;Origin;Destination;Total;age: [children];age: [adults];age: [elders];occupation: [student];occupation: [worker]
0;Aberta dos Morros;Aberta dos Morros;2800;200;1414;420;500;2300
1;Aberta dos Morros;Agronomia;100;0;55;21;0;100
2;Aberta dos Morros;Anchieta;50;0;26;14;0;50
3;Aberta dos Morros;Arquipélago;0;0;0;0;0;0
4;Aberta dos Morros;Auxiliadora;0;0;0;0;0;0
5;Aberta dos Morros;Azenha;100;0;59;12;0;100
6;Aberta dos Morros;Bela Vista;50;0;25;11;0;50
7;Aberta dos Morros;Belém Novo;150;100;29;10;100;50
8;Aberta dos Morros;Belém Velho;750;100;389;105;100;650
9;Aberta dos Morros;Boa Vista;50;0;28;13;0;50
10;Aberta dos Morros;Boa Vista do Sul;100;0;32;8;50;50
11;Aberta dos Morros;Bom Fim;0;0;0;0;0;0
12;Aberta dos Morros;Bom Jesus;0;0;0;0;0;0
13;Aberta dos Morros;Camaquã;200;0;119;44;0;200
14;Aberta dos Morros;Campo Novo;1733;50;868;234;283;1450
15;Aberta dos Morros;Cascata;0;0;0;0;0;0
16;Aberta dos Morros;Cavalhada;450;50;234;87;50;400
17;Aberta dos Morros;Cel. Aparício Borges;250;100;72;13;150;100
18;Aberta dos Morros;Centro Histórico;200;50;91;34;50;150
19;Aberta dos Morros;Chapéu do Sol;0;0;0;0;0;0
20;Aberta dos Morros;Chácara das Pedras;0;0;0;0;0;0
21;Aberta dos Morros;Cidade Baixa;100;0;31;3;50;50
22;Aberta dos Morros;Costa e Silva;100;0;69;14;0;100
23;Aberta dos Morros;Cristal;100;50;27;8;50;50
24;Aberta dos Morros;Cristo Redentor;0;0;0;0;0;0
25;Aberta dos Morros;Espírito Santo;1300;600;239;20;1150;150
26;Aberta dos Morros;Extrema;0;0;0;0;0;0
27;Aberta dos Morros;Farrapos;0;0;0;0;0;0
28;Aberta dos Morros;Farroupilha;50;0;0;0;50;0
29;Aberta dos Morros;Floresta;0;0;0;0;0;0
30;Aberta dos Morros;Glória;200;50;85;22;50;150
31;Aberta dos Morros;Guarujá;500;0;189;58;200;300
32;Aberta dos Morros;Higienópolis;50;0;30;12;0;50
33;Aberta dos Morros;Humaitá;50;0;27;10;0;50
34;Aberta dos Morros;Hípica;1600;300;711;154;600;1000
35;Aberta dos Morros;Independência;0;0;0;0;0;0
36;Aberta dos Morros;Ipanema;200;50;85;32;50;150
37;Aberta dos Morros;Jardim Botânico;50;0;25;9;0;50
38;Aberta dos Morros;Jardim Carvalho;100;0;59;21;0;100
39;Aberta dos Morros;Jardim Europa;50;0;0;0;50;0
40;Aberta dos Morros;Jardim Floresta;0;0;0;0;0;0
41;Aberta dos Morros;Jardim Isabel;400;0;224;59;50;350
42;Aberta dos Morros;Jardim Itú;0;0;0;0;0;0
43;Aberta dos Morros;Jardim Leopoldina;50;0;36;6;0;50
44;Aberta dos Morros;Jardim Lindóia;0;0;0;0;0;0
45;Aberta dos Morros;Jardim Sabará;50;0;0;0;50;0
46;Aberta dos Morros;Jardim São Pedro;0;0;0;0;0;0
47;Aberta dos Morros;Jardim do Salso;50;0;36;5;0;50
48;Aberta dos Morros;Lageado;150;100;33;7;100;50
49;Aberta dos Morros;Lami;0;0;0;0;0;0
50;Aberta dos Morros;Lomba do Pinheiro;150;50;56;17;50;100
51;Aberta dos Morros;Medianeira;100;0;63;20;0;100
52;Aberta dos Morros;Menino Deus;200;0;59;26;100;100
53;Aberta dos Morros;Moinhos de Vento;50;0;32;9;0;50
54;Aberta dos Morros;Mont'Serrat;0;0;0;0;0;0
55;Aberta dos Morros;Morro Santana;100;50;27;12;50;50
56;Aberta dos Morros;Mário Quintana;50;50;0;0;50;0
57;Aberta dos Morros;Navegantes;0;0;0;0;0;0
58;Aberta dos Morros;Nonoai;100;50;0;0;100;0
59;Aberta dos Morros;Parque Santa Fé;0;0;0;0;0;0
60;Aberta dos Morros;Partenon;250;100;56;22;150;100
61;Aberta dos Morros;Passo D'Areia;100;0;33;43;0;100
62;Aberta dos Morros;Passo das Pedras;50;0;50;0;50;0
63;Aberta dos Morros;Pedra Redonda;50;0;33;7;0;50
64;Aberta dos Morros;Petrópolis;100;50;29;17;50;50
65;Aberta dos Morros;Pitinga;0;0;0;0;0;0
66;Aberta dos Morros;Ponta Grossa;300;0;135;34;50;250
67;Aberta dos Morros;Praia de Belas;0;0;0;0;0;0
68;Aberta dos Morros;Restinga;2250;800;610;168;1150;1100
69;Aberta dos Morros;Rio Branco;150;0;26;13;100;50
70;Aberta dos Morros;Rubem Berta;0;0;0;0;0;0
71;Aberta dos Morros;Santa Cecília;0;0;0;0;0;0
72;Aberta dos Morros;Santa Maria Goretti;100;50;39;2;50;50
73;Aberta dos Morros;Santa Rosa de Lima;200;0;115;45;0;200
74;Aberta dos Morros;Santa Tereza;250;50;83;37;100;150
75;Aberta dos Morros;Santana;100;0;34;4;50;50
76;Aberta dos Morros;Santo Antônio;0;0;0;0;0;0
77;Aberta dos Morros;Sarandi;50;0;22;16;0;50
78;Aberta dos Morros;Serraria;900;250;152;61;600;300
79;Aberta dos Morros;São Caetano;0;0;0;0;0;0
80;Aberta dos Morros;São Geraldo;50;0;34;15;0;50
81;Aberta dos Morros;São José;50;0;24;10;0;50
82;Aberta dos Morros;São João;50;0;0;0;50;0
83;Aberta dos Morros;São Sebastião;0;0;0;0;0;0
84;Aberta dos Morros;Sétimo Céu;50;0;31;11;0;50
85;Aberta dos Morros;Teresópolis;100;50;0;0;100;0
86;Aberta dos Morros;Tristeza;50;0;0;0;50;0
87;Aberta dos Morros;Três Figueiras;0;0;0;0;0;0
88;Aberta dos Morros;Vila Assunção;50;0;0;0;50;0
89;Aberta dos Morros;Vila Conceição;150;100;0;0;150;0
90;Aberta dos Morros;Vila Ipiranga;200;0;54;19;100;100
91;Aberta dos Morros;Vila Jardim;50;0;34;13;0;50
92;Aberta dos Morros;Vila João Pessoa;0;0;0;0;0;0
93;Aberta dos Morros;Vila Nova;1000;150;477;147;200;800
94;Agronomia;Aberta dos Morros;100;0;55;21;0;100
95;Agronomia;Agronomia;400;200;0;0;400;0
96;Agronomia;Anchieta;50;50;0;0;50;0
97;Agronomia;Arquipélago;50;0;22;9;0;50
98;Agronomia;Auxiliadora;0;0;0;0;0;0
99;Agronomia;Azenha;200;0;97;35;50;150
100;Agronomia;Bela Vista;50;0;0;0;50;0
101;Agronomia;Belém Novo;50;0;35;9;0;50
102;Agronomia;Belém Velho;0;0;0;0;0;0
103;Agronomia;Boa Vista;0;0;0;0;0;0
104;Agronomia;Boa Vista do Sul;100;0;25;10;50;50
105;Agronomia;Bom Fim;0;0;0;0;0;0
106;Agronomia;Bom Jesus;650;200;97;23;500;150
107;Agronomia;Camaquã;0;0;0;0;0;0
108;Agronomia;Campo Novo;100;0;57;16;0;100
109;Agronomia;Cascata;450;150;148;40;200;250
110;Agronomia;Cavalhada;50;50;0;0;50;0
111;Agronomia;Cel. Aparício Borges;300;100;134;17;150;150
112;Agronomia;Centro Histórico;100;0;50;0;100;0
113;Agronomia;Chapéu do Sol;0;0;0;0;0;0
114;Agronomia;Chácara das Pedras;50;50;0;0;50;0
115;Agronomia;Cidade Baixa;0;0;0;0;0;0
116;Agronomia;Costa e Silva;50;0;28;8;0;50
117;Agronomia;Cristal;0;0;0;0;0;0
118;Agronomia;Cristo Redentor;50;0;0;0;50;0
119;Agronomia;Espírito Santo;0;0;0;0;0;0
120;Agronomia;Extrema;50;0;32;9;0;50
121;Agronomia;Farrapos;0;0;0;0;0;0
122;Agronomia;Farroupilha;0;0;0;0;0;0
123;Agronomia;Floresta;150;50;32;7;100;50
124;Agronomia;Glória;250;100;58;16;150;100
125;Agronomia;Guarujá;0;0;0;0;0;0
126;Agronomia;Higienópolis;150;0;93;26;0;150
127;Agronomia;Humaitá;0;0;0;0;0;0
128;Agronomia;Hípica;50;50;0;0;50;0
129;Agronomia;Independência;0;0;0;0;0;0
130;Agronomia;Ipanema;100;0;63;30;0;100
131;Agronomia;Jardim Botânico;50;0;0;0;50;0
132;Agronomia;Jardim Carvalho;3000;1550;321;59;2650;350
133;Agronomia;Jardim Europa;50;0;33;9;0;50
134;Agronomia;Jardim Floresta;0;0;0;0;0;0
135;Agronomia;Jardim Isabel;0;0;0;0;0;0
136;Agronomia;Jardim Itú;250;50;139;39;50;200
137;Agronomia;Jardim Leopoldina;250;0;110;38;50;200
138;Agronomia;Jardim Lindóia;0;0;0;0;0;0
139;Agronomia;Jardim Sabará;200;50;87;21;50;150
140;Agronomia;Jardim São Pedro;100;0;50;0;100;0
141;Agronomia;Jardim do Salso;0;0;0;0;0;0
142;Agronomia;Lageado;50;50;0;0;50;0
143;Agronomia;Lami;50;0;0;0;50;0
144;Agronomia;Lomba do Pinheiro;5200;550;2522;601;1000;4200
145;Agronomia;Medianeira;100;0;49;33;0;100
146;Agronomia;Menino Deus;50;0;27;12;0;50
147;Agronomia;Moinhos de Vento;0;0;0;0;0;0
148;Agronomia;Mont'Serrat;100;0;28;11;50;50
149;Agronomia;Morro Santana;550;0;338;89;0;550
150;Agronomia;Mário Quintana;250;50;92;14;100;150
151;Agronomia;Navegantes;0;0;0;0;0;0
152;Agronomia;Nonoai;50;0;31;10;0;50
153;Agronomia;Parque Santa Fé;50;50;0;0;50;0
154;Agronomia;Partenon;400;100;158;45;150;250
155;Agronomia;Passo D'Areia;100;0;16;13;50;50
156;Agronomia;Passo das Pedras;150;0;29;9;100;50
157;Agronomia;Pedra Redonda;0;0;0;0;0;0
158;Agronomia;Petrópolis;300;0;182;83;50;250
159;Agronomia;Pitinga;0;0;0;0;0;0
160;Agronomia;Ponta Grossa;0;0;0;0;0;0
161;Agronomia;Praia de Belas;0;0;0;0;0;0
162;Agronomia;Restinga;200;50;84;23;50;150
163;Agronomia;Rio Branco;250;0;79;31;100;150
164;Agronomia;Rubem Berta;50;0;19;26;0;50
165;Agronomia;Santa Cecília;0;0;0;0;0;0
166;Agronomia;Santa Maria Goretti;50;0;37;2;0;50
167;Agronomia;Santa Rosa de Lima;200;0;124;37;0;200
168;Agronomia;Santa Tereza;200;50;84;21;50;150
169;Agronomia;Santana;50;0;18;11;0;50
170;Agronomia;Santo Antônio;0;0;0;0;0;0
171;Agronomia;Sarandi;50;50;0;0;50;0
172;Agronomia;Serraria;0;0;0;0;0;0
173;Agronomia;São Caetano;0;0;0;0;0;0
174;Agronomia;São Geraldo;100;0;0;0;100;0
175;Agronomia;São José;3700;850;1359;354;1450;2250
176;Agronomia;São João;50;0;0;0;50;0
177;Agronomia;São Sebastião;0;0;0;0;0;0
178;Agronomia;Sétimo Céu;0;0;0;0;0;0
179;Agronomia;Teresópolis;0;0;0;0;0;0
180;Agronomia;Tristeza;50;0;31;13;0;50
181;Agronomia;Três Figueiras;50;0;0;0;50;0
182;Agronomia;Vila Assunção;0;0;0;0;0;0
183;Agronomia;Vila Conceição;0;0;0;0;0;0
184;Agronomia;Vila Ipiranga;0;0;0;0;0;0
185;Agronomia;Vila Jardim;150;50;21;13;100;50
186;Agronomia;Vila João Pessoa;150;0;90;28;0;150
187;Agronomia;Vila Nova;200;0;25;18;150;50
188;Anchieta;Aberta dos Morros;50;0;26;14;0;50
189;Anchieta;Agronomia;50;50;0;0;50;0
190;Anchieta;Anchieta;400;200;0;0;400;0
191;Anchieta;Arquipélago;0;0;0;0;0;0
192;Anchieta;Auxiliadora;200;100;69;16;100;100
193;Anchieta;Azenha;0;0;0;0;0;0
194;Anchieta;Bela Vista;150;0;87;33;0;150
195;Anchieta;Belém Novo;0;0;0;0;0;0
196;Anchieta;Belém Velho;200;50;69;14;100;100
197;Anchieta;Boa Vista;0;0;0;0;0;0
198;Anchieta;Boa Vista do Sul;0;0;0;0;0;0
199;Anchieta;Bom Fim;50;0;26;8;0;50
200;Anchieta;Bom Jesus;250;50;55;18;150;100
201;Anchieta;Camaquã;50;0;0;0;50;0
202;Anchieta;Campo Novo;0;0;0;0;0;0
203;Anchieta;Cascata;50;50;0;0;50;0
204;Anchieta;Cavalhada;0;0;0;0;0;0
205;Anchieta;Cel. Aparício Borges;100;0;57;15;0;100
206;Anchieta;Centro Histórico;150;100;37;8;100;50
207;Anchieta;Chapéu do Sol;0;0;0;0;0;0
208;Anchieta;Chácara das Pedras;100;50;28;15;50;50
209;Anchieta;Cidade Baixa;0;0;0;0;0;0
210;Anchieta;Costa e Silva;150;50;31;9;100;50
211;Anchieta;Cristal;50;0;26;15;0;50
212;Anchieta;Cristo Redentor;300;50;88;34;150;150
213;Anchieta;Espírito Santo;50;0;20;4;0;50
214;Anchieta;Extrema;0;0;0;0;0;0
215;Anchieta;Farrapos;1423;500;219;67;1073;350
216;Anchieta;Farroupilha;0;0;0;0;0;0
217;Anchieta;Floresta;0;0;0;0;0;0
218;Anchieta;Glória;50;0;28;8;0;50
219;Anchieta;Guarujá;0;0;0;0;0;0
220;Anchieta;Higienópolis;100;0;33;3;50;50
221;Anchieta;Humaitá;486;50;69;9;386;100
222;Anchieta;Hípica;100;50;27;5;50;50
223;Anchieta;Independência;100;0;23;8;50;50
224;Anchieta;Ipanema;50;0;0;0;50;0
225;Anchieta;Jardim Botânico;0;0;0;0;0;0
226;Anchieta;Jardim Carvalho;100;100;0;0;100;0
227;Anchieta;Jardim Europa;50;0;0;0;50;0
228;Anchieta;Jardim Floresta;50;0;26;5;0;50
229;Anchieta;Jardim Isabel;0;0;0;0;0;0
230;Anchieta;Jardim Itú;50;50;0;0;50;0
231;Anchieta;Jardim Leopoldina;0;0;0;0;0;0
232;Anchieta;Jardim Lindóia;0;0;0;0;0;0
233;Anchieta;Jardim Sabará;150;0;57;21;50;100
234;Anchieta;Jardim São Pedro;500;150;195;38;200;300
235;Anchieta;Jardim do Salso;0;0;0;0;0;0
236;Anchieta;Lageado;0;0;0;0;0;0
237;Anchieta;Lami;0;0;0;0;0;0
238;Anchieta;Lomba do Pinheiro;250;0;159;27;0;250
239;Anchieta;Medianeira;50;50;0;0;50;0
240;Anchieta;Menino Deus;50;0;29;9;0;50
241;Anchieta;Moinhos de Vento;50;0;0;0;50;0
242;Anchieta;Mont'Serrat;100;0;58;19;0;100
243;Anchieta;Morro Santana;50;0;28;5;0;50
244;Anchieta;Mário Quintana;50;0;36;4;0;50
245;Anchieta;Navegantes;0;0;0;0;0;0
246;Anchieta;Nonoai;100;0;64;28;0;100
247;Anchieta;Parque Santa Fé;50;0;36;7;0;50
248;Anchieta;Partenon;200;0;113;24;100;100
249;Anchieta;Passo D'Areia;0;0;0;0;0;0
250;Anchieta;Passo das Pedras;0;0;0;0;0;0
251;Anchieta;Pedra Redonda;0;0;0;0;0;0
252;Anchieta;Petrópolis;150;0;72;22;50;100
253;Anchieta;Pitinga;0;0;0;0;0;0
254;Anchieta;Ponta Grossa;0;0;0;0;0;0
255;Anchieta;Praia de Belas;0;0;0;0;0;0
256;Anchieta;Restinga;50;50;0;0;50;0
257;Anchieta;Rio Branco;50;0;20;11;0;50
258;Anchieta;Rubem Berta;50;0;19;22;0;50
259;Anchieta;Santa Cecília;50;0;30;15;0;50
260;Anchieta;Santa Maria Goretti;400;200;58;9;300;100
261;Anchieta;Santa Rosa de Lima;50;0;0;0;50;0
262;Anchieta;Santa Tereza;200;0;103;34;0;200
263;Anchieta;Santana;0;0;0;0;0;0
264;Anchieta;Santo Antônio;50;0;28;12;0;50
265;Anchieta;Sarandi;1700;150;871;356;350;1350
266;Anchieta;Serraria;100;0;48;23;0;100
267;Anchieta;São Caetano;0;0;0;0;0;0
268;Anchieta;São Geraldo;100;0;51;39;0;100
269;Anchieta;São José;100;0;67;19;0;100
270;Anchieta;São João;157;50;54;19;57;100
271;Anchieta;São Sebastião;100;0;28;12;50;50
272;Anchieta;Sétimo Céu;0;0;0;0;0;0
273;Anchieta;Teresópolis;100;0;31;10;50;50
274;Anchieta;Tristeza;50;0;0;0;50;0
275;Anchieta;Três Figueiras;100;50;31;15;50;50
276;Anchieta;Vila Assunção;0;0;0;0;0;0
277;Anchieta;Vila Conceição;0;0;0;0;0;0
278;Anchieta;Vila Ipiranga;50;50;0;0;50;0
279;Anchieta;Vila Jardim;0;0;0;0;0;0
280;Anchieta;Vila João Pessoa;50;0;44;6;0;50
281;Anchieta;Vila Nova;350;0;216;57;50;300
282;Arquipélago;Aberta dos Morros;0;0;0;0;0;0
283;Arquipélago;Agronomia;50;0;22;9;0;50
284;Arquipélago;Anchieta;0;0;0;0;0;0
285;Arquipélago;Arquipélago;0;0;0;0;0;0
286;Arquipélago;Auxiliadora;50;0;33;9;0;50
287;Arquipélago;Azenha;100;0;21;14;50;50
288;Arquipélago;Bela Vista;50;0;31;3;0;50
289;Arquipélago;Belém Novo;150;0;84;25;0;150
290;Arquipélago;Belém Velho;100;0;26;11;50;50
291;Arquipélago;Boa Vista;0;0;0;0;0;0
292;Arquipélago;Boa Vista do Sul;50;0;50;0;50;0
293;Arquipélago;Bom Fim;250;0;132;47;0;250
294;Arquipélago;Bom Jesus;150;0;93;29;0;150
295;Arquipélago;Camaquã;150;50;0;0;150;0
296;Arquipélago;Campo Novo;50;0;0;0;50;0
297;Arquipélago;Cascata;300;0;145;28;50;250
298;Arquipélago;Cavalhada;250;0;115;44;50;200
299;Arquipélago;Cel. Aparício Borges;50;0;33;11;0;50
300;Arquipélago;Centro Histórico;750;0;384;106;100;650
301;Arquipélago;Chapéu do Sol;0;0;0;0;0;0
302;Arquipélago;Chácara das Pedras;50;0;24;7;0;50
303;Arquipélago;Cidade Baixa;250;200;29;4;200;50
304;Arquipélago;Costa e Silva;150;0;53;22;50;100
305;Arquipélago;Cristal;250;50;55;19;150;100
306;Arquipélago;Cristo Redentor;100;50;0;0;100;0
307;Arquipélago;Espírito Santo;200;0;112;33;0;200
308;Arquipélago;Extrema;150;0;87;21;0;150
309;Arquipélago;Farrapos;100;0;54;14;0;100
310;Arquipélago;Farroupilha;350;100;119;39;150;200
311;Arquipélago;Floresta;100;0;76;9;50;50
312;Arquipélago;Glória;50;50;0;0;50;0
313;Arquipélago;Guarujá;100;0;56;15;0;100
314;Arquipélago;Higienópolis;0;0;0;0;0;0
315;Arquipélago;Humaitá;0;0;0;0;0;0
316;Arquipélago;Hípica;0;0;0;0;0;0
317;Arquipélago;Independência;200;0;84;19;50;150
318;Arquipélago;Ipanema;100;0;57;15;0;100
319;Arquipélago;Jardim Botânico;50;0;50;0;50;0
320;Arquipélago;Jardim Carvalho;50;0;30;16;0;50
321;Arquipélago;Jardim Europa;50;0;24;14;0;50
322;Arquipélago;Jardim Floresta;0;0;0;0;0;0
323;Arquipélago;Jardim Isabel;0;0;0;0;0;0
324;Arquipélago;Jardim Itú;100;0;31;9;50;50
325;Arquipélago;Jardim Leopoldina;50;0;0;0;50;0
326;Arquipélago;Jardim Lindóia;0;0;0;0;0;0
327;Arquipélago;Jardim Sabará;100;0;47;29;0;100
328;Arquipélago;Jardim São Pedro;100;0;58;23;0;100
329;Arquipélago;Jardim do Salso;0;0;0;0;0;0
330;Arquipélago;Lageado;50;0;0;0;50;0
331;Arquipélago;Lami;100;0;32;5;50;50
332;Arquipélago;Lomba do Pinheiro;450;100;193;39;150;300
333;Arquipélago;Medianeira;50;0;26;7;0;50
334;Arquipélago;Menino Deus;400;50;211;83;50;350
335;Arquipélago;Moinhos de Vento;100;0;50;16;0;100
336;Arquipélago;Mont'Serrat;100;50;34;14;50;50
337;Arquipélago;Morro Santana;50;0;31;8;0;50
338;Arquipélago;Mário Quintana;150;0;96;18;0;150
339;Arquipélago;Navegantes;50;0;30;8;0;50
340;Arquipélago;Nonoai;250;0;143;44;0;250
341;Arquipélago;Parque Santa Fé;100;0;58;13;0;100
342;Arquipélago;Partenon;200;50;60;19;100;100
343;Arquipélago;Passo D'Areia;250;0;53;53;100;150
344;Arquipélago;Passo das Pedras;0;0;0;0;0;0
345;Arquipélago;Pedra Redonda;0;0;0;0;0;0
346;Arquipélago;Petrópolis;250;50;112;22;150;100
347;Arquipélago;Pitinga;50;50;0;0;50;0
348;Arquipélago;Ponta Grossa;50;0;24;9;0;50
349;Arquipélago;Praia de Belas;1450;250;579;154;450;1000
350;Arquipélago;Restinga;300;50;121;32;100;200
351;Arquipélago;Rio Branco;50;0;26;9;0;50
352;Arquipélago;Rubem Berta;0;0;0;0;0;0
353;Arquipélago;Santa Cecília;50;50;0;0;50;0
354;Arquipélago;Santa Maria Goretti;50;0;31;1;0;50
355;Arquipélago;Santa Rosa de Lima;100;0;37;4;50;50
356;Arquipélago;Santa Tereza;550;50;217;84;150;400
357;Arquipélago;Santana;0;0;0;0;0;0
358;Arquipélago;Santo Antônio;200;50;63;26;100;100
359;Arquipélago;Sarandi;200;50;62;20;100;100
360;Arquipélago;Serraria;200;50;56;23;100;100
361;Arquipélago;São Caetano;0;0;0;0;0;0
362;Arquipélago;São Geraldo;100;0;24;8;50;50
363;Arquipélago;São José;250;50;119;29;50;200
364;Arquipélago;São João;100;50;50;0;100;0
365;Arquipélago;São Sebastião;100;50;27;7;50;50
366;Arquipélago;Sétimo Céu;0;0;0;0;0;0
367;Arquipélago;Teresópolis;50;0;29;5;0;50
368;Arquipélago;Tristeza;151;100;30;11;101;50
369;Arquipélago;Três Figueiras;100;0;72;16;50;50
370;Arquipélago;Vila Assunção;100;0;19;6;50;50
371;Arquipélago;Vila Conceição;0;0;0;0;0;0
372;Arquipélago;Vila Ipiranga;0;0;0;0;0;0
373;Arquipélago;Vila Jardim;50;0;36;6;0;50
374;Arquipélago;Vila João Pessoa;200;100;21;14;150;50
375;Arquipélago;Vila Nova;150;0;54;21;50;100
376;Auxiliadora;Aberta dos Morros;0;0;0;0;0;0
377;Auxiliadora;Agronomia;0;0;0;0;0;0
378;Auxiliadora;Anchieta;200;100;69;16;100;100
379;Auxiliadora;Arquipélago;50;0;33;9;0;50
380;Auxiliadora;Auxiliadora;4800;1200;1436;692;2400;2400
381;Auxiliadora;Azenha;200;50;85;42;50;150
382;Auxiliadora;Bela Vista;900;250;324;93;600;300
383;Auxiliadora;Belém Novo;50;0;20;20;0;50
384;Auxiliadora;Belém Velho;50;0;35;10;0;50
385;Auxiliadora;Boa Vista;950;100;433;180;200;750
386;Auxiliadora;Boa Vista do Sul;0;0;0;0;0;0
387;Auxiliadora;Bom Fim;250;0;52;36;150;100
388;Auxiliadora;Bom Jesus;50;0;22;18;0;50
389;Auxiliadora;Camaquã;0;0;0;0;0;0
390;Auxiliadora;Campo Novo;100;0;58;16;0;100
391;Auxiliadora;Cascata;50;0;31;10;0;50
392;Auxiliadora;Cavalhada;200;0;73;40;50;150
393;Auxiliadora;Cel. Aparício Borges;150;0;46;34;50;100
394;Auxiliadora;Centro Histórico;550;50;88;58;350;200
395;Auxiliadora;Chapéu do Sol;50;0;0;0;50;0
396;Auxiliadora;Chácara das Pedras;350;50;168;82;50;300
397;Auxiliadora;Cidade Baixa;350;100;118;35;150;200
398;Auxiliadora;Costa e Silva;100;0;30;10;50;50
399;Auxiliadora;Cristal;250;50;116;37;50;200
400;Auxiliadora;Cristo Redentor;300;50;135;67;50;250
401;Auxiliadora;Espírito Santo;100;0;29;16;50;50
402;Auxiliadora;Extrema;50;50;0;0;50;0
403;Auxiliadora;Farrapos;500;0;212;83;150;350
404;Auxiliadora;Farroupilha;150;50;58;28;50;100
405;Auxiliadora;Floresta;500;150;135;71;250;250
406;Auxiliadora;Glória;100;100;0;0;100;0
407;Auxiliadora;Guarujá;0;0;0;0;0;0
408;Auxiliadora;Higienópolis;400;100;88;30;250;150
409;Auxiliadora;Humaitá;0;0;0;0;0;0
410;Auxiliadora;Hípica;50;0;0;0;50;0
411;Auxiliadora;Independência;300;50;88;52;150;150
412;Auxiliadora;Ipanema;50;0;21;14;0;50
413;Auxiliadora;Jardim Botânico;150;0;75;36;0;150
414;Auxiliadora;Jardim Carvalho;100;50;35;11;50;50
415;Auxiliadora;Jardim Europa;250;50;76;36;100;150
416;Auxiliadora;Jardim Floresta;150;50;57;23;50;100
417;Auxiliadora;Jardim Isabel;50;50;0;0;50;0
418;Auxiliadora;Jardim Itú;200;0;92;37;50;150
419;Auxiliadora;Jardim Leopoldina;50;0;41;5;0;50
420;Auxiliadora;Jardim Lindóia;100;0;19;23;50;50
421;Auxiliadora;Jardim Sabará;200;50;74;45;50;150
422;Auxiliadora;Jardim São Pedro;150;0;47;29;50;100
423;Auxiliadora;Jardim do Salso;0;0;0;0;0;0
424;Auxiliadora;Lageado;50;0;20;19;0;50
425;Auxiliadora;Lami;0;0;0;0;0;0
426;Auxiliadora;Lomba do Pinheiro;100;0;30;7;50;50
427;Auxiliadora;Medianeira;50;0;0;0;50;0
428;Auxiliadora;Menino Deus;400;100;158;58;200;200
429;Auxiliadora;Moinhos de Vento;850;150;181;101;600;250
430;Auxiliadora;Mont'Serrat;2800;150;1469;665;400;2400
431;Auxiliadora;Morro Santana;200;0;109;48;0;200
432;Auxiliadora;Mário Quintana;50;50;0;0;50;0
433;Auxiliadora;Navegantes;50;0;0;0;50;0
434;Auxiliadora;Nonoai;150;0;59;21;50;100
435;Auxiliadora;Parque Santa Fé;100;0;23;19;50;50
436;Auxiliadora;Partenon;150;50;0;0;150;0
437;Auxiliadora;Passo D'Areia;450;50;152;100;150;300
438;Auxiliadora;Passo das Pedras;100;50;29;9;50;50
439;Auxiliadora;Pedra Redonda;0;0;0;0;0;0
440;Auxiliadora;Petrópolis;1000;250;293;121;600;400
441;Auxiliadora;Pitinga;0;0;0;0;0;0
442;Auxiliadora;Ponta Grossa;0;0;0;0;0;0
443;Auxiliadora;Praia de Belas;0;0;0;0;0;0
444;Auxiliadora;Restinga;100;0;30;6;50;50
445;Auxiliadora;Rio Branco;550;150;53;34;450;100
446;Auxiliadora;Rubem Berta;50;50;0;0;50;0
447;Auxiliadora;Santa Cecília;50;0;25;12;0;50
448;Auxiliadora;Santa Maria Goretti;100;0;65;2;0;100
449;Auxiliadora;Santa Rosa de Lima;100;0;59;16;0;100
450;Auxiliadora;Santa Tereza;150;50;55;19;50;100
451;Auxiliadora;Santana;250;0;84;45;100;150
452;Auxiliadora;Santo Antônio;100;50;0;0;100;0
453;Auxiliadora;Sarandi;150;50;22;20;100;50
454;Auxiliadora;Serraria;50;0;21;17;0;50
455;Auxiliadora;São Caetano;50;0;28;21;0;50
456;Auxiliadora;São Geraldo;400;50;61;21;300;100
457;Auxiliadora;São José;100;0;25;13;50;50
458;Auxiliadora;São João;1500;300;427;256;650;850
459;Auxiliadora;São Sebastião;100;0;53;19;0;100
460;Auxiliadora;Sétimo Céu;0;0;0;0;0;0
461;Auxiliadora;Teresópolis;100;0;57;28;0;100
462;Auxiliadora;Tristeza;150;50;24;20;100;50
463;Auxiliadora;Três Figueiras;800;50;300;180;200;600
464;Auxiliadora;Vila Assunção;50;0;33;10;0;50
465;Auxiliadora;Vila Conceição;50;0;50;0;50;0
466;Auxiliadora;Vila Ipiranga;150;0;88;46;0;150
467;Auxiliadora;Vila Jardim;100;0;55;25;0;100
468;Auxiliadora;Vila João Pessoa;250;100;92;30;100;150
469;Auxiliadora;Vila Nova;100;0;53;30;0;100
470;Azenha;Aberta dos Morros;100;0;59;12;0;100
471;Azenha;Agronomia;200;0;97;35;50;150
472;Azenha;Anchieta;0;0;0;0;0;0
473;Azenha;Arquipélago;100;0;21;14;50;50
474;Azenha;Auxiliadora;200;50;85;42;50;150
475;Azenha;Azenha;1800;200;754;358;500;1300
476;Azenha;Bela Vista;600;250;112;52;400;200
477;Azenha;Belém Novo;100;0;49;29;0;100
478;Azenha;Belém Velho;100;50;31;8;50;50
479;Azenha;Boa Vista;150;0;21;17;100;50
480;Azenha;Boa Vista do Sul;50;0;25;12;0;50
481;Azenha;Bom Fim;550;100;184;103;200;350
482;Azenha;Bom Jesus;0;0;0;0;0;0
483;Azenha;Camaquã;250;100;73;13;200;50
484;Azenha;Campo Novo;50;0;34;10;0;50
485;Azenha;Cascata;150;0;94;23;0;150
486;Azenha;Cavalhada;150;0;85;24;0;150
487;Azenha;Cel. Aparício Borges;450;100;196;69;100;350
488;Azenha;Centro Histórico;550;150;157;66;250;300
489;Azenha;Chapéu do Sol;100;0;0;0;100;0
490;Azenha;Chácara das Pedras;50;0;29;12;0;50
491;Azenha;Cidade Baixa;700;100;220;110;250;450
492;Azenha;Costa e Silva;150;50;56;16;50;100
493;Azenha;Cristal;600;50;200;67;250;350
494;Azenha;Cristo Redentor;50;0;33;6;0;50
495;Azenha;Espírito Santo;0;0;0;0;0;0
496;Azenha;Extrema;50;0;25;10;0;50
497;Azenha;Farrapos;100;0;52;19;0;100
498;Azenha;Farroupilha;550;0;157;75;250;300
499;Azenha;Floresta;350;0;160;83;50;300
500;Azenha;Glória;200;50;81;34;50;150
501;Azenha;Guarujá;50;50;0;0;50;0
502;Azenha;Higienópolis;100;50;0;0;100;0
503;Azenha;Humaitá;50;0;33;4;0;50
504;Azenha;Hípica;150;50;32;8;100;50
505;Azenha;Independência;450;100;134;72;200;250
506;Azenha;Ipanema;50;0;32;14;0;50
507;Azenha;Jardim Botânico;300;0;82;35;150;150
508;Azenha;Jardim Carvalho;150;100;30;12;100;50
509;Azenha;Jardim Europa;50;50;0;0;50;0
510;Azenha;Jardim Floresta;50;0;30;12;0;50
511;Azenha;Jardim Isabel;0;0;0;0;0;0
512;Azenha;Jardim Itú;50;0;27;11;0;50
513;Azenha;Jardim Leopoldina;50;0;27;13;0;50
514;Azenha;Jardim Lindóia;0;0;0;0;0;0
515;Azenha;Jardim Sabará;200;0;87;33;50;150
516;Azenha;Jardim São Pedro;50;0;0;0;50;0
517;Azenha;Jardim do Salso;50;0;23;12;0;50
518;Azenha;Lageado;250;50;71;36;100;150
519;Azenha;Lami;100;50;32;5;50;50
520;Azenha;Lomba do Pinheiro;50;50;0;0;50;0
521;Azenha;Medianeira;3150;550;1151;527;1100;2050
522;Azenha;Menino Deus;1850;300;706;348;650;1200
523;Azenha;Moinhos de Vento;500;0;167;98;150;350
524;Azenha;Mont'Serrat;250;0;133;62;0;250
525;Azenha;Morro Santana;150;50;57;19;50;100
526;Azenha;Mário Quintana;100;0;60;10;0;100
527;Azenha;Navegantes;100;0;46;29;0;100
528;Azenha;Nonoai;350;50;144;44;100;250
529;Azenha;Parque Santa Fé;0;0;0;0;0;0
530;Azenha;Partenon;2450;500;822;308;1150;1300
531;Azenha;Passo D'Areia;150;50;26;17;100;50
532;Azenha;Passo das Pedras;250;0;98;54;50;200
533;Azenha;Pedra Redonda;50;0;26;10;0;50
534;Azenha;Petrópolis;400;0;188;75;100;300
535;Azenha;Pitinga;50;0;31;11;0;50
536;Azenha;Ponta Grossa;100;50;25;14;50;50
537;Azenha;Praia de Belas;500;0;244;106;50;450
538;Azenha;Restinga;50;0;26;12;0;50
539;Azenha;Rio Branco;550;50;214;69;250;300
540;Azenha;Rubem Berta;400;100;149;66;200;200
541;Azenha;Santa Cecília;400;50;118;52;200;200
542;Azenha;Santa Maria Goretti;200;50;60;15;100;100
543;Azenha;Santa Rosa de Lima;150;0;90;40;0;150
544;Azenha;Santa Tereza;1350;100;461;153;550;800
545;Azenha;Santana;1000;200;373;180;300;700
546;Azenha;Santo Antônio;1300;250;404;108;750;550
547;Azenha;Sarandi;200;0;109;56;0;200
548;Azenha;Serraria;50;0;0;0;50;0
549;Azenha;São Caetano;200;50;47;30;100;100
550;Azenha;São Geraldo;200;100;22;11;150;50
551;Azenha;São José;200;0;109;20;100;100
552;Azenha;São João;150;50;23;17;100;50
553;Azenha;São Sebastião;0;0;0;0;0;0
554;Azenha;Sétimo Céu;0;0;0;0;0;0
555;Azenha;Teresópolis;500;100;207;90;150;350
556;Azenha;Tristeza;150;0;86;41;0;150
557;Azenha;Três Figueiras;0;0;0;0;0;0
558;Azenha;Vila Assunção;50;0;27;10;0;50
559;Azenha;Vila Conceição;50;0;28;15;0;50
560;Azenha;Vila Ipiranga;50;0;36;12;0;50
561;Azenha;Vila Jardim;100;50;20;20;50;50
562;Azenha;Vila João Pessoa;100;50;32;15;50;50
563;Azenha;Vila Nova;250;0;150;55;0;250
564;Bela Vista;Aberta dos Morros;50;0;25;11;0;50
565;Bela Vista;Agronomia;50;0;0;0;50;0
566;Bela Vista;Anchieta;150;0;87;33;0;150
567;Bela Vista;Arquipélago;50;0;31;3;0;50
568;Bela Vista;Auxiliadora;900;250;324;93;600;300
569;Bela Vista;Azenha;600;250;112;52;400;200
570;Bela Vista;Bela Vista;6600;1700;2094;782;3500;3100
571;Bela Vista;Belém Novo;250;100;64;23;150;100
572;Bela Vista;Belém Velho;100;0;66;28;0;100
573;Bela Vista;Boa Vista;350;50;138;75;100;250
574;Bela Vista;Boa Vista do Sul;50;0;26;12;0;50
575;Bela Vista;Bom Fim;250;0;108;31;150;100
576;Bela Vista;Bom Jesus;150;0;24;8;100;50
577;Bela Vista;Camaquã;100;50;30;14;50;50
578;Bela Vista;Campo Novo;0;0;0;0;0;0
579;Bela Vista;Cascata;50;0;31;4;0;50
580;Bela Vista;Cavalhada;100;0;32;10;50;50
581;Bela Vista;Cel. Aparício Borges;150;0;57;18;50;100
582;Bela Vista;Centro Histórico;500;150;89;36;350;150
583;Bela Vista;Chapéu do Sol;150;50;53;24;50;100
584;Bela Vista;Chácara das Pedras;100;0;23;12;50;50
585;Bela Vista;Cidade Baixa;350;50;75;33;200;150
586;Bela Vista;Costa e Silva;50;0;36;12;0;50
587;Bela Vista;Cristal;150;0;56;23;50;100
588;Bela Vista;Cristo Redentor;350;100;132;17;300;50
589;Bela Vista;Espírito Santo;100;0;60;21;0;100
590;Bela Vista;Extrema;0;0;0;0;0;0
591;Bela Vista;Farrapos;0;0;0;0;0;0
592;Bela Vista;Farroupilha;150;50;58;27;50;100
593;Bela Vista;Floresta;550;150;161;57;300;250
594;Bela Vista;Glória;250;100;118;26;150;100
595;Bela Vista;Guarujá;100;0;64;28;0;100
596;Bela Vista;Higienópolis;50;0;31;15;0;50
597;Bela Vista;Humaitá;50;0;33;3;0;50
598;Bela Vista;Hípica;200;0;105;28;50;150
599;Bela Vista;Independência;250;100;75;51;100;150
600;Bela Vista;Ipanema;150;0;88;32;0;150
601;Bela Vista;Jardim Botânico;350;200;33;9;300;50
602;Bela Vista;Jardim Carvalho;200;0;128;38;0;200
603;Bela Vista;Jardim Europa;50;0;31;12;0;50
604;Bela Vista;Jardim Floresta;50;0;32;14;0;50
605;Bela Vista;Jardim Isabel;0;0;0;0;0;0
606;Bela Vista;Jardim Itú;0;0;0;0;0;0
607;Bela Vista;Jardim Leopoldina;0;0;0;0;0;0
608;Bela Vista;Jardim Lindóia;150;0;110;22;50;100
609;Bela Vista;Jardim Sabará;0;0;0;0;0;0
610;Bela Vista;Jardim São Pedro;50;0;0;0;50;0
611;Bela Vista;Jardim do Salso;100;0;60;21;0;100
612;Bela Vista;Lageado;100;0;61;21;0;100
613;Bela Vista;Lami;100;0;58;29;0;100
614;Bela Vista;Lomba do Pinheiro;150;0;105;30;0;150
615;Bela Vista;Medianeira;200;100;56;26;100;100
616;Bela Vista;Menino Deus;650;150;199;112;300;350
617;Bela Vista;Moinhos de Vento;500;200;134;106;200;300
618;Bela Vista;Mont'Serrat;1800;300;770;337;500;1300
619;Bela Vista;Morro Santana;50;0;33;8;0;50
620;Bela Vista;Mário Quintana;50;0;34;5;0;50
621;Bela Vista;Navegantes;100;50;21;11;50;50
622;Bela Vista;Nonoai;100;0;30;14;50;50
623;Bela Vista;Parque Santa Fé;100;50;29;15;50;50
624;Bela Vista;Partenon;650;50;293;105;150;500
625;Bela Vista;Passo D'Areia;500;200;70;75;300;200
626;Bela Vista;Passo das Pedras;50;50;0;0;50;0
627;Bela Vista;Pedra Redonda;0;0;0;0;0;0
628;Bela Vista;Petrópolis;1850;100;830;302;550;1300
629;Bela Vista;Pitinga;0;0;0;0;0;0
630;Bela Vista;Ponta Grossa;0;0;0;0;0;0
631;Bela Vista;Praia de Belas;50;0;0;0;50;0
632;Bela Vista;Restinga;50;0;0;0;50;0
633;Bela Vista;Rio Branco;4350;900;944;415;2850;1500
634;Bela Vista;Rubem Berta;50;0;0;0;50;0
635;Bela Vista;Santa Cecília;1600;50;893;365;100;1500
636;Bela Vista;Santa Maria Goretti;150;0;67;3;50;100
637;Bela Vista;Santa Rosa de Lima;100;0;0;0;100;0
638;Bela Vista;Santa Tereza;300;50;132;53;50;250
639;Bela Vista;Santana;600;100;196;80;250;350
640;Bela Vista;Santo Antônio;400;0;141;65;150;250
641;Bela Vista;Sarandi;250;50;72;37;100;150
642;Bela Vista;Serraria;50;50;0;0;50;0
643;Bela Vista;São Caetano;0;0;0;0;0;0
644;Bela Vista;São Geraldo;200;0;143;42;0;200
645;Bela Vista;São José;200;50;79;33;50;150
646;Bela Vista;São João;350;50;136;78;100;250
647;Bela Vista;São Sebastião;0;0;0;0;0;0
648;Bela Vista;Sétimo Céu;150;0;98;34;0;150
649;Bela Vista;Teresópolis;0;0;0;0;0;0
650;Bela Vista;Tristeza;0;0;0;0;0;0
651;Bela Vista;Três Figueiras;400;150;114;50;200;200
652;Bela Vista;Vila Assunção;50;0;28;17;0;50
653;Bela Vista;Vila Conceição;100;0;57;31;0;100
654;Bela Vista;Vila Ipiranga;100;0;30;13;50;50
655;Bela Vista;Vila Jardim;100;0;63;27;0;100
656;Bela Vista;Vila João Pessoa;50;0;25;11;0;50
657;Bela Vista;Vila Nova;100;50;29;13;50;50
658;Belém Novo;Aberta dos Morros;150;100;29;10;100;50
659;Belém Novo;Agronomia;50;0;35;9;0;50
660;Belém Novo;Anchieta;0;0;0;0;0;0
661;Belém Novo;Arquipélago;150;0;84;25;0;150
662;Belém Novo;Auxiliadora;50;0;20;20;0;50
663;Belém Novo;Azenha;100;0;49;29;0;100
664;Belém Novo;Bela Vista;250;100;64;23;150;100
665;Belém Novo;Belém Novo;5700;700;2284;800;1800;3900
666;Belém Novo;Belém Velho;100;50;23;11;50;50
667;Belém Novo;Boa Vista;100;100;0;0;100;0
668;Belém Novo;Boa Vista do Sul;250;50;87;29;100;150
669;Belém Novo;Bom Fim;50;0;26;19;0;50
670;Belém Novo;Bom Jesus;50;0;25;11;0;50
671;Belém Novo;Camaquã;50;0;28;8;0;50
672;Belém Novo;Campo Novo;300;50;105;54;100;200
673;Belém Novo;Cascata;50;0;33;14;0;50
674;Belém Novo;Cavalhada;0;0;0;0;0;0
675;Belém Novo;Cel. Aparício Borges;50;0;0;0;50;0
676;Belém Novo;Centro Histórico;150;50;59;31;50;100
677;Belém Novo;Chapéu do Sol;350;0;194;78;0;350
678;Belém Novo;Chácara das Pedras;50;0;21;17;0;50
679;Belém Novo;Cidade Baixa;150;0;74;35;0;150
680;Belém Novo;Costa e Silva;0;0;0;0;0;0
681;Belém Novo;Cristal;50;0;25;15;0;50
682;Belém Novo;Cristo Redentor;0;0;0;0;0;0
683;Belém Novo;Espírito Santo;200;0;115;47;0;200
684;Belém Novo;Extrema;100;0;54;9;0;100
685;Belém Novo;Farrapos;150;50;47;14;50;100
686;Belém Novo;Farroupilha;0;0;0;0;0;0
687;Belém Novo;Floresta;50;50;0;0;50;0
688;Belém Novo;Glória;100;50;23;15;50;50
689;Belém Novo;Guarujá;300;50;152;40;50;250
690;Belém Novo;Higienópolis;150;100;29;5;100;50
691;Belém Novo;Humaitá;50;0;0;0;50;0
692;Belém Novo;Hípica;2250;300;1108;312;450;1800
693;Belém Novo;Independência;0;0;0;0;0;0
694;Belém Novo;Ipanema;50;50;0;0;50;0
695;Belém Novo;Jardim Botânico;50;0;0;0;50;0
696;Belém Novo;Jardim Carvalho;200;0;75;38;50;150
697;Belém Novo;Jardim Europa;0;0;0;0;0;0
698;Belém Novo;Jardim Floresta;0;0;0;0;0;0
699;Belém Novo;Jardim Isabel;0;0;0;0;0;0
700;Belém Novo;Jardim Itú;0;0;0;0;0;0
701;Belém Novo;Jardim Leopoldina;100;0;59;14;0;100
702;Belém Novo;Jardim Lindóia;100;0;51;31;0;100
703;Belém Novo;Jardim Sabará;0;0;0;0;0;0
704;Belém Novo;Jardim São Pedro;50;0;29;12;0;50
705;Belém Novo;Jardim do Salso;0;0;0;0;0;0
706;Belém Novo;Lageado;150;100;35;8;100;50
707;Belém Novo;Lami;100;50;29;11;50;50
708;Belém Novo;Lomba do Pinheiro;50;0;32;8;0;50
709;Belém Novo;Medianeira;0;0;0;0;0;0
710;Belém Novo;Menino Deus;200;0;82;39;50;150
711;Belém Novo;Moinhos de Vento;200;50;76;41;50;150
712;Belém Novo;Mont'Serrat;0;0;0;0;0;0
713;Belém Novo;Morro Santana;150;0;30;10;100;50
714;Belém Novo;Mário Quintana;0;0;0;0;0;0
715;Belém Novo;Navegantes;0;0;0;0;0;0
716;Belém Novo;Nonoai;0;0;0;0;0;0
717;Belém Novo;Parque Santa Fé;50;0;33;11;0;50
718;Belém Novo;Partenon;500;100;223;70;150;350
719;Belém Novo;Passo D'Areia;250;50;99;32;150;100
720;Belém Novo;Passo das Pedras;0;0;0;0;0;0
721;Belém Novo;Pedra Redonda;0;0;0;0;0;0
722;Belém Novo;Petrópolis;200;0;91;43;50;150
723;Belém Novo;Pitinga;50;0;0;0;50;0
724;Belém Novo;Ponta Grossa;500;150;176;53;200;300
725;Belém Novo;Praia de Belas;0;0;0;0;0;0
726;Belém Novo;Restinga;550;200;147;39;300;250
727;Belém Novo;Rio Branco;50;0;24;23;0;50
728;Belém Novo;Rubem Berta;50;0;22;25;0;50
729;Belém Novo;Santa Cecília;50;0;23;16;0;50
730;Belém Novo;Santa Maria Goretti;0;0;0;0;0;0
731;Belém Novo;Santa Rosa de Lima;250;100;28;10;200;50
732;Belém Novo;Santa Tereza;50;0;0;0;50;0
733;Belém Novo;Santana;150;0;89;26;0;150
734;Belém Novo;Santo Antônio;50;0;29;11;0;50
735;Belém Novo;Sarandi;100;50;25;19;50;50
736;Belém Novo;Serraria;200;0;110;51;0;200
737;Belém Novo;São Caetano;100;50;0;0;100;0
738;Belém Novo;São Geraldo;0;0;0;0;0;0
739;Belém Novo;São José;100;50;31;8;50;50
740;Belém Novo;São João;0;0;0;0;0;0
741;Belém Novo;São Sebastião;0;0;0;0;0;0
742;Belém Novo;Sétimo Céu;50;0;31;7;0;50
743;Belém Novo;Teresópolis;100;0;28;16;50;50
744;Belém Novo;Tristeza;50;50;0;0;50;0
745;Belém Novo;Três Figueiras;100;0;49;25;0;100
746;Belém Novo;Vila Assunção;100;0;62;24;0;100
747;Belém Novo;Vila Conceição;50;50;0;0;50;0
748;Belém Novo;Vila Ipiranga;150;0;82;43;0;150
749;Belém Novo;Vila Jardim;50;0;28;8;0;50
750;Belém Novo;Vila João Pessoa;200;0;131;42;0;200
751;Belém Novo;Vila Nova;300;0;130;54;50;250
752;Belém Velho;Aberta dos Morros;750;100;389;105;100;650
753;Belém Velho;Agronomia;50;0;24;5;0;50
754;Belém Velho;Anchieta;200;50;69;14;100;100
755;Belém Velho;Arquipélago;100;0;26;11;50;50
756;Belém Velho;Auxiliadora;50;0;35;10;0;50
757;Belém Velho;Azenha;100;50;31;8;50;50
758;Belém Velho;Bela Vista;100;0;66;28;0;100
759;Belém Velho;Belém Novo;100;50;23;11;50;50
760;Belém Velho;Belém Velho;6500;1800;1382;424;4200;2300
761;Belém Velho;Boa Vista;50;0;28;8;0;50
762;Belém Velho;Boa Vista do Sul;0;0;0;0;0;0
763;Belém Velho;Bom Fim;0;0;0;0;0;0
764;Belém Velho;Bom Jesus;250;0;118;40;50;200
765;Belém Velho;Camaquã;50;0;0;0;50;0
766;Belém Velho;Campo Novo;1568;600;293;43;1268;300
767;Belém Velho;Cascata;650;50;293;81;150;500
768;Belém Velho;Cavalhada;150;50;29;11;100;50
769;Belém Velho;Cel. Aparício Borges;200;50;75;24;50;150
770;Belém Velho;Centro Histórico;50;0;31;6;0;50
771;Belém Velho;Chapéu do Sol;100;50;0;0;100;0
772;Belém Velho;Chácara das Pedras;0;0;0;0;0;0
773;Belém Velho;Cidade Baixa;100;0;68;22;0;100
774;Belém Velho;Costa e Silva;0;0;0;0;0;0
775;Belém Velho;Cristal;150;0;35;10;100;50
776;Belém Velho;Cristo Redentor;100;0;65;22;0;100
777;Belém Velho;Espírito Santo;200;100;39;8;150;50
778;Belém Velho;Extrema;0;0;0;0;0;0
779;Belém Velho;Farrapos;150;0;68;17;50;100
780;Belém Velho;Farroupilha;50;0;26;16;0;50
781;Belém Velho;Floresta;100;50;31;5;50;50
782;Belém Velho;Glória;250;0;150;46;0;250
783;Belém Velho;Guarujá;100;50;21;8;50;50
784;Belém Velho;Higienópolis;150;0;86;32;0;150
785;Belém Velho;Humaitá;50;0;31;6;0;50
786;Belém Velho;Hípica;450;150;174;42;150;300
787;Belém Velho;Independência;50;0;31;15;0;50
788;Belém Velho;Ipanema;400;50;211;67;50;350
789;Belém Velho;Jardim Botânico;50;0;34;11;0;50
790;Belém Velho;Jardim Carvalho;150;50;38;6;100;50
791;Belém Velho;Jardim Europa;0;0;0;0;0;0
792;Belém Velho;Jardim Floresta;0;0;0;0;0;0
793;Belém Velho;Jardim Isabel;50;50;0;0;50;0
794;Belém Velho;Jardim Itú;0;0;0;0;0;0
795;Belém Velho;Jardim Leopoldina;200;0;121;30;0;200
796;Belém Velho;Jardim Lindóia;150;0;98;35;50;100
797;Belém Velho;Jardim Sabará;50;50;0;0;50;0
798;Belém Velho;Jardim São Pedro;0;0;0;0;0;0
799;Belém Velho;Jardim do Salso;50;0;0;0;50;0
800;Belém Velho;Lageado;50;50;0;0;50;0
801;Belém Velho;Lami;0;0;0;0;0;0
802;Belém Velho;Lomba do Pinheiro;1500;100;802;172;250;1250
803;Belém Velho;Medianeira;0;0;0;0;0;0
804;Belém Velho;Menino Deus;200;100;56;24;100;100
805;Belém Velho;Moinhos de Vento;50;0;0;0;50;0
806;Belém Velho;Mont'Serrat;100;50;0;0;100;0
807;Belém Velho;Morro Santana;100;50;0;0;100;0
808;Belém Velho;Mário Quintana;350;50;171;31;50;300
809;Belém Velho;Navegantes;0;0;0;0;0;0
810;Belém Velho;Nonoai;400;50;192;58;100;300
811;Belém Velho;Parque Santa Fé;50;0;33;13;0;50
812;Belém Velho;Partenon;200;100;51;28;100;100
813;Belém Velho;Passo D'Areia;0;0;0;0;0;0
814;Belém Velho;Passo das Pedras;150;50;63;11;50;100
815;Belém Velho;Pedra Redonda;0;0;0;0;0;0
816;Belém Velho;Petrópolis;450;200;136;44;300;150
817;Belém Velho;Pitinga;50;0;33;6;0;50
818;Belém Velho;Ponta Grossa;100;50;26;11;50;50
819;Belém Velho;Praia de Belas;50;0;29;11;0;50
820;Belém Velho;Restinga;1550;200;679;144;450;1100
821;Belém Velho;Rio Branco;50;0;25;9;0;50
822;Belém Velho;Rubem Berta;150;0;74;32;0;150
823;Belém Velho;Santa Cecília;250;50;111;51;50;200
824;Belém Velho;Santa Maria Goretti;0;0;0;0;0;0
825;Belém Velho;Santa Rosa de Lima;350;50;144;50;100;250
826;Belém Velho;Santa Tereza;200;0;86;32;50;150
827;Belém Velho;Santana;50;0;29;9;0;50
828;Belém Velho;Santo Antônio;50;0;30;13;0;50
829;Belém Velho;Sarandi;600;50;267;126;100;500
830;Belém Velho;Serraria;200;0;142;38;0;200
831;Belém Velho;São Caetano;150;0;103;29;0;150
832;Belém Velho;São Geraldo;0;0;0;0;0;0
833;Belém Velho;São José;850;100;452;90;200;650
834;Belém Velho;São João;0;0;0;0;0;0
835;Belém Velho;São Sebastião;50;0;0;0;50;0
836;Belém Velho;Sétimo Céu;50;0;32;9;0;50
837;Belém Velho;Teresópolis;850;100;307;95;350;500
838;Belém Velho;Tristeza;100;0;60;23;0;100
839;Belém Velho;Três Figueiras;50;0;35;8;0;50
840;Belém Velho;Vila Assunção;0;0;0;0;0;0
841;Belém Velho;Vila Conceição;50;0;29;17;0;50
842;Belém Velho;Vila Ipiranga;150;100;26;15;100;50
843;Belém Velho;Vila Jardim;100;50;36;9;50;50
844;Belém Velho;Vila João Pessoa;250;0;161;38;0;250
845;Belém Velho;Vila Nova;4450;550;1928;670;1100;3350
846;Boa Vista;Aberta dos Morros;50;0;28;13;0;50
847;Boa Vista;Agronomia;0;0;0;0;0;0
848;Boa Vista;Anchieta;0;0;0;0;0;0
849;Boa Vista;Arquipélago;0;0;0;0;0;0
850;Boa Vista;Auxiliadora;950;100;433;180;200;750
851;Boa Vista;Azenha;150;0;21;17;100;50
852;Boa Vista;Bela Vista;350;50;138;75;100;250
853;Boa Vista;Belém Novo;100;100;0;0;100;0
854;Boa Vista;Belém Velho;50;0;28;8;0;50
855;Boa Vista;Boa Vista;2700;200;1470;548;200;2500
856;Boa Vista;Boa Vista do Sul;0;0;0;0;0;0
857;Boa Vista;Bom Fim;50;0;15;17;0;50
858;Boa Vista;Bom Jesus;300;100;28;10;250;50
859;Boa Vista;Camaquã;50;0;28;9;0;50
860;Boa Vista;Campo Novo;100;0;29;6;50;50
861;Boa Vista;Cascata;50;0;38;7;0;50
862;Boa Vista;Cavalhada;300;150;81;37;150;150
863;Boa Vista;Cel. Aparício Borges;50;0;30;4;0;50
864;Boa Vista;Centro Histórico;400;0;168;83;100;300
865;Boa Vista;Chapéu do Sol;0;0;0;0;0;0
866;Boa Vista;Chácara das Pedras;350;100;87;35;200;150
867;Boa Vista;Cidade Baixa;100;0;34;24;0;100
868;Boa Vista;Costa e Silva;100;0;54;19;0;100
869;Boa Vista;Cristal;150;0;92;23;0;150
870;Boa Vista;Cristo Redentor;700;100;343;93;300;400
871;Boa Vista;Espírito Santo;0;0;0;0;0;0
872;Boa Vista;Extrema;50;0;28;13;0;50
873;Boa Vista;Farrapos;100;0;58;22;0;100
874;Boa Vista;Farroupilha;100;0;54;32;0;100
875;Boa Vista;Floresta;100;0;29;18;50;50
876;Boa Vista;Glória;200;0;103;50;0;200
877;Boa Vista;Guarujá;0;0;0;0;0;0
878;Boa Vista;Higienópolis;1400;150;669;275;250;1150
879;Boa Vista;Humaitá;100;50;39;5;50;50
880;Boa Vista;Hípica;0;0;0;0;0;0
881;Boa Vista;Independência;100;0;26;18;50;50
882;Boa Vista;Ipanema;50;50;0;0;50;0
883;Boa Vista;Jardim Botânico;0;0;0;0;0;0
884;Boa Vista;Jardim Carvalho;50;0;23;14;0;50
885;Boa Vista;Jardim Europa;250;50;85;26;100;150
886;Boa Vista;Jardim Floresta;200;0;139;38;50;150
887;Boa Vista;Jardim Isabel;0;0;0;0;0;0
888;Boa Vista;Jardim Itú;201;50;68;20;101;100
889;Boa Vista;Jardim Leopoldina;250;50;84;10;200;50
890;Boa Vista;Jardim Lindóia;200;50;31;11;150;50
891;Boa Vista;Jardim Sabará;150;0;86;38;0;150
892;Boa Vista;Jardim São Pedro;400;50;179;62;100;300
893;Boa Vista;Jardim do Salso;50;50;0;0;50;0
894;Boa Vista;Lageado;0;0;0;0;0;0
895;Boa Vista;Lami;0;0;0;0;0;0
896;Boa Vista;Lomba do Pinheiro;150;0;95;22;0;150
897;Boa Vista;Medianeira;100;0;57;20;0;100
898;Boa Vista;Menino Deus;150;0;81;35;0;150
899;Boa Vista;Moinhos de Vento;300;0;143;66;50;250
900;Boa Vista;Mont'Serrat;850;150;392;164;150;700
901;Boa Vista;Morro Santana;150;0;96;29;0;150
902;Boa Vista;Mário Quintana;150;100;34;3;100;50
903;Boa Vista;Navegantes;100;0;67;18;0;100
904;Boa Vista;Nonoai;50;0;25;10;0;50
905;Boa Vista;Parque Santa Fé;0;0;0;0;0;0
906;Boa Vista;Partenon;150;0;93;22;50;100
907;Boa Vista;Passo D'Areia;1950;100;773;544;200;1750
908;Boa Vista;Passo das Pedras;200;100;38;6;150;50
909;Boa Vista;Pedra Redonda;0;0;0;0;0;0
910;Boa Vista;Petrópolis;650;50;254;125;200;450
911;Boa Vista;Pitinga;50;0;25;15;0;50
912;Boa Vista;Ponta Grossa;50;0;26;8;0;50
913;Boa Vista;Praia de Belas;0;0;0;0;0;0
914;Boa Vista;Restinga;100;50;29;13;50;50
915;Boa Vista;Rio Branco;400;0;179;108;50;350
916;Boa Vista;Rubem Berta;100;0;23;18;50;50
917;Boa Vista;Santa Cecília;300;0;137;71;50;250
918;Boa Vista;Santa Maria Goretti;750;0;395;92;200;550
919;Boa Vista;Santa Rosa de Lima;200;50;77;37;50;150
920;Boa Vista;Santa Tereza;300;50;161;44;50;250
921;Boa Vista;Santana;150;50;49;24;50;100
922;Boa Vista;Santo Antônio;0;0;0;0;0;0
923;Boa Vista;Sarandi;150;50;60;25;50;100
924;Boa Vista;Serraria;0;0;0;0;0;0
925;Boa Vista;São Caetano;50;0;50;0;50;0
926;Boa Vista;São Geraldo;50;0;0;0;50;0
927;Boa Vista;São José;100;0;68;17;0;100
928;Boa Vista;São João;350;0;190;75;0;350
929;Boa Vista;São Sebastião;200;50;85;32;50;150
930;Boa Vista;Sétimo Céu;0;0;0;0;0;0
931;Boa Vista;Teresópolis;200;50;59;31;100;100
932;Boa Vista;Tristeza;0;0;0;0;0;0
933;Boa Vista;Três Figueiras;800;150;393;138;250;550
934;Boa Vista;Vila Assunção;100;50;24;16;50;50
935;Boa Vista;Vila Conceição;0;0;0;0;0;0
936;Boa Vista;Vila Ipiranga;600;150;249;97;150;450
937;Boa Vista;Vila Jardim;300;100;90;41;150;150
938;Boa Vista;Vila João Pessoa;50;0;25;9;0;50
939;Boa Vista;Vila Nova;50;0;32;8;0;50
940;Boa Vista do Sul;Aberta dos Morros;100;0;32;8;50;50
941;Boa Vista do Sul;Agronomia;100;0;25;10;50;50
942;Boa Vista do Sul;Anchieta;0;0;0;0;0;0
943;Boa Vista do Sul;Arquipélago;50;0;50;0;50;0
944;Boa Vista do Sul;Auxiliadora;0;0;0;0;0;0
945;Boa Vista do Sul;Azenha;50;0;25;12;0;50
946;Boa Vista do Sul;Bela Vista;50;0;26;12;0;50
947;Boa Vista do Sul;Belém Novo;250;50;87;29;100;150
948;Boa Vista do Sul;Belém Velho;0;0;0;0;0;0
949;Boa Vista do Sul;Boa Vista;0;0;0;0;0;0
950;Boa Vista do Sul;Boa Vista do Sul;600;300;188;50;300;300
951;Boa Vista do Sul;Bom Fim;50;0;23;23;0;50
952;Boa Vista do Sul;Bom Jesus;50;0;27;10;0;50
953;Boa Vista do Sul;Camaquã;0;0;0;0;0;0
954;Boa Vista do Sul;Campo Novo;0;0;0;0;0;0
955;Boa Vista do Sul;Cascata;0;0;0;0;0;0
956;Boa Vista do Sul;Cavalhada;0;0;0;0;0;0
957;Boa Vista do Sul;Cel. Aparício Borges;50;50;0;0;50;0
958;Boa Vista do Sul;Centro Histórico;100;0;35;31;0;100
959;Boa Vista do Sul;Chapéu do Sol;0;0;0;0;0;0
960;Boa Vista do Sul;Chácara das Pedras;50;0;23;19;0;50
961;Boa Vista do Sul;Cidade Baixa;50;0;0;0;50;0
962;Boa Vista do Sul;Costa e Silva;50;50;0;0;50;0
963;Boa Vista do Sul;Cristal;150;50;0;0;150;0
964;Boa Vista do Sul;Cristo Redentor;50;0;27;9;0;50
965;Boa Vista do Sul;Espírito Santo;0;0;0;0;0;0
966;Boa Vista do Sul;Extrema;0;0;0;0;0;0
967;Boa Vista do Sul;Farrapos;100;0;67;15;0;100
968;Boa Vista do Sul;Farroupilha;0;0;0;0;0;0
969;Boa Vista do Sul;Floresta;100;0;54;31;0;100
970;Boa Vista do Sul;Glória;50;50;0;0;50;0
971;Boa Vista do Sul;Guarujá;0;0;0;0;0;0
972;Boa Vista do Sul;Higienópolis;0;0;0;0;0;0
973;Boa Vista do Sul;Humaitá;150;50;35;7;100;50
974;Boa Vista do Sul;Hípica;150;0;87;25;0;150
975;Boa Vista do Sul;Independência;50;0;26;14;0;50
976;Boa Vista do Sul;Ipanema;50;0;27;15;0;50
977;Boa Vista do Sul;Jardim Botânico;0;0;0;0;0;0
978;Boa Vista do Sul;Jardim Carvalho;50;0;28;6;0;50
979;Boa Vista do Sul;Jardim Europa;0;0;0;0;0;0
980;Boa Vista do Sul;Jardim Floresta;0;0;0;0;0;0
981;Boa Vista do Sul;Jardim Isabel;0;0;0;0;0;0
982;Boa Vista do Sul;Jardim Itú;50;0;23;10;0;50
983;Boa Vista do Sul;Jardim Leopoldina;150;100;0;0;150;0
984;Boa Vista do Sul;Jardim Lindóia;50;0;23;10;0;50
985;Boa Vista do Sul;Jardim Sabará;100;0;24;12;50;50
986;Boa Vista do Sul;Jardim São Pedro;0;0;0;0;0;0
987;Boa Vista do Sul;Jardim do Salso;150;50;27;12;100;50
988;Boa Vista do Sul;Lageado;50;0;0;0;50;0
989;Boa Vista do Sul;Lami;100;0;31;4;50;50
990;Boa Vista do Sul;Lomba do Pinheiro;350;100;119;34;150;200
991;Boa Vista do Sul;Medianeira;50;0;26;13;0;50
992;Boa Vista do Sul;Menino Deus;200;0;53;23;100;100
993;Boa Vista do Sul;Moinhos de Vento;100;50;0;0;100;0
994;Boa Vista do Sul;Mont'Serrat;0;0;0;0;0;0
995;Boa Vista do Sul;Morro Santana;150;50;31;12;100;50
996;Boa Vista do Sul;Mário Quintana;150;0;93;15;0;150
997;Boa Vista do Sul;Navegantes;0;0;0;0;0;0
998;Boa Vista do Sul;Nonoai;100;0;30;11;50;50
999;Boa Vista do Sul;Parque Santa Fé;0;0;0;0;0;0
1000;Boa Vista do Sul;Partenon;450;0;222;88;50;400
1001;Boa Vista do Sul;Passo D'Areia;50;0;19;15;0;50
1002;Boa Vista do Sul;Passo das Pedras;150;100;28;6;100;50
1003;Boa Vista do Sul;Pedra Redonda;0;0;0;0;0;0
1004;Boa Vista do Sul;Petrópolis;300;50;133;50;100;200
1005;Boa Vista do Sul;Pitinga;100;0;65;20;0;100
1006;Boa Vista do Sul;Ponta Grossa;100;100;0;0;100;0
1007;Boa Vista do Sul;Praia de Belas;0;0;0;0;0;0
1008;Boa Vista do Sul;Restinga;100;0;59;19;0;100
1009;Boa Vista do Sul;Rio Branco;150;0;28;11;100;50
1010;Boa Vista do Sul;Rubem Berta;200;0;104;68;0;200
1011;Boa Vista do Sul;Santa Cecília;50;50;0;0;50;0
1012;Boa Vista do Sul;Santa Maria Goretti;0;0;0;0;0;0
1013;Boa Vista do Sul;Santa Rosa de Lima;200;50;88;23;50;150
1014;Boa Vista do Sul;Santa Tereza;300;50;159;40;100;200
1015;Boa Vista do Sul;Santana;0;0;0;0;0;0
1016;Boa Vista do Sul;Santo Antônio;0;0;0;0;0;0
1017;Boa Vista do Sul;Sarandi;250;0;107;52;50;200
1018;Boa Vista do Sul;Serraria;50;0;0;0;50;0
1019;Boa Vista do Sul;São Caetano;50;0;23;12;0;50
1020;Boa Vista do Sul;São Geraldo;50;0;25;17;0;50
1021;Boa Vista do Sul;São José;150;50;53;13;50;100
1022;Boa Vista do Sul;São João;0;0;0;0;0;0
1023;Boa Vista do Sul;São Sebastião;0;0;0;0;0;0
1024;Boa Vista do Sul;Sétimo Céu;0;0;0;0;0;0
1025;Boa Vista do Sul;Teresópolis;150;0;60;20;50;100
1026;Boa Vista do Sul;Tristeza;50;0;23;17;0;50
1027;Boa Vista do Sul;Três Figueiras;0;0;0;0;0;0
1028;Boa Vista do Sul;Vila Assunção;50;0;25;11;0;50
1029;Boa Vista do Sul;Vila Conceição;0;0;0;0;0;0
1030;Boa Vista do Sul;Vila Ipiranga;100;0;71;15;0;100
1031;Boa Vista do Sul;Vila Jardim;100;0;29;12;50;50
1032;Boa Vista do Sul;Vila João Pessoa;50;0;25;12;0;50
1033;Boa Vista do Sul;Vila Nova;100;100;0;0;100;0
1034;Bom Fim;Aberta dos Morros;0;0;0;0;0;0
1035;Bom Fim;Agronomia;0;0;0;0;0;0
1036;Bom Fim;Anchieta;50;0;26;8;0;50
1037;Bom Fim;Arquipélago;250;0;132;47;0;250
1038;Bom Fim;Auxiliadora;250;0;52;36;150;100
1039;Bom Fim;Azenha;550;100;184;103;200;350
1040;Bom Fim;Bela Vista;250;0;108;31;150;100
1041;Bom Fim;Belém Novo;50;0;26;19;0;50
1042;Bom Fim;Belém Velho;0;0;0;0;0;0
1043;Bom Fim;Boa Vista;50;0;15;17;0;50
1044;Bom Fim;Boa Vista do Sul;50;0;23;23;0;50
1045;Bom Fim;Bom Fim;4400;1200;1060;540;2500;1900
1046;Bom Fim;Bom Jesus;150;0;80;26;0;150
1047;Bom Fim;Camaquã;50;50;0;0;50;0
1048;Bom Fim;Campo Novo;100;0;70;14;0;100
1049;Bom Fim;Cascata;50;0;27;17;0;50
1050;Bom Fim;Cavalhada;100;0;21;19;50;50
1051;Bom Fim;Cel. Aparício Borges;100;0;43;20;0;100
1052;Bom Fim;Centro Histórico;2500;200;903;358;1050;1450
1053;Bom Fim;Chapéu do Sol;100;0;0;0;100;0
1054;Bom Fim;Chácara das Pedras;100;0;39;9;50;50
1055;Bom Fim;Cidade Baixa;1550;0;542;302;450;1100
1056;Bom Fim;Costa e Silva;100;50;0;0;100;0
1057;Bom Fim;Cristal;200;50;43;28;100;100
1058;Bom Fim;Cristo Redentor;250;0;120;53;50;200
1059;Bom Fim;Espírito Santo;100;50;23;12;50;50
1060;Bom Fim;Extrema;0;0;0;0;0;0
1061;Bom Fim;Farrapos;150;0;88;35;0;150
1062;Bom Fim;Farroupilha;1547;100;509;260;597;950
1063;Bom Fim;Floresta;750;50;155;105;450;300
1064;Bom Fim;Glória;0;0;0;0;0;0
1065;Bom Fim;Guarujá;0;0;0;0;0;0
1066;Bom Fim;Higienópolis;200;50;40;8;150;50
1067;Bom Fim;Humaitá;100;0;71;11;0;100
1068;Bom Fim;Hípica;50;50;0;0;50;0
1069;Bom Fim;Independência;3550;400;1088;631;1350;2200
1070;Bom Fim;Ipanema;0;0;0;0;0;0
1071;Bom Fim;Jardim Botânico;350;0;180;82;50;300
1072;Bom Fim;Jardim Carvalho;250;0;83;41;100;150
1073;Bom Fim;Jardim Europa;100;0;31;12;50;50
1074;Bom Fim;Jardim Floresta;100;0;50;22;0;100
1075;Bom Fim;Jardim Isabel;0;0;0;0;0;0
1076;Bom Fim;Jardim Itú;100;0;61;26;0;100
1077;Bom Fim;Jardim Leopoldina;100;50;0;0;100;0
1078;Bom Fim;Jardim Lindóia;100;0;63;24;0;100
1079;Bom Fim;Jardim Sabará;150;0;51;29;50;100
1080;Bom Fim;Jardim São Pedro;100;0;25;16;50;50
1081;Bom Fim;Jardim do Salso;0;0;0;0;0;0
1082;Bom Fim;Lageado;50;0;30;14;0;50
1083;Bom Fim;Lami;100;0;31;8;50;50
1084;Bom Fim;Lomba do Pinheiro;100;50;0;0;100;0
1085;Bom Fim;Medianeira;100;0;56;23;0;100
1086;Bom Fim;Menino Deus;700;100;270;162;200;500
1087;Bom Fim;Moinhos de Vento;1400;250;477;295;450;950
1088;Bom Fim;Mont'Serrat;50;0;32;9;0;50
1089;Bom Fim;Morro Santana;0;0;0;0;0;0
1090;Bom Fim;Mário Quintana;50;50;0;0;50;0
1091;Bom Fim;Navegantes;150;0;0;0;150;0
1092;Bom Fim;Nonoai;200;50;26;9;150;50
1093;Bom Fim;Parque Santa Fé;100;0;21;17;50;50
1094;Bom Fim;Partenon;350;50;132;43;100;250
1095;Bom Fim;Passo D'Areia;0;0;0;0;0;0
1096;Bom Fim;Passo das Pedras;100;50;32;18;50;50
1097;Bom Fim;Pedra Redonda;50;0;0;0;50;0
1098;Bom Fim;Petrópolis;500;50;168;95;150;350
1099;Bom Fim;Pitinga;50;0;30;12;0;50
1100;Bom Fim;Ponta Grossa;50;0;26;8;0;50
1101;Bom Fim;Praia de Belas;350;0;127;71;100;250
1102;Bom Fim;Restinga;100;0;33;5;50;50
1103;Bom Fim;Rio Branco;2750;150;1146;658;450;2300
1104;Bom Fim;Rubem Berta;300;50;69;62;150;150
1105;Bom Fim;Santa Cecília;600;100;95;58;400;200
1106;Bom Fim;Santa Maria Goretti;50;0;21;16;0;50
1107;Bom Fim;Santa Rosa de Lima;0;0;0;0;0;0
1108;Bom Fim;Santa Tereza;300;0;101;51;100;200
1109;Bom Fim;Santana;1100;150;344;212;400;700
1110;Bom Fim;Santo Antônio;50;0;0;0;50;0
1111;Bom Fim;Sarandi;450;50;229;106;50;400
1112;Bom Fim;Serraria;50;0;21;11;0;50
1113;Bom Fim;São Caetano;0;0;0;0;0;0
1114;Bom Fim;São Geraldo;200;50;28;18;150;50
1115;Bom Fim;São José;50;0;26;10;0;50
1116;Bom Fim;São João;350;50;116;53;150;200
1117;Bom Fim;São Sebastião;50;0;26;12;0;50
1118;Bom Fim;Sétimo Céu;0;0;0;0;0;0
1119;Bom Fim;Teresópolis;150;100;50;0;150;0
1120;Bom Fim;Tristeza;0;0;0;0;0;0
1121;Bom Fim;Três Figueiras;0;0;0;0;0;0
1122;Bom Fim;Vila Assunção;0;0;0;0;0;0
1123;Bom Fim;Vila Conceição;50;0;0;0;50;0
1124;Bom Fim;Vila Ipiranga;100;0;32;10;50;50
1125;Bom Fim;Vila Jardim;100;0;25;11;50;50
1126;Bom Fim;Vila João Pessoa;50;0;28;14;0;50
1127;Bom Fim;Vila Nova;50;0;18;22;0;50
1128;Bom Jesus;Aberta dos Morros;0;0;0;0;0;0
1129;Bom Jesus;Agronomia;650;200;97;23;500;150
1130;Bom Jesus;Anchieta;250;50;55;18;150;100
1131;Bom Jesus;Arquipélago;150;0;93;29;0;150
1132;Bom Jesus;Auxiliadora;50;0;22;18;0;50
1133;Bom Jesus;Azenha;0;0;0;0;0;0
1134;Bom Jesus;Bela Vista;150;0;24;8;100;50
1135;Bom Jesus;Belém Novo;50;0;25;11;0;50
1136;Bom Jesus;Belém Velho;250;0;118;40;50;200
1137;Bom Jesus;Boa Vista;300;100;28;10;250;50
1138;Bom Jesus;Boa Vista do Sul;50;0;27;10;0;50
1139;Bom Jesus;Bom Fim;150;0;80;26;0;150
1140;Bom Jesus;Bom Jesus;24700;4300;9810;2814;8700;16000
1141;Bom Jesus;Camaquã;0;0;0;0;0;0
1142;Bom Jesus;Campo Novo;250;150;32;10;200;50
1143;Bom Jesus;Cascata;300;0;113;26;100;200
1144;Bom Jesus;Cavalhada;100;0;23;11;50;50
1145;Bom Jesus;Cel. Aparício Borges;350;50;94;24;200;150
1146;Bom Jesus;Centro Histórico;250;0;53;20;150;100
1147;Bom Jesus;Chapéu do Sol;100;50;37;9;50;50
1148;Bom Jesus;Chácara das Pedras;1700;150;866;282;250;1450
1149;Bom Jesus;Cidade Baixa;150;0;28;18;100;50
1150;Bom Jesus;Costa e Silva;200;200;0;0;200;0
1151;Bom Jesus;Cristal;250;50;82;31;100;150
1152;Bom Jesus;Cristo Redentor;200;50;65;23;100;100
1153;Bom Jesus;Espírito Santo;0;0;0;0;0;0
1154;Bom Jesus;Extrema;100;0;81;12;50;50
1155;Bom Jesus;Farrapos;200;100;50;0;200;0
1156;Bom Jesus;Farroupilha;200;50;67;23;100;100
1157;Bom Jesus;Floresta;150;0;43;29;50;100
1158;Bom Jesus;Glória;200;100;54;20;100;100
1159;Bom Jesus;Guarujá;250;50;89;16;100;150
1160;Bom Jesus;Higienópolis;300;100;103;32;150;150
1161;Bom Jesus;Humaitá;200;0;115;32;0;200
1162;Bom Jesus;Hípica;150;50;25;6;100;50
1163;Bom Jesus;Independência;100;0;64;19;0;100
1164;Bom Jesus;Ipanema;50;0;22;9;0;50
1165;Bom Jesus;Jardim Botânico;700;200;200;70;350;350
1166;Bom Jesus;Jardim Carvalho;1600;400;520;138;850;750
1167;Bom Jesus;Jardim Europa;619;150;160;62;319;300
1168;Bom Jesus;Jardim Floresta;100;0;60;14;0;100
1169;Bom Jesus;Jardim Isabel;150;100;22;8;100;50
1170;Bom Jesus;Jardim Itú;350;0;156;59;50;300
1171;Bom Jesus;Jardim Leopoldina;250;50;83;30;100;150
1172;Bom Jesus;Jardim Lindóia;200;100;63;15;100;100
1173;Bom Jesus;Jardim Sabará;2800;50;1384;426;450;2350
1174;Bom Jesus;Jardim São Pedro;0;0;0;0;0;0
1175;Bom Jesus;Jardim do Salso;2750;500;1202;378;700;2050
1176;Bom Jesus;Lageado;100;0;59;16;0;100
1177;Bom Jesus;Lami;150;0;98;21;0;150
1178;Bom Jesus;Lomba do Pinheiro;750;200;156;28;500;250
1179;Bom Jesus;Medianeira;0;0;0;0;0;0
1180;Bom Jesus;Menino Deus;50;0;28;6;0;50
1181;Bom Jesus;Moinhos de Vento;250;0;100;62;50;200
1182;Bom Jesus;Mont'Serrat;200;50;79;23;50;150
1183;Bom Jesus;Morro Santana;1350;150;698;179;300;1050
1184;Bom Jesus;Mário Quintana;450;0;247;49;50;400
1185;Bom Jesus;Navegantes;200;50;55;25;100;100
1186;Bom Jesus;Nonoai;300;100;139;43;100;200
1187;Bom Jesus;Parque Santa Fé;50;0;0;0;50;0
1188;Bom Jesus;Partenon;1100;550;107;28;900;200
1189;Bom Jesus;Passo D'Areia;400;100;141;102;100;300
1190;Bom Jesus;Passo das Pedras;450;200;112;45;250;200
1191;Bom Jesus;Pedra Redonda;200;0;110;46;0;200
1192;Bom Jesus;Petrópolis;200;100;27;7;150;50
1193;Bom Jesus;Pitinga;0;0;0;0;0;0
1194;Bom Jesus;Ponta Grossa;100;0;61;21;0;100
1195;Bom Jesus;Praia de Belas;200;50;61;12;100;100
1196;Bom Jesus;Restinga;150;50;64;14;50;100
1197;Bom Jesus;Rio Branco;400;0;168;76;100;300
1198;Bom Jesus;Rubem Berta;100;50;25;20;50;50
1199;Bom Jesus;Santa Cecília;150;100;27;7;100;50
1200;Bom Jesus;Santa Maria Goretti;150;0;55;18;50;100
1201;Bom Jesus;Santa Rosa de Lima;350;150;142;27;200;150
1202;Bom Jesus;Santa Tereza;350;50;134;48;100;250
1203;Bom Jesus;Santana;100;0;23;13;50;50
1204;Bom Jesus;Santo Antônio;250;0;150;44;0;250
1205;Bom Jesus;Sarandi;250;0;121;38;50;200
1206;Bom Jesus;Serraria;150;0;92;26;0;150
1207;Bom Jesus;São Caetano;100;0;27;7;50;50
1208;Bom Jesus;São Geraldo;50;0;32;5;0;50
1209;Bom Jesus;São José;450;100;238;41;150;300
1210;Bom Jesus;São João;0;0;0;0;0;0
1211;Bom Jesus;São Sebastião;200;50;37;7;150;50
1212;Bom Jesus;Sétimo Céu;0;0;0;0;0;0
1213;Bom Jesus;Teresópolis;50;0;32;7;0;50
1214;Bom Jesus;Tristeza;0;0;0;0;0;0
1215;Bom Jesus;Três Figueiras;250;0;149;45;0;250
1216;Bom Jesus;Vila Assunção;0;0;0;0;0;0
1217;Bom Jesus;Vila Conceição;0;0;0;0;0;0
1218;Bom Jesus;Vila Ipiranga;750;150;320;107;200;550
1219;Bom Jesus;Vila Jardim;2400;900;693;230;1200;1200
1220;Bom Jesus;Vila João Pessoa;600;50;335;117;50;550
1221;Bom Jesus;Vila Nova;150;0;96;27;0;150
1222;Camaquã;Aberta dos Morros;200;0;119;44;0;200
1223;Camaquã;Agronomia;0;0;0;0;0;0
1224;Camaquã;Anchieta;50;0;0;0;50;0
1225;Camaquã;Arquipélago;150;50;0;0;150;0
1226;Camaquã;Auxiliadora;0;0;0;0;0;0
1227;Camaquã;Azenha;200;100;50;0;200;0
1228;Camaquã;Bela Vista;100;50;30;14;50;50
1229;Camaquã;Belém Novo;50;0;28;8;0;50
1230;Camaquã;Belém Velho;50;0;0;0;50;0
1231;Camaquã;Boa Vista;50;0;28;9;0;50
1232;Camaquã;Boa Vista do Sul;0;0;0;0;0;0
1233;Camaquã;Bom Fim;50;50;0;0;50;0
1234;Camaquã;Bom Jesus;0;0;0;0;0;0
1235;Camaquã;Camaquã;12400;600;6454;2424;1100;11300
1236;Camaquã;Campo Novo;350;150;108;41;150;200
1237;Camaquã;Cascata;0;0;0;0;0;0
1238;Camaquã;Cavalhada;2350;450;952;355;650;1700
1239;Camaquã;Cel. Aparício Borges;200;50;84;21;50;150
1240;Camaquã;Centro Histórico;200;0;79;46;50;150
1241;Camaquã;Chapéu do Sol;50;0;0;0;50;0
1242;Camaquã;Chácara das Pedras;0;0;0;0;0;0
1243;Camaquã;Cidade Baixa;50;0;27;15;0;50
1244;Camaquã;Costa e Silva;250;50;83;25;100;150
1245;Camaquã;Cristal;3250;600;1266;370;1200;2050
1246;Camaquã;Cristo Redentor;250;50;49;19;150;100
1247;Camaquã;Espírito Santo;200;0;92;26;50;150
1248;Camaquã;Extrema;50;0;31;8;0;50
1249;Camaquã;Farrapos;0;0;0;0;0;0
1250;Camaquã;Farroupilha;100;50;0;0;100;0
1251;Camaquã;Floresta;0;0;0;0;0;0
1252;Camaquã;Glória;350;100;79;41;200;150
1253;Camaquã;Guarujá;500;150;203;37;250;250
1254;Camaquã;Higienópolis;50;0;0;0;50;0
1255;Camaquã;Humaitá;100;50;28;7;50;50
1256;Camaquã;Hípica;150;0;92;34;0;150
1257;Camaquã;Independência;0;0;0;0;0;0
1258;Camaquã;Ipanema;550;150;224;74;200;350
1259;Camaquã;Jardim Botânico;50;0;0;0;50;0
1260;Camaquã;Jardim Carvalho;0;0;0;0;0;0
1261;Camaquã;Jardim Europa;150;0;65;15;50;100
1262;Camaquã;Jardim Floresta;0;0;0;0;0;0
1263;Camaquã;Jardim Isabel;1700;100;857;344;150;1550
1264;Camaquã;Jardim Itú;0;0;0;0;0;0
1265;Camaquã;Jardim Leopoldina;50;0;34;8;0;50
1266;Camaquã;Jardim Lindóia;0;0;0;0;0;0
1267;Camaquã;Jardim Sabará;0;0;0;0;0;0
1268;Camaquã;Jardim São Pedro;0;0;0;0;0;0
1269;Camaquã;Jardim do Salso;50;0;26;9;0;50
1270;Camaquã;Lageado;0;0;0;0;0;0
1271;Camaquã;Lami;50;50;0;0;50;0
1272;Camaquã;Lomba do Pinheiro;150;0;53;27;50;100
1273;Camaquã;Medianeira;450;150;166;51;250;200
1274;Camaquã;Menino Deus;150;50;30;12;100;50
1275;Camaquã;Moinhos de Vento;50;0;31;9;0;50
1276;Camaquã;Mont'Serrat;50;0;27;17;0;50
1277;Camaquã;Morro Santana;50;0;0;0;50;0
1278;Camaquã;Mário Quintana;50;0;0;0;50;0
1279;Camaquã;Navegantes;50;0;27;11;0;50
1280;Camaquã;Nonoai;1850;250;816;281;500;1350
1281;Camaquã;Parque Santa Fé;0;0;0;0;0;0
1282;Camaquã;Partenon;350;100;91;25;200;150
1283;Camaquã;Passo D'Areia;150;0;19;19;100;50
1284;Camaquã;Passo das Pedras;150;50;0;0;150;0
1285;Camaquã;Pedra Redonda;200;50;60;22;100;100
1286;Camaquã;Petrópolis;400;50;116;52;200;200
1287;Camaquã;Pitinga;50;0;50;0;50;0
1288;Camaquã;Ponta Grossa;150;0;54;24;50;100
1289;Camaquã;Praia de Belas;100;0;54;26;0;100
1290;Camaquã;Restinga;300;50;143;33;50;250
1291;Camaquã;Rio Branco;50;0;27;8;0;50
1292;Camaquã;Rubem Berta;50;50;0;0;50;0
1293;Camaquã;Santa Cecília;150;50;57;19;50;100
1294;Camaquã;Santa Maria Goretti;0;0;0;0;0;0
1295;Camaquã;Santa Rosa de Lima;150;0;53;18;50;100
1296;Camaquã;Santa Tereza;500;100;240;65;150;350
1297;Camaquã;Santana;0;0;0;0;0;0
1298;Camaquã;Santo Antônio;50;50;0;0;50;0
1299;Camaquã;Sarandi;50;0;26;16;0;50
1300;Camaquã;Serraria;0;0;0;0;0;0
1301;Camaquã;São Caetano;0;0;0;0;0;0
1302;Camaquã;São Geraldo;100;0;57;21;0;100
1303;Camaquã;São José;200;0;92;33;50;150
1304;Camaquã;São João;150;0;60;14;50;100
1305;Camaquã;São Sebastião;50;0;29;12;0;50
1306;Camaquã;Sétimo Céu;1400;300;577;201;400;1000
1307;Camaquã;Teresópolis;850;100;448;136;100;750
1308;Camaquã;Tristeza;1250;400;451;217;450;800
1309;Camaquã;Três Figueiras;100;0;46;26;0;100
1310;Camaquã;Vila Assunção;900;200;160;73;600;300
1311;Camaquã;Vila Conceição;300;50;154;46;50;250
1312;Camaquã;Vila Ipiranga;200;0;54;23;100;100
1313;Camaquã;Vila Jardim;50;50;0;0;50;0
1314;Camaquã;Vila João Pessoa;150;50;67;18;50;100
1315;Camaquã;Vila Nova;600;0;263;82;150;450
1316;Campo Novo;Aberta dos Morros;1733;50;868;234;283;1450
1317;Campo Novo;Agronomia;100;0;57;16;0;100
1318;Campo Novo;Anchieta;0;0;0;0;0;0
1319;Campo Novo;Arquipélago;50;0;0;0;50;0
1320;Campo Novo;Auxiliadora;100;0;58;16;0;100
1321;Campo Novo;Azenha;50;0;34;10;0;50
1322;Campo Novo;Bela Vista;0;0;0;0;0;0
1323;Campo Novo;Belém Novo;300;50;105;54;100;200
1324;Campo Novo;Belém Velho;1568;600;293;43;1268;300
1325;Campo Novo;Boa Vista;100;0;29;6;50;50
1326;Campo Novo;Boa Vista do Sul;0;0;0;0;0;0
1327;Campo Novo;Bom Fim;100;0;70;14;0;100
1328;Campo Novo;Bom Jesus;250;150;32;10;200;50
1329;Campo Novo;Camaquã;350;150;108;41;150;200
1330;Campo Novo;Campo Novo;5000;1700;1466;308;2900;2100
1331;Campo Novo;Cascata;100;50;31;7;50;50
1332;Campo Novo;Cavalhada;300;50;118;45;100;200
1333;Campo Novo;Cel. Aparício Borges;200;0;88;27;50;150
1334;Campo Novo;Centro Histórico;50;50;0;0;50;0
1335;Campo Novo;Chapéu do Sol;50;0;32;5;0;50
1336;Campo Novo;Chácara das Pedras;0;0;0;0;0;0
1337;Campo Novo;Cidade Baixa;50;0;0;0;50;0
1338;Campo Novo;Costa e Silva;50;0;32;6;0;50
1339;Campo Novo;Cristal;150;50;48;20;50;100
1340;Campo Novo;Cristo Redentor;0;0;0;0;0;0
1341;Campo Novo;Espírito Santo;400;50;209;69;50;350
1342;Campo Novo;Extrema;0;0;0;0;0;0
1343;Campo Novo;Farrapos;0;0;0;0;0;0
1344;Campo Novo;Farroupilha;0;0;0;0;0;0
1345;Campo Novo;Floresta;0;0;0;0;0;0
1346;Campo Novo;Glória;100;0;61;21;0;100
1347;Campo Novo;Guarujá;350;50;140;29;200;150
1348;Campo Novo;Higienópolis;50;0;0;0;50;0
1349;Campo Novo;Humaitá;200;0;120;31;0;200
1350;Campo Novo;Hípica;300;100;120;29;100;200
1351;Campo Novo;Independência;0;0;0;0;0;0
1352;Campo Novo;Ipanema;700;0;413;138;0;700
1353;Campo Novo;Jardim Botânico;100;50;36;10;50;50
1354;Campo Novo;Jardim Carvalho;0;0;0;0;0;0
1355;Campo Novo;Jardim Europa;0;0;0;0;0;0
1356;Campo Novo;Jardim Floresta;50;50;0;0;50;0
1357;Campo Novo;Jardim Isabel;150;50;64;20;50;100
1358;Campo Novo;Jardim Itú;100;0;33;11;50;50
1359;Campo Novo;Jardim Leopoldina;50;0;0;0;50;0
1360;Campo Novo;Jardim Lindóia;0;0;0;0;0;0
1361;Campo Novo;Jardim Sabará;0;0;0;0;0;0
1362;Campo Novo;Jardim São Pedro;50;0;38;3;0;50
1363;Campo Novo;Jardim do Salso;0;0;0;0;0;0
1364;Campo Novo;Lageado;50;0;36;6;0;50
1365;Campo Novo;Lami;50;50;0;0;50;0
1366;Campo Novo;Lomba do Pinheiro;250;50;91;31;100;150
1367;Campo Novo;Medianeira;50;0;0;0;50;0
1368;Campo Novo;Menino Deus;150;0;102;26;0;150
1369;Campo Novo;Moinhos de Vento;50;0;32;8;0;50
1370;Campo Novo;Mont'Serrat;0;0;0;0;0;0
1371;Campo Novo;Morro Santana;100;0;57;18;0;100
1372;Campo Novo;Mário Quintana;50;0;29;9;0;50
1373;Campo Novo;Navegantes;50;0;27;16;0;50
1374;Campo Novo;Nonoai;250;0;123;38;50;200
1375;Campo Novo;Parque Santa Fé;0;0;0;0;0;0
1376;Campo Novo;Partenon;200;0;115;45;0;200
1377;Campo Novo;Passo D'Areia;50;0;25;7;0;50
1378;Campo Novo;Passo das Pedras;100;50;31;9;50;50
1379;Campo Novo;Pedra Redonda;100;0;59;16;0;100
1380;Campo Novo;Petrópolis;50;0;31;17;0;50
1381;Campo Novo;Pitinga;100;0;58;20;0;100
1382;Campo Novo;Ponta Grossa;200;50;108;14;100;100
1383;Campo Novo;Praia de Belas;50;0;27;10;0;50
1384;Campo Novo;Restinga;950;350;227;55;600;350
1385;Campo Novo;Rio Branco;50;0;30;14;0;50
1386;Campo Novo;Rubem Berta;150;0;50;41;50;100
1387;Campo Novo;Santa Cecília;100;0;54;27;0;100
1388;Campo Novo;Santa Maria Goretti;100;0;82;5;50;50
1389;Campo Novo;Santa Rosa de Lima;50;0;0;0;50;0
1390;Campo Novo;Santa Tereza;200;50;54;19;100;100
1391;Campo Novo;Santana;100;0;30;10;50;50
1392;Campo Novo;Santo Antônio;100;0;31;6;50;50
1393;Campo Novo;Sarandi;400;100;171;78;100;300
1394;Campo Novo;Serraria;200;0;124;48;0;200
1395;Campo Novo;São Caetano;0;0;0;0;0;0
1396;Campo Novo;São Geraldo;50;0;33;10;0;50
1397;Campo Novo;São José;50;0;32;10;0;50
1398;Campo Novo;São João;0;0;0;0;0;0
1399;Campo Novo;São Sebastião;0;0;0;0;0;0
1400;Campo Novo;Sétimo Céu;50;0;26;9;0;50
1401;Campo Novo;Teresópolis;350;100;151;44;100;250
1402;Campo Novo;Tristeza;400;0;199;106;50;350
1403;Campo Novo;Três Figueiras;100;0;31;15;50;50
1404;Campo Novo;Vila Assunção;50;0;50;0;50;0
1405;Campo Novo;Vila Conceição;0;0;0;0;0;0
1406;Campo Novo;Vila Ipiranga;100;100;0;0;100;0
1407;Campo Novo;Vila Jardim;50;50;0;0;50;0
1408;Campo Novo;Vila João Pessoa;200;50;55;25;100;100
1409;Campo Novo;Vila Nova;1950;200;759;257;600;1350
1410;Cascata;Aberta dos Morros;0;0;0;0;0;0
1411;Cascata;Agronomia;450;150;148;40;200;250
1412;Cascata;Anchieta;50;50;0;0;50;0
1413;Cascata;Arquipélago;300;0;145;28;50;250
1414;Cascata;Auxiliadora;50;0;31;10;0;50
1415;Cascata;Azenha;150;0;94;23;0;150
1416;Cascata;Bela Vista;50;0;31;4;0;50
1417;Cascata;Belém Novo;50;0;33;14;0;50
1418;Cascata;Belém Velho;650;50;293;81;150;500
1419;Cascata;Boa Vista;50;0;38;7;0;50
1420;Cascata;Boa Vista do Sul;0;0;0;0;0;0
1421;Cascata;Bom Fim;50;0;27;17;0;50
1422;Cascata;Bom Jesus;300;0;113;26;100;200
1423;Cascata;Camaquã;0;0;0;0;0;0
1424;Cascata;Campo Novo;100;50;31;7;50;50
1425;Cascata;Cascata;1900;300;862;192;500;1400
1426;Cascata;Cavalhada;250;50;62;12;150;100
1427;Cascata;Cel. Aparício Borges;1050;200;341;75;450;600
1428;Cascata;Centro Histórico;100;0;25;7;50;50
1429;Cascata;Chapéu do Sol;0;0;0;0;0;0
1430;Cascata;Chácara das Pedras;200;50;94;15;50;150
1431;Cascata;Cidade Baixa;200;0;125;40;0;200
1432;Cascata;Costa e Silva;100;50;0;0;100;0
1433;Cascata;Cristal;0;0;0;0;0;0
1434;Cascata;Cristo Redentor;50;0;30;16;0;50
1435;Cascata;Espírito Santo;0;0;0;0;0;0
1436;Cascata;Extrema;50;50;0;0;50;0
1437;Cascata;Farrapos;50;0;29;6;0;50
1438;Cascata;Farroupilha;0;0;0;0;0;0
1439;Cascata;Floresta;100;0;67;9;0;100
1440;Cascata;Glória;1450;250;574;171;450;1000
1441;Cascata;Guarujá;200;50;64;16;100;100
1442;Cascata;Higienópolis;100;50;31;4;50;50
1443;Cascata;Humaitá;100;100;0;0;100;0
1444;Cascata;Hípica;150;50;36;5;100;50
1445;Cascata;Independência;150;50;73;20;100;50
1446;Cascata;Ipanema;50;0;0;0;50;0
1447;Cascata;Jardim Botânico;450;0;206;65;100;350
1448;Cascata;Jardim Carvalho;750;200;365;96;200;550
1449;Cascata;Jardim Europa;0;0;0;0;0;0
1450;Cascata;Jardim Floresta;0;0;0;0;0;0
1451;Cascata;Jardim Isabel;0;0;0;0;0;0
1452;Cascata;Jardim Itú;0;0;0;0;0;0
1453;Cascata;Jardim Leopoldina;0;0;0;0;0;0
1454;Cascata;Jardim Lindóia;200;0;49;25;100;100
1455;Cascata;Jardim Sabará;150;0;50;20;50;100
1456;Cascata;Jardim São Pedro;150;0;92;24;0;150
1457;Cascata;Jardim do Salso;250;50;113;31;50;200
1458;Cascata;Lageado;0;0;0;0;0;0
1459;Cascata;Lami;150;0;119;8;50;100
1460;Cascata;Lomba do Pinheiro;1200;100;592;136;200;1000
1461;Cascata;Medianeira;150;0;75;35;0;150
1462;Cascata;Menino Deus;150;0;64;20;50;100
1463;Cascata;Moinhos de Vento;50;0;0;0;50;0
1464;Cascata;Mont'Serrat;150;0;90;27;0;150
1465;Cascata;Morro Santana;200;50;88;22;50;150
1466;Cascata;Mário Quintana;250;0;114;22;50;200
1467;Cascata;Navegantes;0;0;0;0;0;0
1468;Cascata;Nonoai;300;0;168;24;100;200
1469;Cascata;Parque Santa Fé;300;50;131;23;100;200
1470;Cascata;Partenon;650;100;271;102;200;450
1471;Cascata;Passo D'Areia;50;50;0;0;50;0
1472;Cascata;Passo das Pedras;0;0;0;0;0;0
1473;Cascata;Pedra Redonda;0;0;0;0;0;0
1474;Cascata;Petrópolis;250;50;67;24;150;100
1475;Cascata;Pitinga;200;0;78;20;50;150
1476;Cascata;Ponta Grossa;150;50;62;18;50;100
1477;Cascata;Praia de Belas;0;0;0;0;0;0
1478;Cascata;Restinga;550;200;145;41;300;250
1479;Cascata;Rio Branco;50;0;20;13;0;50
1480;Cascata;Rubem Berta;100;50;31;6;50;50
1481;Cascata;Santa Cecília;350;50;177;57;50;300
1482;Cascata;Santa Maria Goretti;50;0;37;2;0;50
1483;Cascata;Santa Rosa de Lima;150;50;84;3;100;50
1484;Cascata;Santa Tereza;300;0;98;15;200;100
1485;Cascata;Santana;50;0;0;0;50;0
1486;Cascata;Santo Antônio;100;0;54;14;0;100
1487;Cascata;Sarandi;350;50;82;35;200;150
1488;Cascata;Serraria;150;0;101;21;0;150
1489;Cascata;São Caetano;100;50;32;8;50;50
1490;Cascata;São Geraldo;0;0;0;0;0;0
1491;Cascata;São José;6100;450;3036;734;1450;4650
1492;Cascata;São João;0;0;0;0;0;0
1493;Cascata;São Sebastião;0;0;0;0;0;0
1494;Cascata;Sétimo Céu;50;0;25;9;0;50
1495;Cascata;Teresópolis;450;100;109;29;250;200
1496;Cascata;Tristeza;200;50;0;0;200;0
1497;Cascata;Três Figueiras;50;0;22;7;0;50
1498;Cascata;Vila Assunção;0;0;0;0;0;0
1499;Cascata;Vila Conceição;0;0;0;0;0;0
1500;Cascata;Vila Ipiranga;0;0;0;0;0;0
1501;Cascata;Vila Jardim;100;50;50;0;100;0
1502;Cascata;Vila João Pessoa;1250;300;508;106;500;750
1503;Cascata;Vila Nova;1100;250;315;91;650;450
1504;Cavalhada;Aberta dos Morros;450;50;234;87;50;400
1505;Cavalhada;Agronomia;50;50;0;0;50;0
1506;Cavalhada;Anchieta;0;0;0;0;0;0
1507;Cavalhada;Arquipélago;250;0;115;44;50;200
1508;Cavalhada;Auxiliadora;200;0;73;40;50;150
1509;Cavalhada;Azenha;150;0;85;24;0;150
1510;Cavalhada;Bela Vista;100;0;32;10;50;50
1511;Cavalhada;Belém Novo;0;0;0;0;0;0
1512;Cavalhada;Belém Velho;150;50;29;11;100;50
1513;Cavalhada;Boa Vista;300;150;81;37;150;150
1514;Cavalhada;Boa Vista do Sul;0;0;0;0;0;0
1515;Cavalhada;Bom Fim;100;0;21;19;50;50
1516;Cavalhada;Bom Jesus;100;0;23;11;50;50
1517;Cavalhada;Camaquã;2350;450;952;355;650;1700
1518;Cavalhada;Campo Novo;300;50;118;45;100;200
1519;Cavalhada;Cascata;250;50;62;12;150;100
1520;Cavalhada;Cavalhada;9924;5500;734;88;9524;400
1521;Cavalhada;Cel. Aparício Borges;200;0;81;26;50;150
1522;Cavalhada;Centro Histórico;200;0;119;54;0;200
1523;Cavalhada;Chapéu do Sol;50;0;25;10;0;50
1524;Cavalhada;Chácara das Pedras;100;50;23;16;50;50
1525;Cavalhada;Cidade Baixa;150;100;0;0;150;0
1526;Cavalhada;Costa e Silva;150;100;35;9;100;50
1527;Cavalhada;Cristal;9100;400;4945;1668;450;8650
1528;Cavalhada;Cristo Redentor;150;0;63;27;50;100
1529;Cavalhada;Espírito Santo;750;250;110;37;550;200
1530;Cavalhada;Extrema;100;50;32;4;50;50
1531;Cavalhada;Farrapos;50;0;30;13;0;50
1532;Cavalhada;Farroupilha;0;0;0;0;0;0
1533;Cavalhada;Floresta;0;0;0;0;0;0
1534;Cavalhada;Glória;50;0;0;0;50;0
1535;Cavalhada;Guarujá;450;50;146;50;200;250
1536;Cavalhada;Higienópolis;50;0;24;10;0;50
1537;Cavalhada;Humaitá;100;0;65;17;0;100
1538;Cavalhada;Hípica;550;50;199;69;200;350
1539;Cavalhada;Independência;100;0;32;14;50;50
1540;Cavalhada;Ipanema;2000;750;242;83;1600;400
1541;Cavalhada;Jardim Botânico;150;50;30;10;100;50
1542;Cavalhada;Jardim Carvalho;250;0;166;52;0;250
1543;Cavalhada;Jardim Europa;50;50;0;0;50;0
1544;Cavalhada;Jardim Floresta;0;0;0;0;0;0
1545;Cavalhada;Jardim Isabel;5050;450;2561;871;800;4250
1546;Cavalhada;Jardim Itú;100;0;59;15;0;100
1547;Cavalhada;Jardim Leopoldina;50;50;0;0;50;0
1548;Cavalhada;Jardim Lindóia;200;100;55;27;100;100
1549;Cavalhada;Jardim Sabará;50;0;25;11;0;50
1550;Cavalhada;Jardim São Pedro;0;0;0;0;0;0
1551;Cavalhada;Jardim do Salso;0;0;0;0;0;0
1552;Cavalhada;Lageado;50;50;0;0;50;0
1553;Cavalhada;Lami;0;0;0;0;0;0
1554;Cavalhada;Lomba do Pinheiro;50;0;28;8;0;50
1555;Cavalhada;Medianeira;150;0;68;23;50;100
1556;Cavalhada;Menino Deus;350;50;164;87;50;300
1557;Cavalhada;Moinhos de Vento;200;100;52;26;100;100
1558;Cavalhada;Mont'Serrat;250;50;112;49;50;200
1559;Cavalhada;Morro Santana;250;50;122;42;50;200
1560;Cavalhada;Mário Quintana;50;0;28;8;0;50
1561;Cavalhada;Navegantes;100;0;69;21;0;100
1562;Cavalhada;Nonoai;1850;50;1040;378;100;1750
1563;Cavalhada;Parque Santa Fé;100;0;57;22;0;100
1564;Cavalhada;Partenon;800;150;372;128;150;650
1565;Cavalhada;Passo D'Areia;250;50;98;37;150;100
1566;Cavalhada;Passo das Pedras;150;0;94;25;0;150
1567;Cavalhada;Pedra Redonda;3021;500;987;363;1321;1700
1568;Cavalhada;Petrópolis;100;0;52;30;0;100
1569;Cavalhada;Pitinga;0;0;0;0;0;0
1570;Cavalhada;Ponta Grossa;200;100;35;9;150;50
1571;Cavalhada;Praia de Belas;100;50;23;12;50;50
1572;Cavalhada;Restinga;400;50;149;39;150;250
1573;Cavalhada;Rio Branco;0;0;0;0;0;0
1574;Cavalhada;Rubem Berta;100;0;43;36;0;100
1575;Cavalhada;Santa Cecília;150;0;60;24;50;100
1576;Cavalhada;Santa Maria Goretti;0;0;0;0;0;0
1577;Cavalhada;Santa Rosa de Lima;250;0;139;46;0;250
1578;Cavalhada;Santa Tereza;1450;200;655;225;350;1100
1579;Cavalhada;Santana;300;50;129;76;50;250
1580;Cavalhada;Santo Antônio;300;0;57;18;200;100
1581;Cavalhada;Sarandi;250;0;106;50;50;200
1582;Cavalhada;Serraria;350;0;209;74;0;350
1583;Cavalhada;São Caetano;100;50;36;9;50;50
1584;Cavalhada;São Geraldo;150;50;57;22;50;100
1585;Cavalhada;São José;50;0;0;0;50;0
1586;Cavalhada;São João;50;50;0;0;50;0
1587;Cavalhada;São Sebastião;50;0;33;7;0;50
1588;Cavalhada;Sétimo Céu;6350;700;2991;1080;1300;5050
1589;Cavalhada;Teresópolis;600;150;246;97;250;350
1590;Cavalhada;Tristeza;900;150;290;121;400;500
1591;Cavalhada;Três Figueiras;150;100;27;11;100;50
1592;Cavalhada;Vila Assunção;400;50;195;83;50;350
1593;Cavalhada;Vila Conceição;600;150;186;68;250;350
1594;Cavalhada;Vila Ipiranga;150;0;77;35;0;150
1595;Cavalhada;Vila Jardim;100;50;22;12;50;50
1596;Cavalhada;Vila João Pessoa;200;100;29;13;150;50
1597;Cavalhada;Vila Nova;1750;300;751;293;450;1300
1598;Cel. Aparício Borges;Aberta dos Morros;250;100;72;13;150;100
1599;Cel. Aparício Borges;Agronomia;300;100;134;17;150;150
1600;Cel. Aparício Borges;Anchieta;100;0;57;15;0;100
1601;Cel. Aparício Borges;Arquipélago;50;0;33;11;0;50
1602;Cel. Aparício Borges;Auxiliadora;150;0;46;34;50;100
1603;Cel. Aparício Borges;Azenha;450;100;196;69;100;350
1604;Cel. Aparício Borges;Bela Vista;150;0;57;18;50;100
1605;Cel. Aparício Borges;Belém Novo;50;0;0;0;50;0
1606;Cel. Aparício Borges;Belém Velho;200;50;75;24;50;150
1607;Cel. Aparício Borges;Boa Vista;50;0;30;4;0;50
1608;Cel. Aparício Borges;Boa Vista do Sul;50;50;0;0;50;0
1609;Cel. Aparício Borges;Bom Fim;100;0;43;20;0;100
1610;Cel. Aparício Borges;Bom Jesus;350;50;94;24;200;150
1611;Cel. Aparício Borges;Camaquã;200;50;84;21;50;150
1612;Cel. Aparício Borges;Campo Novo;200;0;88;27;50;150
1613;Cel. Aparício Borges;Cascata;1050;200;341;75;450;600
1614;Cel. Aparício Borges;Cavalhada;200;0;81;26;50;150
1615;Cel. Aparício Borges;Cel. Aparício Borges;11800;800;6212;1572;800;11000
1616;Cel. Aparício Borges;Centro Histórico;200;0;80;36;50;150
1617;Cel. Aparício Borges;Chapéu do Sol;50;50;0;0;50;0
1618;Cel. Aparício Borges;Chácara das Pedras;100;0;55;19;0;100
1619;Cel. Aparício Borges;Cidade Baixa;100;0;24;10;50;50
1620;Cel. Aparício Borges;Costa e Silva;0;0;0;0;0;0
1621;Cel. Aparício Borges;Cristal;250;50;114;39;50;200
1622;Cel. Aparício Borges;Cristo Redentor;50;0;32;8;0;50
1623;Cel. Aparício Borges;Espírito Santo;50;0;0;0;50;0
1624;Cel. Aparício Borges;Extrema;100;0;59;16;0;100
1625;Cel. Aparício Borges;Farrapos;50;0;26;14;0;50
1626;Cel. Aparício Borges;Farroupilha;0;0;0;0;0;0
1627;Cel. Aparício Borges;Floresta;100;0;64;19;0;100
1628;Cel. Aparício Borges;Glória;4700;500;2179;784;700;4000
1629;Cel. Aparício Borges;Guarujá;100;50;25;11;50;50
1630;Cel. Aparício Borges;Higienópolis;150;100;30;7;100;50
1631;Cel. Aparício Borges;Humaitá;200;50;89;17;50;150
1632;Cel. Aparício Borges;Hípica;150;0;97;20;0;150
1633;Cel. Aparício Borges;Independência;50;0;25;25;0;50
1634;Cel. Aparício Borges;Ipanema;0;0;0;0;0;0
1635;Cel. Aparício Borges;Jardim Botânico;1100;200;406;87;500;600
1636;Cel. Aparício Borges;Jardim Carvalho;377;0;135;37;127;250
1637;Cel. Aparício Borges;Jardim Europa;150;50;66;16;50;100
1638;Cel. Aparício Borges;Jardim Floresta;50;0;38;4;0;50
1639;Cel. Aparício Borges;Jardim Isabel;50;50;0;0;50;0
1640;Cel. Aparício Borges;Jardim Itú;150;0;25;10;100;50
1641;Cel. Aparício Borges;Jardim Leopoldina;50;0;30;8;0;50
1642;Cel. Aparício Borges;Jardim Lindóia;50;0;35;6;0;50
1643;Cel. Aparício Borges;Jardim Sabará;300;0;108;36;100;200
1644;Cel. Aparício Borges;Jardim São Pedro;50;0;29;5;0;50
1645;Cel. Aparício Borges;Jardim do Salso;750;150;334;102;150;600
1646;Cel. Aparício Borges;Lageado;50;0;24;9;0;50
1647;Cel. Aparício Borges;Lami;150;0;88;21;0;150
1648;Cel. Aparício Borges;Lomba do Pinheiro;250;50;94;9;100;150
1649;Cel. Aparício Borges;Medianeira;250;150;53;16;150;100
1650;Cel. Aparício Borges;Menino Deus;350;0;159;57;100;250
1651;Cel. Aparício Borges;Moinhos de Vento;100;0;56;30;0;100
1652;Cel. Aparício Borges;Mont'Serrat;100;0;31;4;50;50
1653;Cel. Aparício Borges;Morro Santana;150;100;30;12;100;50
1654;Cel. Aparício Borges;Mário Quintana;50;0;30;7;0;50
1655;Cel. Aparício Borges;Navegantes;0;0;0;0;0;0
1656;Cel. Aparício Borges;Nonoai;150;0;79;25;0;150
1657;Cel. Aparício Borges;Parque Santa Fé;50;0;29;8;0;50
1658;Cel. Aparício Borges;Partenon;1550;100;820;241;150;1400
1659;Cel. Aparício Borges;Passo D'Areia;50;0;50;0;50;0
1660;Cel. Aparício Borges;Passo das Pedras;150;0;56;21;50;100
1661;Cel. Aparício Borges;Pedra Redonda;0;0;0;0;0;0
1662;Cel. Aparício Borges;Petrópolis;400;0;221;106;0;400
1663;Cel. Aparício Borges;Pitinga;100;0;61;16;0;100
1664;Cel. Aparício Borges;Ponta Grossa;100;0;62;14;0;100
1665;Cel. Aparício Borges;Praia de Belas;50;50;0;0;50;0
1666;Cel. Aparício Borges;Restinga;200;50;81;29;50;150
1667;Cel. Aparício Borges;Rio Branco;100;50;28;5;50;50
1668;Cel. Aparício Borges;Rubem Berta;0;0;0;0;0;0
1669;Cel. Aparício Borges;Santa Cecília;300;0;166;52;0;300
1670;Cel. Aparício Borges;Santa Maria Goretti;100;0;71;7;0;100
1671;Cel. Aparício Borges;Santa Rosa de Lima;0;0;0;0;0;0
1672;Cel. Aparício Borges;Santa Tereza;2200;0;1219;409;50;2150
1673;Cel. Aparício Borges;Santana;150;50;79;8;100;50
1674;Cel. Aparício Borges;Santo Antônio;650;150;226;77;250;400
1675;Cel. Aparício Borges;Sarandi;400;100;58;20;300;100
1676;Cel. Aparício Borges;Serraria;100;0;29;10;50;50
1677;Cel. Aparício Borges;São Caetano;150;50;0;0;150;0
1678;Cel. Aparício Borges;São Geraldo;0;0;0;0;0;0
1679;Cel. Aparício Borges;São José;1950;900;261;86;1450;500
1680;Cel. Aparício Borges;São João;50;0;28;14;0;50
1681;Cel. Aparício Borges;São Sebastião;50;0;0;0;50;0
1682;Cel. Aparício Borges;Sétimo Céu;0;0;0;0;0;0
1683;Cel. Aparício Borges;Teresópolis;350;50;177;64;50;300
1684;Cel. Aparício Borges;Tristeza;50;0;30;18;0;50
1685;Cel. Aparício Borges;Três Figueiras;100;0;59;11;0;100
1686;Cel. Aparício Borges;Vila Assunção;50;0;26;5;0;50
1687;Cel. Aparício Borges;Vila Conceição;50;0;25;9;0;50
1688;Cel. Aparício Borges;Vila Ipiranga;100;0;57;21;0;100
1689;Cel. Aparício Borges;Vila Jardim;200;50;104;23;100;100
1690;Cel. Aparício Borges;Vila João Pessoa;4350;1200;1336;418;1950;2400
1691;Cel. Aparício Borges;Vila Nova;450;50;186;50;200;250
1692;Centro Histórico;Aberta dos Morros;200;50;91;34;50;150
1693;Centro Histórico;Agronomia;100;0;50;0;100;0
1694;Centro Histórico;Anchieta;150;100;37;8;100;50
1695;Centro Histórico;Arquipélago;750;0;384;106;100;650
1696;Centro Histórico;Auxiliadora;550;50;88;58;350;200
1697;Centro Histórico;Azenha;550;150;157;66;250;300
1698;Centro Histórico;Bela Vista;500;150;89;36;350;150
1699;Centro Histórico;Belém Novo;150;50;59;31;50;100
1700;Centro Histórico;Belém Velho;50;0;31;6;0;50
1701;Centro Histórico;Boa Vista;400;0;168;83;100;300
1702;Centro Histórico;Boa Vista do Sul;100;0;35;31;0;100
1703;Centro Histórico;Bom Fim;2500;200;903;358;1050;1450
1704;Centro Histórico;Bom Jesus;250;0;53;20;150;100
1705;Centro Histórico;Camaquã;200;0;79;46;50;150
1706;Centro Histórico;Campo Novo;50;50;0;0;50;0
1707;Centro Histórico;Cascata;100;0;25;7;50;50
1708;Centro Histórico;Cavalhada;200;0;119;54;0;200
1709;Centro Histórico;Cel. Aparício Borges;200;0;80;36;50;150
1710;Centro Histórico;Centro Histórico;19200;5000;1842;578;16900;2300
1711;Centro Histórico;Chapéu do Sol;50;0;31;17;0;50
1712;Centro Histórico;Chácara das Pedras;200;100;50;27;100;100
1713;Centro Histórico;Cidade Baixa;1800;200;620;243;750;1050
1714;Centro Histórico;Costa e Silva;300;50;168;42;100;200
1715;Centro Histórico;Cristal;250;100;63;20;150;100
1716;Centro Histórico;Cristo Redentor;150;100;0;0;150;0
1717;Centro Histórico;Espírito Santo;350;0;189;80;0;350
1718;Centro Histórico;Extrema;100;0;55;21;0;100
1719;Centro Histórico;Farrapos;50;0;27;9;0;50
1720;Centro Histórico;Farroupilha;11600;300;5718;2602;850;10750
1721;Centro Histórico;Floresta;650;100;137;60;400;250
1722;Centro Histórico;Glória;100;0;58;24;0;100
1723;Centro Histórico;Guarujá;0;0;0;0;0;0
1724;Centro Histórico;Higienópolis;700;0;319;137;150;550
1725;Centro Histórico;Humaitá;150;0;89;35;0;150
1726;Centro Histórico;Hípica;100;0;42;27;0;100
1727;Centro Histórico;Independência;1650;150;578;233;750;900
1728;Centro Histórico;Ipanema;200;100;57;20;100;100
1729;Centro Histórico;Jardim Botânico;400;50;182;79;50;350
1730;Centro Histórico;Jardim Carvalho;100;0;19;9;50;50
1731;Centro Histórico;Jardim Europa;200;0;94;49;0;200
1732;Centro Histórico;Jardim Floresta;150;50;24;9;100;50
1733;Centro Histórico;Jardim Isabel;0;0;0;0;0;0
1734;Centro Histórico;Jardim Itú;100;0;63;22;0;100
1735;Centro Histórico;Jardim Leopoldina;0;0;0;0;0;0
1736;Centro Histórico;Jardim Lindóia;0;0;0;0;0;0
1737;Centro Histórico;Jardim Sabará;150;0;56;26;50;100
1738;Centro Histórico;Jardim São Pedro;200;0;106;59;0;200
1739;Centro Histórico;Jardim do Salso;150;0;58;34;50;100
1740;Centro Histórico;Lageado;200;100;27;6;150;50
1741;Centro Histórico;Lami;250;0;80;36;100;150
1742;Centro Histórico;Lomba do Pinheiro;150;0;81;25;0;150
1743;Centro Histórico;Medianeira;350;100;72;44;200;150
1744;Centro Histórico;Menino Deus;1650;350;350;140;1150;500
1745;Centro Histórico;Moinhos de Vento;2400;150;1036;545;300;2100
1746;Centro Histórico;Mont'Serrat;450;100;117;82;200;250
1747;Centro Histórico;Morro Santana;150;50;53;21;50;100
1748;Centro Histórico;Mário Quintana;300;100;50;18;200;100
1749;Centro Histórico;Navegantes;250;0;146;56;0;250
1750;Centro Histórico;Nonoai;150;0;40;31;50;100
1751;Centro Histórico;Parque Santa Fé;50;0;0;0;50;0
1752;Centro Histórico;Partenon;450;0;222;95;50;400
1753;Centro Histórico;Passo D'Areia;450;50;200;77;50;400
1754;Centro Histórico;Passo das Pedras;200;50;60;20;100;100
1755;Centro Histórico;Pedra Redonda;0;0;0;0;0;0
1756;Centro Histórico;Petrópolis;350;50;67;28;250;100
1757;Centro Histórico;Pitinga;50;0;32;12;0;50
1758;Centro Histórico;Ponta Grossa;150;50;23;12;100;50
1759;Centro Histórico;Praia de Belas;1250;200;488;238;300;950
1760;Centro Histórico;Restinga;300;50;142;36;150;150
1761;Centro Histórico;Rio Branco;1450;50;613;313;250;1200
1762;Centro Histórico;Rubem Berta;0;0;0;0;0;0
1763;Centro Histórico;Santa Cecília;450;50;24;18;400;50
1764;Centro Histórico;Santa Maria Goretti;200;100;49;31;100;100
1765;Centro Histórico;Santa Rosa de Lima;50;0;27;12;0;50
1766;Centro Histórico;Santa Tereza;600;50;234;89;150;450
1767;Centro Histórico;Santana;900;0;212;103;500;400
1768;Centro Histórico;Santo Antônio;650;0;268;136;100;550
1769;Centro Histórico;Sarandi;250;50;110;47;50;200
1770;Centro Histórico;Serraria;200;50;99;30;50;150
1771;Centro Histórico;São Caetano;250;0;137;42;100;150
1772;Centro Histórico;São Geraldo;300;50;54;20;200;100
1773;Centro Histórico;São José;100;50;0;0;100;0
1774;Centro Histórico;São João;366;0;128;56;166;200
1775;Centro Histórico;São Sebastião;250;50;58;23;150;100
1776;Centro Histórico;Sétimo Céu;50;0;0;0;50;0
1777;Centro Histórico;Teresópolis;150;0;52;28;50;100
1778;Centro Histórico;Tristeza;200;0;114;51;0;200
1779;Centro Histórico;Três Figueiras;500;50;173;76;150;350
1780;Centro Histórico;Vila Assunção;100;0;40;25;0;100
1781;Centro Histórico;Vila Conceição;150;0;56;18;50;100
1782;Centro Histórico;Vila Ipiranga;150;0;86;30;0;150
1783;Centro Histórico;Vila Jardim;300;50;121;30;100;200
1784;Centro Histórico;Vila João Pessoa;50;0;19;15;0;50
1785;Centro Histórico;Vila Nova;250;100;51;22;150;100
1786;Chapéu do Sol;Aberta dos Morros;0;0;0;0;0;0
1787;Chapéu do Sol;Agronomia;0;0;0;0;0;0
1788;Chapéu do Sol;Anchieta;0;0;0;0;0;0
1789;Chapéu do Sol;Arquipélago;0;0;0;0;0;0
1790;Chapéu do Sol;Auxiliadora;50;0;0;0;50;0
1791;Chapéu do Sol;Azenha;100;0;0;0;100;0
1792;Chapéu do Sol;Bela Vista;150;50;53;24;50;100
1793;Chapéu do Sol;Belém Novo;350;0;194;78;0;350
1794;Chapéu do Sol;Belém Velho;100;50;0;0;100;0
1795;Chapéu do Sol;Boa Vista;0;0;0;0;0;0
1796;Chapéu do Sol;Boa Vista do Sul;0;0;0;0;0;0
1797;Chapéu do Sol;Bom Fim;100;0;0;0;100;0
1798;Chapéu do Sol;Bom Jesus;100;50;37;9;50;50
1799;Chapéu do Sol;Camaquã;50;0;0;0;50;0
1800;Chapéu do Sol;Campo Novo;50;0;32;5;0;50
1801;Chapéu do Sol;Cascata;0;0;0;0;0;0
1802;Chapéu do Sol;Cavalhada;50;0;25;10;0;50
1803;Chapéu do Sol;Cel. Aparício Borges;50;50;0;0;50;0
1804;Chapéu do Sol;Centro Histórico;50;0;31;17;0;50
1805;Chapéu do Sol;Chapéu do Sol;1200;100;500;140;300;900
1806;Chapéu do Sol;Chácara das Pedras;50;0;32;18;0;50
1807;Chapéu do Sol;Cidade Baixa;50;0;0;0;50;0
1808;Chapéu do Sol;Costa e Silva;50;0;34;4;0;50
1809;Chapéu do Sol;Cristal;0;0;0;0;0;0
1810;Chapéu do Sol;Cristo Redentor;0;0;0;0;0;0
1811;Chapéu do Sol;Espírito Santo;50;0;28;8;0;50
1812;Chapéu do Sol;Extrema;0;0;0;0;0;0
1813;Chapéu do Sol;Farrapos;50;0;26;10;0;50
1814;Chapéu do Sol;Farroupilha;0;0;0;0;0;0
1815;Chapéu do Sol;Floresta;50;0;30;18;0;50
1816;Chapéu do Sol;Glória;50;0;22;13;0;50
1817;Chapéu do Sol;Guarujá;50;50;0;0;50;0
1818;Chapéu do Sol;Higienópolis;150;0;95;33;0;150
1819;Chapéu do Sol;Humaitá;50;0;31;7;0;50
1820;Chapéu do Sol;Hípica;5300;1000;2127;489;2200;3100
1821;Chapéu do Sol;Independência;0;0;0;0;0;0
1822;Chapéu do Sol;Ipanema;50;50;0;0;50;0
1823;Chapéu do Sol;Jardim Botânico;50;0;0;0;50;0
1824;Chapéu do Sol;Jardim Carvalho;250;100;86;33;100;150
1825;Chapéu do Sol;Jardim Europa;0;0;0;0;0;0
1826;Chapéu do Sol;Jardim Floresta;0;0;0;0;0;0
1827;Chapéu do Sol;Jardim Isabel;50;0;30;4;0;50
1828;Chapéu do Sol;Jardim Itú;0;0;0;0;0;0
1829;Chapéu do Sol;Jardim Leopoldina;100;50;0;0;100;0
1830;Chapéu do Sol;Jardim Lindóia;0;0;0;0;0;0
1831;Chapéu do Sol;Jardim Sabará;100;0;57;29;0;100
1832;Chapéu do Sol;Jardim São Pedro;0;0;0;0;0;0
1833;Chapéu do Sol;Jardim do Salso;50;0;24;10;0;50
1834;Chapéu do Sol;Lageado;450;50;239;58;50;400
1835;Chapéu do Sol;Lami;100;0;52;13;0;100
1836;Chapéu do Sol;Lomba do Pinheiro;500;100;178;26;300;200
1837;Chapéu do Sol;Medianeira;0;0;0;0;0;0
1838;Chapéu do Sol;Menino Deus;150;100;28;12;100;50
1839;Chapéu do Sol;Moinhos de Vento;50;0;24;13;0;50
1840;Chapéu do Sol;Mont'Serrat;0;0;0;0;0;0
1841;Chapéu do Sol;Morro Santana;50;0;36;3;0;50
1842;Chapéu do Sol;Mário Quintana;50;0;38;5;0;50
1843;Chapéu do Sol;Navegantes;0;0;0;0;0;0
1844;Chapéu do Sol;Nonoai;200;150;35;7;150;50
1845;Chapéu do Sol;Parque Santa Fé;100;50;24;12;50;50
1846;Chapéu do Sol;Partenon;100;0;26;17;50;50
1847;Chapéu do Sol;Passo D'Areia;50;0;24;17;0;50
1848;Chapéu do Sol;Passo das Pedras;50;0;30;12;0;50
1849;Chapéu do Sol;Pedra Redonda;50;50;0;0;50;0
1850;Chapéu do Sol;Petrópolis;100;0;62;24;0;100
1851;Chapéu do Sol;Pitinga;0;0;0;0;0;0
1852;Chapéu do Sol;Ponta Grossa;200;0;121;23;0;200
1853;Chapéu do Sol;Praia de Belas;0;0;0;0;0;0
1854;Chapéu do Sol;Restinga;3850;150;2046;542;300;3550
1855;Chapéu do Sol;Rio Branco;250;100;85;45;100;150
1856;Chapéu do Sol;Rubem Berta;100;0;51;41;0;100
1857;Chapéu do Sol;Santa Cecília;0;0;0;0;0;0
1858;Chapéu do Sol;Santa Maria Goretti;0;0;0;0;0;0
1859;Chapéu do Sol;Santa Rosa de Lima;150;0;86;26;0;150
1860;Chapéu do Sol;Santa Tereza;100;50;0;0;100;0
1861;Chapéu do Sol;Santana;150;0;52;34;50;100
1862;Chapéu do Sol;Santo Antônio;50;50;0;0;50;0
1863;Chapéu do Sol;Sarandi;100;0;55;28;0;100
1864;Chapéu do Sol;Serraria;100;0;61;14;0;100
1865;Chapéu do Sol;São Caetano;0;0;0;0;0;0
1866;Chapéu do Sol;São Geraldo;0;0;0;0;0;0
1867;Chapéu do Sol;São José;50;0;26;9;0;50
1868;Chapéu do Sol;São João;0;0;0;0;0;0
1869;Chapéu do Sol;São Sebastião;0;0;0;0;0;0
1870;Chapéu do Sol;Sétimo Céu;0;0;0;0;0;0
1871;Chapéu do Sol;Teresópolis;150;50;33;7;100;50
1872;Chapéu do Sol;Tristeza;100;50;29;14;50;50
1873;Chapéu do Sol;Três Figueiras;50;0;27;7;0;50
1874;Chapéu do Sol;Vila Assunção;0;0;0;0;0;0
1875;Chapéu do Sol;Vila Conceição;0;0;0;0;0;0
1876;Chapéu do Sol;Vila Ipiranga;100;0;58;16;0;100
1877;Chapéu do Sol;Vila Jardim;0;0;0;0;0;0
1878;Chapéu do Sol;Vila João Pessoa;0;0;0;0;0;0
1879;Chapéu do Sol;Vila Nova;150;50;62;24;50;100
1880;Chácara das Pedras;Aberta dos Morros;0;0;0;0;0;0
1881;Chácara das Pedras;Agronomia;50;50;0;0;50;0
1882;Chácara das Pedras;Anchieta;100;50;28;15;50;50
1883;Chácara das Pedras;Arquipélago;50;0;24;7;0;50
1884;Chácara das Pedras;Auxiliadora;350;50;168;82;50;300
1885;Chácara das Pedras;Azenha;50;0;29;12;0;50
1886;Chácara das Pedras;Bela Vista;100;0;23;12;50;50
1887;Chácara das Pedras;Belém Novo;50;0;21;17;0;50
1888;Chácara das Pedras;Belém Velho;0;0;0;0;0;0
1889;Chácara das Pedras;Boa Vista;350;100;87;35;200;150
1890;Chácara das Pedras;Boa Vista do Sul;50;0;23;19;0;50
1891;Chácara das Pedras;Bom Fim;100;0;39;9;50;50
1892;Chácara das Pedras;Bom Jesus;1700;150;866;282;250;1450
1893;Chácara das Pedras;Camaquã;0;0;0;0;0;0
1894;Chácara das Pedras;Campo Novo;0;0;0;0;0;0
1895;Chácara das Pedras;Cascata;200;50;94;15;50;150
1896;Chácara das Pedras;Cavalhada;100;50;23;16;50;50
1897;Chácara das Pedras;Cel. Aparício Borges;100;0;55;19;0;100
1898;Chácara das Pedras;Centro Histórico;200;100;50;27;100;100
1899;Chácara das Pedras;Chapéu do Sol;50;0;32;18;0;50
1900;Chácara das Pedras;Chácara das Pedras;4500;200;2408;1122;300;4200
1901;Chácara das Pedras;Cidade Baixa;50;0;0;0;50;0
1902;Chácara das Pedras;Costa e Silva;100;50;33;9;50;50
1903;Chácara das Pedras;Cristal;200;150;29;9;150;50
1904;Chácara das Pedras;Cristo Redentor;300;50;101;30;150;150
1905;Chácara das Pedras;Espírito Santo;50;50;0;0;50;0
1906;Chácara das Pedras;Extrema;0;0;0;0;0;0
1907;Chácara das Pedras;Farrapos;50;0;35;6;0;50
1908;Chácara das Pedras;Farroupilha;0;0;0;0;0;0
1909;Chácara das Pedras;Floresta;50;0;32;9;0;50
1910;Chácara das Pedras;Glória;50;0;29;6;0;50
1911;Chácara das Pedras;Guarujá;50;0;31;13;0;50
1912;Chácara das Pedras;Higienópolis;100;50;36;8;50;50
1913;Chácara das Pedras;Humaitá;100;0;27;13;50;50
1914;Chácara das Pedras;Hípica;50;50;0;0;50;0
1915;Chácara das Pedras;Independência;50;0;18;16;0;50
1916;Chácara das Pedras;Ipanema;50;50;0;0;50;0
1917;Chácara das Pedras;Jardim Botânico;150;0;83;46;0;150
1918;Chácara das Pedras;Jardim Carvalho;250;0;156;41;0;250
1919;Chácara das Pedras;Jardim Europa;400;250;84;15;350;50
1920;Chácara das Pedras;Jardim Floresta;0;0;0;0;0;0
1921;Chácara das Pedras;Jardim Isabel;0;0;0;0;0;0
1922;Chácara das Pedras;Jardim Itú;300;50;117;50;100;200
1923;Chácara das Pedras;Jardim Leopoldina;350;0;218;74;0;350
1924;Chácara das Pedras;Jardim Lindóia;50;0;28;17;0;50
1925;Chácara das Pedras;Jardim Sabará;750;50;335;156;100;650
1926;Chácara das Pedras;Jardim São Pedro;50;0;24;16;0;50
1927;Chácara das Pedras;Jardim do Salso;350;0;151;92;50;300
1928;Chácara das Pedras;Lageado;0;0;0;0;0;0
1929;Chácara das Pedras;Lami;50;0;0;0;50;0
1930;Chácara das Pedras;Lomba do Pinheiro;200;0;69;13;100;100
1931;Chácara das Pedras;Medianeira;0;0;0;0;0;0
1932;Chácara das Pedras;Menino Deus;250;0;151;74;0;250
1933;Chácara das Pedras;Moinhos de Vento;100;50;26;23;50;50
1934;Chácara das Pedras;Mont'Serrat;100;0;51;30;0;100
1935;Chácara das Pedras;Morro Santana;200;0;84;36;50;150
1936;Chácara das Pedras;Mário Quintana;300;50;63;9;200;100
1937;Chácara das Pedras;Navegantes;50;0;50;0;50;0
1938;Chácara das Pedras;Nonoai;100;50;0;0;100;0
1939;Chácara das Pedras;Parque Santa Fé;0;0;0;0;0;0
1940;Chácara das Pedras;Partenon;200;0;121;47;0;200
1941;Chácara das Pedras;Passo D'Areia;800;300;100;105;550;250
1942;Chácara das Pedras;Passo das Pedras;150;0;87;26;0;150
1943;Chácara das Pedras;Pedra Redonda;0;0;0;0;0;0
1944;Chácara das Pedras;Petrópolis;900;100;337;136;400;500
1945;Chácara das Pedras;Pitinga;0;0;0;0;0;0
1946;Chácara das Pedras;Ponta Grossa;50;0;28;13;0;50
1947;Chácara das Pedras;Praia de Belas;50;0;22;17;0;50
1948;Chácara das Pedras;Restinga;100;50;25;8;50;50
1949;Chácara das Pedras;Rio Branco;250;50;87;46;100;150
1950;Chácara das Pedras;Rubem Berta;0;0;0;0;0;0
1951;Chácara das Pedras;Santa Cecília;100;0;25;14;50;50
1952;Chácara das Pedras;Santa Maria Goretti;0;0;0;0;0;0
1953;Chácara das Pedras;Santa Rosa de Lima;150;50;66;17;50;100
1954;Chácara das Pedras;Santa Tereza;300;150;32;8;250;50
1955;Chácara das Pedras;Santana;150;0;70;48;0;150
1956;Chácara das Pedras;Santo Antônio;50;0;0;0;50;0
1957;Chácara das Pedras;Sarandi;750;100;221;107;350;400
1958;Chácara das Pedras;Serraria;0;0;0;0;0;0
1959;Chácara das Pedras;São Caetano;0;0;0;0;0;0
1960;Chácara das Pedras;São Geraldo;50;50;0;0;50;0
1961;Chácara das Pedras;São José;250;0;147;43;0;250
1962;Chácara das Pedras;São João;50;0;33;12;0;50
1963;Chácara das Pedras;São Sebastião;100;0;56;10;0;100
1964;Chácara das Pedras;Sétimo Céu;0;0;0;0;0;0
1965;Chácara das Pedras;Teresópolis;100;0;57;26;0;100
1966;Chácara das Pedras;Tristeza;50;0;22;14;0;50
1967;Chácara das Pedras;Três Figueiras;628;300;25;14;578;50
1968;Chácara das Pedras;Vila Assunção;50;0;26;11;0;50
1969;Chácara das Pedras;Vila Conceição;50;0;27;8;0;50
1970;Chácara das Pedras;Vila Ipiranga;650;100;119;55;450;200
1971;Chácara das Pedras;Vila Jardim;1800;400;328;152;1250;550
1972;Chácara das Pedras;Vila João Pessoa;400;0;166;80;100;300
1973;Chácara das Pedras;Vila Nova;50;0;34;10;0;50
1974;Cidade Baixa;Aberta dos Morros;100;0;31;3;50;50
1975;Cidade Baixa;Agronomia;0;0;0;0;0;0
1976;Cidade Baixa;Anchieta;0;0;0;0;0;0
1977;Cidade Baixa;Arquipélago;250;200;29;4;200;50
1978;Cidade Baixa;Auxiliadora;350;100;118;35;150;200
1979;Cidade Baixa;Azenha;700;100;220;110;250;450
1980;Cidade Baixa;Bela Vista;350;50;75;33;200;150
1981;Cidade Baixa;Belém Novo;150;0;74;35;0;150
1982;Cidade Baixa;Belém Velho;100;0;68;22;0;100
1983;Cidade Baixa;Boa Vista;100;0;34;24;0;100
1984;Cidade Baixa;Boa Vista do Sul;50;0;0;0;50;0
1985;Cidade Baixa;Bom Fim;1550;0;542;302;450;1100
1986;Cidade Baixa;Bom Jesus;150;0;28;18;100;50
1987;Cidade Baixa;Camaquã;50;0;27;15;0;50
1988;Cidade Baixa;Campo Novo;50;0;0;0;50;0
1989;Cidade Baixa;Cascata;200;0;125;40;0;200
1990;Cidade Baixa;Cavalhada;150;100;0;0;150;0
1991;Cidade Baixa;Cel. Aparício Borges;100;0;24;10;50;50
1992;Cidade Baixa;Centro Histórico;1800;200;620;243;750;1050
1993;Cidade Baixa;Chapéu do Sol;50;0;0;0;50;0
1994;Cidade Baixa;Chácara das Pedras;50;0;0;0;50;0
1995;Cidade Baixa;Cidade Baixa;7900;0;4084;1916;0;7900
1996;Cidade Baixa;Costa e Silva;0;0;0;0;0;0
1997;Cidade Baixa;Cristal;450;100;102;48;250;200
1998;Cidade Baixa;Cristo Redentor;150;0;26;13;100;50
1999;Cidade Baixa;Espírito Santo;0;0;0;0;0;0
2000;Cidade Baixa;Extrema;150;50;25;11;100;50
2001;Cidade Baixa;Farrapos;0;0;0;0;0;0
2002;Cidade Baixa;Farroupilha;3800;750;436;194;2950;850
2003;Cidade Baixa;Floresta;150;50;0;0;150;0
2004;Cidade Baixa;Glória;50;0;21;9;0;50
2005;Cidade Baixa;Guarujá;50;0;24;14;0;50
2006;Cidade Baixa;Higienópolis;250;0;117;52;50;200
2007;Cidade Baixa;Humaitá;50;0;22;7;0;50
2008;Cidade Baixa;Hípica;100;0;62;13;0;100
2009;Cidade Baixa;Independência;1200;50;447;267;300;900
2010;Cidade Baixa;Ipanema;300;50;141;63;50;250
2011;Cidade Baixa;Jardim Botânico;100;0;60;18;0;100
2012;Cidade Baixa;Jardim Carvalho;100;0;71;11;0;100
2013;Cidade Baixa;Jardim Europa;100;0;51;27;0;100
2014;Cidade Baixa;Jardim Floresta;0;0;0;0;0;0
2015;Cidade Baixa;Jardim Isabel;0;0;0;0;0;0
2016;Cidade Baixa;Jardim Itú;350;100;179;35;150;200
2017;Cidade Baixa;Jardim Leopoldina;0;0;0;0;0;0
2018;Cidade Baixa;Jardim Lindóia;150;0;64;26;50;100
2019;Cidade Baixa;Jardim Sabará;0;0;0;0;0;0
2020;Cidade Baixa;Jardim São Pedro;50;0;34;11;0;50
2021;Cidade Baixa;Jardim do Salso;50;0;35;11;0;50
2022;Cidade Baixa;Lageado;0;0;0;0;0;0
2023;Cidade Baixa;Lami;0;0;0;0;0;0
2024;Cidade Baixa;Lomba do Pinheiro;50;0;28;7;0;50
2025;Cidade Baixa;Medianeira;300;0;78;41;150;150
2026;Cidade Baixa;Menino Deus;11350;1000;4958;2535;2350;9000
2027;Cidade Baixa;Moinhos de Vento;450;150;51;29;350;100
2028;Cidade Baixa;Mont'Serrat;300;50;102;54;100;200
2029;Cidade Baixa;Morro Santana;100;0;55;15;0;100
2030;Cidade Baixa;Mário Quintana;200;0;124;32;0;200
2031;Cidade Baixa;Navegantes;50;0;0;0;50;0
2032;Cidade Baixa;Nonoai;150;50;27;11;100;50
2033;Cidade Baixa;Parque Santa Fé;50;0;0;0;50;0
2034;Cidade Baixa;Partenon;850;100;358;150;200;650
2035;Cidade Baixa;Passo D'Areia;150;0;50;24;50;100
2036;Cidade Baixa;Passo das Pedras;150;0;87;29;0;150
2037;Cidade Baixa;Pedra Redonda;50;50;0;0;50;0
2038;Cidade Baixa;Petrópolis;300;100;101;38;150;150
2039;Cidade Baixa;Pitinga;150;50;23;12;100;50
2040;Cidade Baixa;Ponta Grossa;100;0;34;12;50;50
2041;Cidade Baixa;Praia de Belas;1192;50;501;219;292;900
2042;Cidade Baixa;Restinga;100;0;0;0;100;0
2043;Cidade Baixa;Rio Branco;550;50;276;102;150;400
2044;Cidade Baixa;Rubem Berta;200;0;44;39;100;100
2045;Cidade Baixa;Santa Cecília;150;0;94;29;0;150
2046;Cidade Baixa;Santa Maria Goretti;100;0;56;24;0;100
2047;Cidade Baixa;Santa Rosa de Lima;0;0;0;0;0;0
2048;Cidade Baixa;Santa Tereza;600;0;205;69;200;400
2049;Cidade Baixa;Santana;7150;400;3444;1831;650;6500
2050;Cidade Baixa;Santo Antônio;400;50;150;61;150;250
2051;Cidade Baixa;Sarandi;350;150;25;15;300;50
2052;Cidade Baixa;Serraria;100;50;0;0;100;0
2053;Cidade Baixa;São Caetano;100;50;29;13;50;50
2054;Cidade Baixa;São Geraldo;226;0;32;11;176;50
2055;Cidade Baixa;São José;50;50;0;0;50;0
2056;Cidade Baixa;São João;100;0;54;23;0;100
2057;Cidade Baixa;São Sebastião;0;0;0;0;0;0
2058;Cidade Baixa;Sétimo Céu;0;0;0;0;0;0
2059;Cidade Baixa;Teresópolis;250;0;114;51;50;200
2060;Cidade Baixa;Tristeza;200;0;86;38;50;150
2061;Cidade Baixa;Três Figueiras;200;50;80;31;50;150
2062;Cidade Baixa;Vila Assunção;0;0;0;0;0;0
2063;Cidade Baixa;Vila Conceição;0;0;0;0;0;0
2064;Cidade Baixa;Vila Ipiranga;150;50;30;8;100;50
2065;Cidade Baixa;Vila Jardim;150;0;65;35;0;150
2066;Cidade Baixa;Vila João Pessoa;150;50;30;8;100;50
2067;Cidade Baixa;Vila Nova;250;50;123;40;50;200
2068;Costa e Silva;Aberta dos Morros;100;0;69;14;0;100
2069;Costa e Silva;Agronomia;50;0;28;8;0;50
2070;Costa e Silva;Anchieta;150;50;31;9;100;50
2071;Costa e Silva;Arquipélago;150;0;53;22;50;100
2072;Costa e Silva;Auxiliadora;100;0;30;10;50;50
2073;Costa e Silva;Azenha;150;50;56;16;50;100
2074;Costa e Silva;Bela Vista;50;0;36;12;0;50
2075;Costa e Silva;Belém Novo;0;0;0;0;0;0
2076;Costa e Silva;Belém Velho;0;0;0;0;0;0
2077;Costa e Silva;Boa Vista;100;0;54;19;0;100
2078;Costa e Silva;Boa Vista do Sul;50;50;0;0;50;0
2079;Costa e Silva;Bom Fim;100;50;0;0;100;0
2080;Costa e Silva;Bom Jesus;200;200;0;0;200;0
2081;Costa e Silva;Camaquã;250;50;83;25;100;150
2082;Costa e Silva;Campo Novo;50;0;32;6;0;50
2083;Costa e Silva;Cascata;100;50;0;0;100;0
2084;Costa e Silva;Cavalhada;150;100;35;9;100;50
2085;Costa e Silva;Cel. Aparício Borges;0;0;0;0;0;0
2086;Costa e Silva;Centro Histórico;300;50;168;42;100;200
2087;Costa e Silva;Chapéu do Sol;50;0;34;4;0;50
2088;Costa e Silva;Chácara das Pedras;100;50;33;9;50;50
2089;Costa e Silva;Cidade Baixa;0;0;0;0;0;0
2090;Costa e Silva;Costa e Silva;4600;1000;1760;314;2000;2600
2091;Costa e Silva;Cristal;300;0;169;39;50;250
2092;Costa e Silva;Cristo Redentor;400;50;118;29;200;200
2093;Costa e Silva;Espírito Santo;50;0;34;7;0;50
2094;Costa e Silva;Extrema;100;0;58;9;0;100
2095;Costa e Silva;Farrapos;150;0;102;34;0;150
2096;Costa e Silva;Farroupilha;0;0;0;0;0;0
2097;Costa e Silva;Floresta;150;50;84;2;100;50
2098;Costa e Silva;Glória;150;0;64;8;50;100
2099;Costa e Silva;Guarujá;0;0;0;0;0;0
2100;Costa e Silva;Higienópolis;50;0;33;5;0;50
2101;Costa e Silva;Humaitá;200;50;68;18;100;100
2102;Costa e Silva;Hípica;0;0;0;0;0;0
2103;Costa e Silva;Independência;100;0;30;7;50;50
2104;Costa e Silva;Ipanema;0;0;0;0;0;0
2105;Costa e Silva;Jardim Botânico;0;0;0;0;0;0
2106;Costa e Silva;Jardim Carvalho;150;0;68;12;50;100
2107;Costa e Silva;Jardim Europa;50;0;32;5;0;50
2108;Costa e Silva;Jardim Floresta;100;50;29;5;50;50
2109;Costa e Silva;Jardim Isabel;50;0;31;8;0;50
2110;Costa e Silva;Jardim Itú;950;100;306;90;450;500
2111;Costa e Silva;Jardim Leopoldina;4350;200;2296;662;650;3700
2112;Costa e Silva;Jardim Lindóia;500;100;219;69;150;350
2113;Costa e Silva;Jardim Sabará;150;50;28;4;100;50
2114;Costa e Silva;Jardim São Pedro;150;100;33;9;100;50
2115;Costa e Silva;Jardim do Salso;100;50;0;0;100;0
2116;Costa e Silva;Lageado;0;0;0;0;0;0
2117;Costa e Silva;Lami;100;0;29;13;50;50
2118;Costa e Silva;Lomba do Pinheiro;150;0;30;8;100;50
2119;Costa e Silva;Medianeira;100;50;31;8;50;50
2120;Costa e Silva;Menino Deus;200;0;116;47;0;200
2121;Costa e Silva;Moinhos de Vento;50;0;0;0;50;0
2122;Costa e Silva;Mont'Serrat;100;0;54;16;0;100
2123;Costa e Silva;Morro Santana;300;0;125;36;100;200
2124;Costa e Silva;Mário Quintana;550;200;150;32;300;250
2125;Costa e Silva;Navegantes;50;0;24;13;0;50
2126;Costa e Silva;Nonoai;100;100;0;0;100;0
2127;Costa e Silva;Parque Santa Fé;2600;700;796;141;1600;1000
2128;Costa e Silva;Partenon;50;50;0;0;50;0
2129;Costa e Silva;Passo D'Areia;150;0;80;29;0;150
2130;Costa e Silva;Passo das Pedras;2400;600;1073;276;800;1600
2131;Costa e Silva;Pedra Redonda;0;0;0;0;0;0
2132;Costa e Silva;Petrópolis;300;50;140;54;50;250
2133;Costa e Silva;Pitinga;0;0;0;0;0;0
2134;Costa e Silva;Ponta Grossa;150;0;66;18;50;100
2135;Costa e Silva;Praia de Belas;100;0;81;4;50;50
2136;Costa e Silva;Restinga;200;100;62;9;100;100
2137;Costa e Silva;Rio Branco;50;0;28;11;0;50
2138;Costa e Silva;Rubem Berta;2750;650;910;463;1200;1550
2139;Costa e Silva;Santa Cecília;0;0;0;0;0;0
2140;Costa e Silva;Santa Maria Goretti;50;0;39;7;0;50
2141;Costa e Silva;Santa Rosa de Lima;1700;400;611;152;800;900
2142;Costa e Silva;Santa Tereza;200;50;34;10;150;50
2143;Costa e Silva;Santana;200;50;92;30;50;150
2144;Costa e Silva;Santo Antônio;50;0;0;0;50;0
2145;Costa e Silva;Sarandi;1100;100;543;204;200;900
2146;Costa e Silva;Serraria;0;0;0;0;0;0
2147;Costa e Silva;São Caetano;0;0;0;0;0;0
2148;Costa e Silva;São Geraldo;50;0;0;0;50;0
2149;Costa e Silva;São José;0;0;0;0;0;0
2150;Costa e Silva;São João;50;50;0;0;50;0
2151;Costa e Silva;São Sebastião;600;100;205;56;250;350
2152;Costa e Silva;Sétimo Céu;0;0;0;0;0;0
2153;Costa e Silva;Teresópolis;150;100;0;0;150;0
2154;Costa e Silva;Tristeza;150;50;67;29;50;100
2155;Costa e Silva;Três Figueiras;100;50;23;6;50;50
2156;Costa e Silva;Vila Assunção;50;0;32;12;0;50
2157;Costa e Silva;Vila Conceição;100;0;30;9;50;50
2158;Costa e Silva;Vila Ipiranga;400;50;201;39;100;300
2159;Costa e Silva;Vila Jardim;150;0;69;20;50;100
2160;Costa e Silva;Vila João Pessoa;150;0;88;25;0;150
2161;Costa e Silva;Vila Nova;150;100;31;7;100;50
2162;Cristal;Aberta dos Morros;100;50;27;8;50;50
2163;Cristal;Agronomia;0;0;0;0;0;0
2164;Cristal;Anchieta;50;0;26;15;0;50
2165;Cristal;Arquipélago;250;50;55;19;150;100
2166;Cristal;Auxiliadora;250;50;116;37;50;200
2167;Cristal;Azenha;600;50;200;67;250;350
2168;Cristal;Bela Vista;150;0;56;23;50;100
2169;Cristal;Belém Novo;50;0;25;15;0;50
2170;Cristal;Belém Velho;150;0;35;10;100;50
2171;Cristal;Boa Vista;150;0;92;23;0;150
2172;Cristal;Boa Vista do Sul;150;50;0;0;150;0
2173;Cristal;Bom Fim;200;50;43;28;100;100
2174;Cristal;Bom Jesus;250;50;82;31;100;150
2175;Cristal;Camaquã;3250;600;1266;370;1200;2050
2176;Cristal;Campo Novo;150;50;48;20;50;100
2177;Cristal;Cascata;0;0;0;0;0;0
2178;Cristal;Cavalhada;9100;400;4945;1668;450;8650
2179;Cristal;Cel. Aparício Borges;250;50;114;39;50;200
2180;Cristal;Centro Histórico;250;100;63;20;150;100
2181;Cristal;Chapéu do Sol;0;0;0;0;0;0
2182;Cristal;Chácara das Pedras;200;150;29;9;150;50
2183;Cristal;Cidade Baixa;450;100;102;48;250;200
2184;Cristal;Costa e Silva;300;0;169;39;50;250
2185;Cristal;Cristal;7000;1600;2864;914;2300;4700
2186;Cristal;Cristo Redentor;200;50;25;11;150;50
2187;Cristal;Espírito Santo;100;0;57;26;0;100
2188;Cristal;Extrema;100;0;25;12;50;50
2189;Cristal;Farrapos;100;0;0;0;100;0
2190;Cristal;Farroupilha;250;50;74;30;100;150
2191;Cristal;Floresta;50;50;0;0;50;0
2192;Cristal;Glória;150;0;60;20;50;100
2193;Cristal;Guarujá;0;0;0;0;0;0
2194;Cristal;Higienópolis;150;50;30;9;100;50
2195;Cristal;Humaitá;250;0;144;54;0;250
2196;Cristal;Hípica;200;0;98;23;50;150
2197;Cristal;Independência;100;50;27;6;50;50
2198;Cristal;Ipanema;250;0;126;52;50;200
2199;Cristal;Jardim Botânico;300;0;117;44;100;200
2200;Cristal;Jardim Carvalho;100;0;25;11;50;50
2201;Cristal;Jardim Europa;150;100;28;10;100;50
2202;Cristal;Jardim Floresta;0;0;0;0;0;0
2203;Cristal;Jardim Isabel;350;50;141;49;100;250
2204;Cristal;Jardim Itú;250;50;125;31;100;150
2205;Cristal;Jardim Leopoldina;150;50;55;27;50;100
2206;Cristal;Jardim Lindóia;150;0;78;10;100;50
2207;Cristal;Jardim Sabará;100;0;27;10;50;50
2208;Cristal;Jardim São Pedro;200;0;117;58;0;200
2209;Cristal;Jardim do Salso;100;100;0;0;100;0
2210;Cristal;Lageado;150;0;61;18;50;100
2211;Cristal;Lami;0;0;0;0;0;0
2212;Cristal;Lomba do Pinheiro;100;0;29;11;50;50
2213;Cristal;Medianeira;300;100;89;28;150;150
2214;Cristal;Menino Deus;450;0;212;88;50;400
2215;Cristal;Moinhos de Vento;200;0;84;42;50;150
2216;Cristal;Mont'Serrat;300;50;89;28;150;150
2217;Cristal;Morro Santana;150;50;55;20;50;100
2218;Cristal;Mário Quintana;250;0;116;16;50;200
2219;Cristal;Navegantes;50;0;26;10;0;50
2220;Cristal;Nonoai;3150;950;803;257;1850;1300
2221;Cristal;Parque Santa Fé;50;50;0;0;50;0
2222;Cristal;Partenon;300;100;98;40;100;200
2223;Cristal;Passo D'Areia;200;100;50;19;100;100
2224;Cristal;Passo das Pedras;250;100;88;30;100;150
2225;Cristal;Pedra Redonda;350;0;204;66;0;350
2226;Cristal;Petrópolis;150;0;80;33;0;150
2227;Cristal;Pitinga;100;50;32;6;50;50
2228;Cristal;Ponta Grossa;50;0;34;7;0;50
2229;Cristal;Praia de Belas;450;250;133;29;300;150
2230;Cristal;Restinga;50;0;30;7;0;50
2231;Cristal;Rio Branco;150;0;28;8;100;50
2232;Cristal;Rubem Berta;250;50;85;35;100;150
2233;Cristal;Santa Cecília;300;50;86;28;150;150
2234;Cristal;Santa Maria Goretti;0;0;0;0;0;0
2235;Cristal;Santa Rosa de Lima;0;0;0;0;0;0
2236;Cristal;Santa Tereza;4400;650;2015;624;1150;3250
2237;Cristal;Santana;100;0;46;26;0;100
2238;Cristal;Santo Antônio;250;100;53;20;150;100
2239;Cristal;Sarandi;550;100;233;101;150;400
2240;Cristal;Serraria;150;0;58;24;50;100
2241;Cristal;São Caetano;150;50;51;15;50;100
2242;Cristal;São Geraldo;150;50;30;11;100;50
2243;Cristal;São José;250;50;97;23;100;150
2244;Cristal;São João;100;0;59;17;0;100
2245;Cristal;São Sebastião;100;0;67;9;0;100
2246;Cristal;Sétimo Céu;900;250;209;51;650;250
2247;Cristal;Teresópolis;350;0;205;50;100;250
2248;Cristal;Tristeza;1100;50;437;202;350;750
2249;Cristal;Três Figueiras;150;0;84;27;0;150
2250;Cristal;Vila Assunção;1300;300;511;183;500;800
2251;Cristal;Vila Conceição;650;100;273;85;200;450
2252;Cristal;Vila Ipiranga;300;100;114;47;100;200
2253;Cristal;Vila Jardim;50;50;0;0;50;0
2254;Cristal;Vila João Pessoa;150;0;26;10;100;50
2255;Cristal;Vila Nova;500;100;190;79;150;350
2256;Cristo Redentor;Aberta dos Morros;0;0;0;0;0;0
2257;Cristo Redentor;Agronomia;50;0;0;0;50;0
2258;Cristo Redentor;Anchieta;300;50;88;34;150;150
2259;Cristo Redentor;Arquipélago;100;50;0;0;100;0
2260;Cristo Redentor;Auxiliadora;300;50;135;67;50;250
2261;Cristo Redentor;Azenha;50;0;33;6;0;50
2262;Cristo Redentor;Bela Vista;350;100;132;17;300;50
2263;Cristo Redentor;Belém Novo;0;0;0;0;0;0
2264;Cristo Redentor;Belém Velho;100;0;65;22;0;100
2265;Cristo Redentor;Boa Vista;700;100;343;93;300;400
2266;Cristo Redentor;Boa Vista do Sul;50;0;27;9;0;50
2267;Cristo Redentor;Bom Fim;250;0;120;53;50;200
2268;Cristo Redentor;Bom Jesus;200;50;65;23;100;100
2269;Cristo Redentor;Camaquã;250;50;49;19;150;100
2270;Cristo Redentor;Campo Novo;0;0;0;0;0;0
2271;Cristo Redentor;Cascata;50;0;30;16;0;50
2272;Cristo Redentor;Cavalhada;150;0;63;27;50;100
2273;Cristo Redentor;Cel. Aparício Borges;50;0;32;8;0;50
2274;Cristo Redentor;Centro Histórico;150;100;0;0;150;0
2275;Cristo Redentor;Chapéu do Sol;0;0;0;0;0;0
2276;Cristo Redentor;Chácara das Pedras;300;50;101;30;150;150
2277;Cristo Redentor;Cidade Baixa;150;0;26;13;100;50
2278;Cristo Redentor;Costa e Silva;400;50;118;29;200;200
2279;Cristo Redentor;Cristal;200;50;25;11;150;50
2280;Cristo Redentor;Cristo Redentor;3500;100;1918;798;200;3300
2281;Cristo Redentor;Espírito Santo;50;0;26;13;0;50
2282;Cristo Redentor;Extrema;0;0;0;0;0;0
2283;Cristo Redentor;Farrapos;0;0;0;0;0;0
2284;Cristo Redentor;Farroupilha;50;50;0;0;50;0
2285;Cristo Redentor;Floresta;100;50;29;11;50;50
2286;Cristo Redentor;Glória;200;0;31;4;150;50
2287;Cristo Redentor;Guarujá;50;0;29;14;0;50
2288;Cristo Redentor;Higienópolis;550;50;201;85;200;350
2289;Cristo Redentor;Humaitá;100;0;27;7;50;50
2290;Cristo Redentor;Hípica;50;0;32;13;0;50
2291;Cristo Redentor;Independência;50;0;25;11;0;50
2292;Cristo Redentor;Ipanema;50;0;34;13;0;50
2293;Cristo Redentor;Jardim Botânico;100;0;28;12;50;50
2294;Cristo Redentor;Jardim Carvalho;250;0;166;50;0;250
2295;Cristo Redentor;Jardim Europa;550;150;206;83;200;350
2296;Cristo Redentor;Jardim Floresta;2350;200;1098;467;450;1900
2297;Cristo Redentor;Jardim Isabel;50;0;26;8;0;50
2298;Cristo Redentor;Jardim Itú;350;50;157;68;50;300
2299;Cristo Redentor;Jardim Leopoldina;100;0;70;14;0;100
2300;Cristo Redentor;Jardim Lindóia;1800;100;927;397;250;1550
2301;Cristo Redentor;Jardim Sabará;200;150;0;0;200;0
2302;Cristo Redentor;Jardim São Pedro;3200;1150;565;175;2350;850
2303;Cristo Redentor;Jardim do Salso;150;100;32;5;100;50
2304;Cristo Redentor;Lageado;100;50;28;10;50;50
2305;Cristo Redentor;Lami;0;0;0;0;0;0
2306;Cristo Redentor;Lomba do Pinheiro;150;0;102;15;50;100
2307;Cristo Redentor;Medianeira;0;0;0;0;0;0
2308;Cristo Redentor;Menino Deus;0;0;0;0;0;0
2309;Cristo Redentor;Moinhos de Vento;50;0;30;15;0;50
2310;Cristo Redentor;Mont'Serrat;300;0;199;59;0;300
2311;Cristo Redentor;Morro Santana;300;100;83;34;150;150
2312;Cristo Redentor;Mário Quintana;200;0;108;24;0;200
2313;Cristo Redentor;Navegantes;50;0;22;15;0;50
2314;Cristo Redentor;Nonoai;350;50;144;33;200;150
2315;Cristo Redentor;Parque Santa Fé;150;0;87;38;0;150
2316;Cristo Redentor;Partenon;350;100;118;49;150;200
2317;Cristo Redentor;Passo D'Areia;1300;400;326;211;600;700
2318;Cristo Redentor;Passo das Pedras;300;150;54;18;200;100
2319;Cristo Redentor;Pedra Redonda;0;0;0;0;0;0
2320;Cristo Redentor;Petrópolis;500;50;189;89;150;350
2321;Cristo Redentor;Pitinga;0;0;0;0;0;0
2322;Cristo Redentor;Ponta Grossa;50;50;0;0;50;0
2323;Cristo Redentor;Praia de Belas;150;0;66;16;50;100
2324;Cristo Redentor;Restinga;300;50;143;73;50;250
2325;Cristo Redentor;Rio Branco;150;0;87;36;0;150
2326;Cristo Redentor;Rubem Berta;200;100;44;44;100;100
2327;Cristo Redentor;Santa Cecília;50;0;0;0;50;0
2328;Cristo Redentor;Santa Maria Goretti;1700;100;889;333;200;1500
2329;Cristo Redentor;Santa Rosa de Lima;250;0;140;37;100;150
2330;Cristo Redentor;Santa Tereza;200;50;55;19;100;100
2331;Cristo Redentor;Santana;150;50;52;38;50;100
2332;Cristo Redentor;Santo Antônio;50;0;33;11;0;50
2333;Cristo Redentor;Sarandi;1000;150;409;208;300;700
2334;Cristo Redentor;Serraria;0;0;0;0;0;0
2335;Cristo Redentor;São Caetano;0;0;0;0;0;0
2336;Cristo Redentor;São Geraldo;100;0;32;17;50;50
2337;Cristo Redentor;São José;0;0;0;0;0;0
2338;Cristo Redentor;São João;350;50;149;59;100;250
2339;Cristo Redentor;São Sebastião;500;50;284;90;100;400
2340;Cristo Redentor;Sétimo Céu;50;50;0;0;50;0
2341;Cristo Redentor;Teresópolis;100;50;0;0;100;0
2342;Cristo Redentor;Tristeza;50;0;25;14;0;50
2343;Cristo Redentor;Três Figueiras;200;50;60;18;100;100
2344;Cristo Redentor;Vila Assunção;50;0;50;0;50;0
2345;Cristo Redentor;Vila Conceição;50;0;25;19;0;50
2346;Cristo Redentor;Vila Ipiranga;3500;850;1264;497;1550;1950
2347;Cristo Redentor;Vila Jardim;350;50;103;59;150;200
2348;Cristo Redentor;Vila João Pessoa;50;0;32;13;0;50
2349;Cristo Redentor;Vila Nova;200;0;31;8;150;50
2350;Espírito Santo;Aberta dos Morros;1300;600;239;20;1150;150
2351;Espírito Santo;Agronomia;0;0;0;0;0;0
2352;Espírito Santo;Anchieta;50;0;20;4;0;50
2353;Espírito Santo;Arquipélago;200;0;112;33;0;200
2354;Espírito Santo;Auxiliadora;100;0;29;16;50;50
2355;Espírito Santo;Azenha;0;0;0;0;0;0
2356;Espírito Santo;Bela Vista;100;0;60;21;0;100
2357;Espírito Santo;Belém Novo;200;0;115;47;0;200
2358;Espírito Santo;Belém Velho;200;100;39;8;150;50
2359;Espírito Santo;Boa Vista;0;0;0;0;0;0
2360;Espírito Santo;Boa Vista do Sul;0;0;0;0;0;0
2361;Espírito Santo;Bom Fim;100;50;23;12;50;50
2362;Espírito Santo;Bom Jesus;0;0;0;0;0;0
2363;Espírito Santo;Camaquã;200;0;92;26;50;150
2364;Espírito Santo;Campo Novo;400;50;209;69;50;350
2365;Espírito Santo;Cascata;0;0;0;0;0;0
2366;Espírito Santo;Cavalhada;750;250;110;37;550;200
2367;Espírito Santo;Cel. Aparício Borges;50;0;0;0;50;0
2368;Espírito Santo;Centro Histórico;350;0;189;80;0;350
2369;Espírito Santo;Chapéu do Sol;50;0;28;8;0;50
2370;Espírito Santo;Chácara das Pedras;50;50;0;0;50;0
2371;Espírito Santo;Cidade Baixa;0;0;0;0;0;0
2372;Espírito Santo;Costa e Silva;50;0;34;7;0;50
2373;Espírito Santo;Cristal;100;0;57;26;0;100
2374;Espírito Santo;Cristo Redentor;50;0;26;13;0;50
2375;Espírito Santo;Espírito Santo;2300;0;1246;550;0;2300
2376;Espírito Santo;Extrema;0;0;0;0;0;0
2377;Espírito Santo;Farrapos;150;50;57;20;50;100
2378;Espírito Santo;Farroupilha;0;0;0;0;0;0
2379;Espírito Santo;Floresta;100;0;28;15;50;50
2380;Espírito Santo;Glória;50;0;0;0;50;0
2381;Espírito Santo;Guarujá;900;100;464;149;150;750
2382;Espírito Santo;Higienópolis;100;0;24;11;50;50
2383;Espírito Santo;Humaitá;31;0;31;0;31;0
2384;Espírito Santo;Hípica;200;0;103;16;50;150
2385;Espírito Santo;Independência;50;0;36;7;0;50
2386;Espírito Santo;Ipanema;700;50;327;112;150;550
2387;Espírito Santo;Jardim Botânico;50;50;0;0;50;0
2388;Espírito Santo;Jardim Carvalho;150;0;82;28;0;150
2389;Espírito Santo;Jardim Europa;0;0;0;0;0;0
2390;Espírito Santo;Jardim Floresta;0;0;0;0;0;0
2391;Espírito Santo;Jardim Isabel;200;50;35;6;150;50
2392;Espírito Santo;Jardim Itú;100;100;0;0;100;0
2393;Espírito Santo;Jardim Leopoldina;0;0;0;0;0;0
2394;Espírito Santo;Jardim Lindóia;0;0;0;0;0;0
2395;Espírito Santo;Jardim Sabará;0;0;0;0;0;0
2396;Espírito Santo;Jardim São Pedro;50;0;33;11;0;50
2397;Espírito Santo;Jardim do Salso;0;0;0;0;0;0
2398;Espírito Santo;Lageado;50;0;27;6;0;50
2399;Espírito Santo;Lami;50;0;29;8;0;50
2400;Espírito Santo;Lomba do Pinheiro;0;0;0;0;0;0
2401;Espírito Santo;Medianeira;0;0;0;0;0;0
2402;Espírito Santo;Menino Deus;50;0;29;20;0;50
2403;Espírito Santo;Moinhos de Vento;100;0;18;23;50;50
2404;Espírito Santo;Mont'Serrat;0;0;0;0;0;0
2405;Espírito Santo;Morro Santana;0;0;0;0;0;0
2406;Espírito Santo;Mário Quintana;100;0;67;15;0;100
2407;Espírito Santo;Navegantes;0;0;0;0;0;0
2408;Espírito Santo;Nonoai;100;50;33;14;50;50
2409;Espírito Santo;Parque Santa Fé;0;0;0;0;0;0
2410;Espírito Santo;Partenon;250;50;90;33;100;150
2411;Espírito Santo;Passo D'Areia;100;0;49;26;0;100
2412;Espírito Santo;Passo das Pedras;50;0;28;5;0;50
2413;Espírito Santo;Pedra Redonda;150;0;81;35;0;150
2414;Espírito Santo;Petrópolis;250;0;136;64;0;250
2415;Espírito Santo;Pitinga;50;0;31;7;0;50
2416;Espírito Santo;Ponta Grossa;500;50;248;69;100;400
2417;Espírito Santo;Praia de Belas;0;0;0;0;0;0
2418;Espírito Santo;Restinga;850;250;166;51;550;300
2419;Espírito Santo;Rio Branco;100;0;47;38;0;100
2420;Espírito Santo;Rubem Berta;0;0;0;0;0;0
2421;Espírito Santo;Santa Cecília;0;0;0;0;0;0
2422;Espírito Santo;Santa Maria Goretti;0;0;0;0;0;0
2423;Espírito Santo;Santa Rosa de Lima;50;0;35;8;0;50
2424;Espírito Santo;Santa Tereza;150;0;80;28;0;150
2425;Espírito Santo;Santana;100;50;0;0;100;0
2426;Espírito Santo;Santo Antônio;50;0;24;12;0;50
2427;Espírito Santo;Sarandi;150;0;49;40;50;100
2428;Espírito Santo;Serraria;1150;300;301;115;600;550
2429;Espírito Santo;São Caetano;0;0;0;0;0;0
2430;Espírito Santo;São Geraldo;100;0;0;0;100;0
2431;Espírito Santo;São José;100;0;50;20;0;100
2432;Espírito Santo;São João;50;0;26;12;0;50
2433;Espírito Santo;São Sebastião;0;0;0;0;0;0
2434;Espírito Santo;Sétimo Céu;150;50;56;19;50;100
2435;Espírito Santo;Teresópolis;250;50;92;28;100;150
2436;Espírito Santo;Tristeza;100;0;58;37;0;100
2437;Espírito Santo;Três Figueiras;0;0;0;0;0;0
2438;Espírito Santo;Vila Assunção;100;0;31;8;50;50
2439;Espírito Santo;Vila Conceição;250;100;102;26;100;150
2440;Espírito Santo;Vila Ipiranga;50;0;35;13;0;50
2441;Espírito Santo;Vila Jardim;50;0;0;0;50;0
2442;Espírito Santo;Vila João Pessoa;0;0;0;0;0;0
2443;Espírito Santo;Vila Nova;750;200;194;64;400;350
2444;Extrema;Aberta dos Morros;0;0;0;0;0;0
2445;Extrema;Agronomia;50;0;32;9;0;50
2446;Extrema;Anchieta;0;0;0;0;0;0
2447;Extrema;Arquipélago;150;0;87;21;0;150
2448;Extrema;Auxiliadora;50;50;0;0;50;0
2449;Extrema;Azenha;50;0;25;10;0;50
2450;Extrema;Bela Vista;0;0;0;0;0;0
2451;Extrema;Belém Novo;100;0;54;9;0;100
2452;Extrema;Belém Velho;0;0;0;0;0;0
2453;Extrema;Boa Vista;50;0;28;13;0;50
2454;Extrema;Boa Vista do Sul;0;0;0;0;0;0
2455;Extrema;Bom Fim;0;0;0;0;0;0
2456;Extrema;Bom Jesus;100;0;81;12;50;50
2457;Extrema;Camaquã;50;0;31;8;0;50
2458;Extrema;Campo Novo;0;0;0;0;0;0
2459;Extrema;Cascata;50;50;0;0;50;0
2460;Extrema;Cavalhada;100;50;32;4;50;50
2461;Extrema;Cel. Aparício Borges;100;0;59;16;0;100
2462;Extrema;Centro Histórico;100;0;55;21;0;100
2463;Extrema;Chapéu do Sol;0;0;0;0;0;0
2464;Extrema;Chácara das Pedras;0;0;0;0;0;0
2465;Extrema;Cidade Baixa;150;50;25;11;100;50
2466;Extrema;Costa e Silva;100;0;58;9;0;100
2467;Extrema;Cristal;100;0;25;12;50;50
2468;Extrema;Cristo Redentor;0;0;0;0;0;0
2469;Extrema;Espírito Santo;0;0;0;0;0;0
2470;Extrema;Extrema;100;100;0;0;100;0
2471;Extrema;Farrapos;50;50;0;0;50;0
2472;Extrema;Farroupilha;0;0;0;0;0;0
2473;Extrema;Floresta;0;0;0;0;0;0
2474;Extrema;Glória;200;0;97;35;50;150
2475;Extrema;Guarujá;0;0;0;0;0;0
2476;Extrema;Higienópolis;0;0;0;0;0;0
2477;Extrema;Humaitá;50;0;24;13;0;50
2478;Extrema;Hípica;100;0;67;14;0;100
2479;Extrema;Independência;50;0;0;0;50;0
2480;Extrema;Ipanema;0;0;0;0;0;0
2481;Extrema;Jardim Botânico;0;0;0;0;0;0
2482;Extrema;Jardim Carvalho;100;0;67;20;0;100
2483;Extrema;Jardim Europa;0;0;0;0;0;0
2484;Extrema;Jardim Floresta;50;0;0;0;50;0
2485;Extrema;Jardim Isabel;0;0;0;0;0;0
2486;Extrema;Jardim Itú;150;0;53;25;50;100
2487;Extrema;Jardim Leopoldina;100;50;24;11;50;50
2488;Extrema;Jardim Lindóia;0;0;0;0;0;0
2489;Extrema;Jardim Sabará;100;50;25;14;50;50
2490;Extrema;Jardim São Pedro;0;0;0;0;0;0
2491;Extrema;Jardim do Salso;0;0;0;0;0;0
2492;Extrema;Lageado;400;0;237;61;0;400
2493;Extrema;Lami;300;50;146;38;50;250
2494;Extrema;Lomba do Pinheiro;50;0;31;4;0;50
2495;Extrema;Medianeira;50;0;26;13;0;50
2496;Extrema;Menino Deus;100;50;21;18;50;50
2497;Extrema;Moinhos de Vento;0;0;0;0;0;0
2498;Extrema;Mont'Serrat;50;50;0;0;50;0
2499;Extrema;Morro Santana;250;50;121;39;50;200
2500;Extrema;Mário Quintana;100;0;63;15;0;100
2501;Extrema;Navegantes;50;0;25;10;0;50
2502;Extrema;Nonoai;50;0;25;14;0;50
2503;Extrema;Parque Santa Fé;50;50;0;0;50;0
2504;Extrema;Partenon;350;0;193;70;0;350
2505;Extrema;Passo D'Areia;0;0;0;0;0;0
2506;Extrema;Passo das Pedras;50;50;0;0;50;0
2507;Extrema;Pedra Redonda;0;0;0;0;0;0
2508;Extrema;Petrópolis;150;0;56;32;50;100
2509;Extrema;Pitinga;100;0;57;17;0;100
2510;Extrema;Ponta Grossa;50;0;0;0;50;0
2511;Extrema;Praia de Belas;0;0;0;0;0;0
2512;Extrema;Restinga;200;0;123;25;0;200
2513;Extrema;Rio Branco;50;0;28;11;0;50
2514;Extrema;Rubem Berta;0;0;0;0;0;0
2515;Extrema;Santa Cecília;0;0;0;0;0;0
2516;Extrema;Santa Maria Goretti;0;0;0;0;0;0
2517;Extrema;Santa Rosa de Lima;50;50;0;0;50;0
2518;Extrema;Santa Tereza;150;0;97;26;0;150
2519;Extrema;Santana;50;0;32;8;0;50
2520;Extrema;Santo Antônio;0;0;0;0;0;0
2521;Extrema;Sarandi;50;0;29;12;0;50
2522;Extrema;Serraria;0;0;0;0;0;0
2523;Extrema;São Caetano;100;0;60;21;0;100
2524;Extrema;São Geraldo;0;0;0;0;0;0
2525;Extrema;São José;50;0;0;0;50;0
2526;Extrema;São João;50;0;21;16;0;50
2527;Extrema;São Sebastião;0;0;0;0;0;0
2528;Extrema;Sétimo Céu;0;0;0;0;0;0
2529;Extrema;Teresópolis;50;0;25;13;0;50
2530;Extrema;Tristeza;50;0;0;0;50;0
2531;Extrema;Três Figueiras;0;0;0;0;0;0
2532;Extrema;Vila Assunção;0;0;0;0;0;0
2533;Extrema;Vila Conceição;0;0;0;0;0;0
2534;Extrema;Vila Ipiranga;50;0;28;10;0;50
2535;Extrema;Vila Jardim;100;0;26;14;50;50
2536;Extrema;Vila João Pessoa;100;0;56;23;0;100
2537;Extrema;Vila Nova;250;0;78;34;100;150
2538;Farrapos;Aberta dos Morros;0;0;0;0;0;0
2539;Farrapos;Agronomia;0;0;0;0;0;0
2540;Farrapos;Anchieta;1423;500;219;67;1073;350
2541;Farrapos;Arquipélago;100;0;54;14;0;100
2542;Farrapos;Auxiliadora;500;0;212;83;150;350
2543;Farrapos;Azenha;100;0;52;19;0;100
2544;Farrapos;Bela Vista;0;0;0;0;0;0
2545;Farrapos;Belém Novo;150;50;47;14;50;100
2546;Farrapos;Belém Velho;150;0;68;17;50;100
2547;Farrapos;Boa Vista;100;0;58;22;0;100
2548;Farrapos;Boa Vista do Sul;100;0;67;15;0;100
2549;Farrapos;Bom Fim;150;0;88;35;0;150
2550;Farrapos;Bom Jesus;200;100;50;0;200;0
2551;Farrapos;Camaquã;0;0;0;0;0;0
2552;Farrapos;Campo Novo;0;0;0;0;0;0
2553;Farrapos;Cascata;50;0;29;6;0;50
2554;Farrapos;Cavalhada;50;0;30;13;0;50
2555;Farrapos;Cel. Aparício Borges;50;0;26;14;0;50
2556;Farrapos;Centro Histórico;50;0;27;9;0;50
2557;Farrapos;Chapéu do Sol;50;0;26;10;0;50
2558;Farrapos;Chácara das Pedras;50;0;35;6;0;50
2559;Farrapos;Cidade Baixa;0;0;0;0;0;0
2560;Farrapos;Costa e Silva;150;0;102;34;0;150
2561;Farrapos;Cristal;100;0;0;0;100;0
2562;Farrapos;Cristo Redentor;0;0;0;0;0;0
2563;Farrapos;Espírito Santo;150;50;57;20;50;100
2564;Farrapos;Extrema;50;50;0;0;50;0
2565;Farrapos;Farrapos;7000;1100;3116;774;1900;5100
2566;Farrapos;Farroupilha;100;0;23;10;50;50
2567;Farrapos;Floresta;200;0;82;31;50;150
2568;Farrapos;Glória;200;0;74;36;50;150
2569;Farrapos;Guarujá;50;0;0;0;50;0
2570;Farrapos;Higienópolis;400;150;88;22;250;150
2571;Farrapos;Humaitá;7550;2350;2451;575;3900;3650
2572;Farrapos;Hípica;150;100;24;8;100;50
2573;Farrapos;Independência;300;100;114;49;100;200
2574;Farrapos;Ipanema;150;0;34;10;100;50
2575;Farrapos;Jardim Botânico;0;0;0;0;0;0
2576;Farrapos;Jardim Carvalho;50;0;20;10;0;50
2577;Farrapos;Jardim Europa;100;0;70;15;0;100
2578;Farrapos;Jardim Floresta;150;0;93;18;0;150
2579;Farrapos;Jardim Isabel;50;50;0;0;50;0
2580;Farrapos;Jardim Itú;200;0;85;25;50;150
2581;Farrapos;Jardim Leopoldina;50;50;0;0;50;0
2582;Farrapos;Jardim Lindóia;100;0;52;20;0;100
2583;Farrapos;Jardim Sabará;50;0;27;13;0;50
2584;Farrapos;Jardim São Pedro;396;100;178;24;196;200
2585;Farrapos;Jardim do Salso;50;0;23;4;0;50
2586;Farrapos;Lageado;50;0;33;4;0;50
2587;Farrapos;Lami;50;50;0;0;50;0
2588;Farrapos;Lomba do Pinheiro;150;0;89;15;0;150
2589;Farrapos;Medianeira;0;0;0;0;0;0
2590;Farrapos;Menino Deus;0;0;0;0;0;0
2591;Farrapos;Moinhos de Vento;200;0;110;58;0;200
2592;Farrapos;Mont'Serrat;100;0;27;12;50;50
2593;Farrapos;Morro Santana;0;0;0;0;0;0
2594;Farrapos;Mário Quintana;200;0;131;23;0;200
2595;Farrapos;Navegantes;2400;300;1079;253;650;1750
2596;Farrapos;Nonoai;50;0;29;12;0;50
2597;Farrapos;Parque Santa Fé;50;0;0;0;50;0
2598;Farrapos;Partenon;100;50;25;9;50;50
2599;Farrapos;Passo D'Areia;250;100;61;18;150;100
2600;Farrapos;Passo das Pedras;50;0;0;0;50;0
2601;Farrapos;Pedra Redonda;100;0;66;18;0;100
2602;Farrapos;Petrópolis;100;0;60;25;0;100
2603;Farrapos;Pitinga;0;0;0;0;0;0
2604;Farrapos;Ponta Grossa;100;0;66;13;0;100
2605;Farrapos;Praia de Belas;250;0;152;38;0;250
2606;Farrapos;Restinga;300;50;144;38;50;250
2607;Farrapos;Rio Branco;50;0;29;4;0;50
2608;Farrapos;Rubem Berta;50;0;34;4;0;50
2609;Farrapos;Santa Cecília;150;50;30;10;100;50
2610;Farrapos;Santa Maria Goretti;1000;400;134;19;800;200
2611;Farrapos;Santa Rosa de Lima;100;0;49;17;0;100
2612;Farrapos;Santa Tereza;150;0;58;21;50;100
2613;Farrapos;Santana;200;0;138;31;0;200
2614;Farrapos;Santo Antônio;50;0;27;9;0;50
2615;Farrapos;Sarandi;450;50;193;102;100;350
2616;Farrapos;Serraria;50;0;34;9;0;50
2617;Farrapos;São Caetano;0;0;0;0;0;0
2618;Farrapos;São Geraldo;350;150;78;7;300;50
2619;Farrapos;São José;100;50;30;12;50;50
2620;Farrapos;São João;300;0;135;37;150;150
2621;Farrapos;São Sebastião;0;0;0;0;0;0
2622;Farrapos;Sétimo Céu;200;50;90;21;50;150
2623;Farrapos;Teresópolis;50;0;33;3;0;50
2624;Farrapos;Tristeza;150;50;36;10;100;50
2625;Farrapos;Três Figueiras;150;50;46;20;50;100
2626;Farrapos;Vila Assunção;0;0;0;0;0;0
2627;Farrapos;Vila Conceição;50;0;34;7;0;50
2628;Farrapos;Vila Ipiranga;150;0;103;25;0;150
2629;Farrapos;Vila Jardim;50;0;24;11;0;50
2630;Farrapos;Vila João Pessoa;300;50;151;54;50;250
2631;Farrapos;Vila Nova;150;50;84;10;100;50
2632;Farroupilha;Aberta dos Morros;50;0;0;0;50;0
2633;Farroupilha;Agronomia;0;0;0;0;0;0
2634;Farroupilha;Anchieta;0;0;0;0;0;0
2635;Farroupilha;Arquipélago;350;100;119;39;150;200
2636;Farroupilha;Auxiliadora;150;50;58;28;50;100
2637;Farroupilha;Azenha;550;0;157;75;250;300
2638;Farroupilha;Bela Vista;150;50;58;27;50;100
2639;Farroupilha;Belém Novo;0;0;0;0;0;0
2640;Farroupilha;Belém Velho;50;0;26;16;0;50
2641;Farroupilha;Boa Vista;100;0;54;32;0;100
2642;Farroupilha;Boa Vista do Sul;0;0;0;0;0;0
2643;Farroupilha;Bom Fim;1547;100;509;260;597;950
2644;Farroupilha;Bom Jesus;200;50;67;23;100;100
2645;Farroupilha;Camaquã;100;50;0;0;100;0
2646;Farroupilha;Campo Novo;0;0;0;0;0;0
2647;Farroupilha;Cascata;0;0;0;0;0;0
2648;Farroupilha;Cavalhada;0;0;0;0;0;0
2649;Farroupilha;Cel. Aparício Borges;0;0;0;0;0;0
2650;Farroupilha;Centro Histórico;11600;300;5718;2602;850;10750
2651;Farroupilha;Chapéu do Sol;0;0;0;0;0;0
2652;Farroupilha;Chácara das Pedras;0;0;0;0;0;0
2653;Farroupilha;Cidade Baixa;3800;750;436;194;2950;850
2654;Farroupilha;Costa e Silva;0;0;0;0;0;0
2655;Farroupilha;Cristal;250;50;74;30;100;150
2656;Farroupilha;Cristo Redentor;50;50;0;0;50;0
2657;Farroupilha;Espírito Santo;0;0;0;0;0;0
2658;Farroupilha;Extrema;0;0;0;0;0;0
2659;Farroupilha;Farrapos;100;0;23;10;50;50
2660;Farroupilha;Farroupilha;100;0;44;40;0;100
2661;Farroupilha;Floresta;150;100;23;19;100;50
2662;Farroupilha;Glória;0;0;0;0;0;0
2663;Farroupilha;Guarujá;0;0;0;0;0;0
2664;Farroupilha;Higienópolis;50;0;32;16;0;50
2665;Farroupilha;Humaitá;0;0;0;0;0;0
2666;Farroupilha;Hípica;0;0;0;0;0;0
2667;Farroupilha;Independência;700;0;292;162;150;550
2668;Farroupilha;Ipanema;0;0;0;0;0;0
2669;Farroupilha;Jardim Botânico;150;100;31;7;100;50
2670;Farroupilha;Jardim Carvalho;100;50;25;11;50;50
2671;Farroupilha;Jardim Europa;0;0;0;0;0;0
2672;Farroupilha;Jardim Floresta;0;0;0;0;0;0
2673;Farroupilha;Jardim Isabel;0;0;0;0;0;0
2674;Farroupilha;Jardim Itú;250;0;163;39;0;250
2675;Farroupilha;Jardim Leopoldina;50;0;23;11;0;50
2676;Farroupilha;Jardim Lindóia;50;0;32;12;0;50
2677;Farroupilha;Jardim Sabará;100;50;29;11;50;50
2678;Farroupilha;Jardim São Pedro;0;0;0;0;0;0
2679;Farroupilha;Jardim do Salso;0;0;0;0;0;0
2680;Farroupilha;Lageado;0;0;0;0;0;0
2681;Farroupilha;Lami;0;0;0;0;0;0
2682;Farroupilha;Lomba do Pinheiro;100;0;26;5;50;50
2683;Farroupilha;Medianeira;100;0;32;14;50;50
2684;Farroupilha;Menino Deus;2800;250;1164;648;650;2150
2685;Farroupilha;Moinhos de Vento;400;50;144;95;100;300
2686;Farroupilha;Mont'Serrat;50;0;36;7;0;50
2687;Farroupilha;Morro Santana;50;50;0;0;50;0
2688;Farroupilha;Mário Quintana;0;0;0;0;0;0
2689;Farroupilha;Navegantes;50;0;27;14;0;50
2690;Farroupilha;Nonoai;150;50;57;17;50;100
2691;Farroupilha;Parque Santa Fé;50;0;33;11;0;50
2692;Farroupilha;Partenon;450;100;154;32;200;250
2693;Farroupilha;Passo D'Areia;100;0;34;34;0;100
2694;Farroupilha;Passo das Pedras;0;0;0;0;0;0
2695;Farroupilha;Pedra Redonda;50;0;22;17;0;50
2696;Farroupilha;Petrópolis;50;0;27;8;0;50
2697;Farroupilha;Pitinga;0;0;0;0;0;0
2698;Farroupilha;Ponta Grossa;0;0;0;0;0;0
2699;Farroupilha;Praia de Belas;150;0;90;37;0;150
2700;Farroupilha;Restinga;100;0;57;20;0;100
2701;Farroupilha;Rio Branco;400;100;104;58;200;200
2702;Farroupilha;Rubem Berta;100;0;0;0;100;0
2703;Farroupilha;Santa Cecília;400;50;178;90;100;300
2704;Farroupilha;Santa Maria Goretti;50;0;38;2;0;50
2705;Farroupilha;Santa Rosa de Lima;100;50;23;13;50;50
2706;Farroupilha;Santa Tereza;300;0;175;57;0;300
2707;Farroupilha;Santana;4750;1100;1047;343;3450;1300
2708;Farroupilha;Santo Antônio;200;50;86;33;50;150
2709;Farroupilha;Sarandi;300;0;134;43;150;150
2710;Farroupilha;Serraria;0;0;0;0;0;0
2711;Farroupilha;São Caetano;0;0;0;0;0;0
2712;Farroupilha;São Geraldo;50;0;28;7;0;50
2713;Farroupilha;São José;50;0;32;10;0;50
2714;Farroupilha;São João;150;0;81;44;0;150
2715;Farroupilha;São Sebastião;0;0;0;0;0;0
2716;Farroupilha;Sétimo Céu;0;0;0;0;0;0
2717;Farroupilha;Teresópolis;100;0;78;15;0;100
2718;Farroupilha;Tristeza;150;100;35;12;100;50
2719;Farroupilha;Três Figueiras;100;50;0;0;100;0
2720;Farroupilha;Vila Assunção;0;0;0;0;0;0
2721;Farroupilha;Vila Conceição;0;0;0;0;0;0
2722;Farroupilha;Vila Ipiranga;50;0;30;10;0;50
2723;Farroupilha;Vila Jardim;150;0;23;9;100;50
2724;Farroupilha;Vila João Pessoa;13;0;0;0;13;0
2725;Farroupilha;Vila Nova;50;50;0;0;50;0
2726;Floresta;Aberta dos Morros;0;0;0;0;0;0
2727;Floresta;Agronomia;150;50;32;7;100;50
2728;Floresta;Anchieta;0;0;0;0;0;0
2729;Floresta;Arquipélago;100;0;76;9;50;50
2730;Floresta;Auxiliadora;500;150;135;71;250;250
2731;Floresta;Azenha;350;0;160;83;50;300
2732;Floresta;Bela Vista;550;150;161;57;300;250
2733;Floresta;Belém Novo;50;50;0;0;50;0
2734;Floresta;Belém Velho;100;50;31;5;50;50
2735;Floresta;Boa Vista;100;0;29;18;50;50
2736;Floresta;Boa Vista do Sul;100;0;54;31;0;100
2737;Floresta;Bom Fim;750;50;155;105;450;300
2738;Floresta;Bom Jesus;150;0;43;29;50;100
2739;Floresta;Camaquã;0;0;0;0;0;0
2740;Floresta;Campo Novo;0;0;0;0;0;0
2741;Floresta;Cascata;100;0;67;9;0;100
2742;Floresta;Cavalhada;0;0;0;0;0;0
2743;Floresta;Cel. Aparício Borges;100;0;64;19;0;100
2744;Floresta;Centro Histórico;650;100;137;60;400;250
2745;Floresta;Chapéu do Sol;50;0;30;18;0;50
2746;Floresta;Chácara das Pedras;50;0;32;9;0;50
2747;Floresta;Cidade Baixa;150;50;0;0;150;0
2748;Floresta;Costa e Silva;150;50;84;2;100;50
2749;Floresta;Cristal;50;50;0;0;50;0
2750;Floresta;Cristo Redentor;100;50;29;11;50;50
2751;Floresta;Espírito Santo;100;0;28;15;50;50
2752;Floresta;Extrema;0;0;0;0;0;0
2753;Floresta;Farrapos;200;0;82;31;50;150
2754;Floresta;Farroupilha;150;100;23;19;100;50
2755;Floresta;Floresta;4100;100;2010;1046;300;3800
2756;Floresta;Glória;300;100;114;49;100;200
2757;Floresta;Guarujá;0;0;0;0;0;0
2758;Floresta;Higienópolis;400;0;226;95;50;350
2759;Floresta;Humaitá;100;50;0;0;100;0
2760;Floresta;Hípica;50;50;0;0;50;0
2761;Floresta;Independência;650;200;247;69;400;250
2762;Floresta;Ipanema;150;0;63;24;50;100
2763;Floresta;Jardim Botânico;150;0;87;37;0;150
2764;Floresta;Jardim Carvalho;300;50;85;29;150;150
2765;Floresta;Jardim Europa;100;0;32;16;50;50
2766;Floresta;Jardim Floresta;100;50;27;13;50;50
2767;Floresta;Jardim Isabel;0;0;0;0;0;0
2768;Floresta;Jardim Itú;100;0;82;15;50;50
2769;Floresta;Jardim Leopoldina;50;0;50;0;50;0
2770;Floresta;Jardim Lindóia;50;0;28;18;0;50
2771;Floresta;Jardim Sabará;100;0;60;25;0;100
2772;Floresta;Jardim São Pedro;200;0;116;43;0;200
2773;Floresta;Jardim do Salso;50;0;30;10;0;50
2774;Floresta;Lageado;50;0;28;6;0;50
2775;Floresta;Lami;0;0;0;0;0;0
2776;Floresta;Lomba do Pinheiro;150;50;84;14;100;50
2777;Floresta;Medianeira;0;0;0;0;0;0
2778;Floresta;Menino Deus;300;50;100;61;100;200
2779;Floresta;Moinhos de Vento;1950;50;869;474;350;1600
2780;Floresta;Mont'Serrat;300;50;90;42;150;150
2781;Floresta;Morro Santana;50;0;29;13;0;50
2782;Floresta;Mário Quintana;100;0;62;11;0;100
2783;Floresta;Navegantes;450;100;132;57;200;250
2784;Floresta;Nonoai;200;0;58;26;100;100
2785;Floresta;Parque Santa Fé;0;0;0;0;0;0
2786;Floresta;Partenon;200;0;106;36;0;200
2787;Floresta;Passo D'Areia;500;150;152;105;200;300
2788;Floresta;Passo das Pedras;100;0;52;19;0;100
2789;Floresta;Pedra Redonda;0;0;0;0;0;0
2790;Floresta;Petrópolis;350;50;119;56;150;200
2791;Floresta;Pitinga;0;0;0;0;0;0
2792;Floresta;Ponta Grossa;150;0;57;15;50;100
2793;Floresta;Praia de Belas;100;50;38;7;50;50
2794;Floresta;Restinga;100;0;68;23;0;100
2795;Floresta;Rio Branco;850;100;305;145;300;550
2796;Floresta;Rubem Berta;350;0;177;83;100;250
2797;Floresta;Santa Cecília;150;50;30;14;100;50
2798;Floresta;Santa Maria Goretti;150;50;29;12;100;50
2799;Floresta;Santa Rosa de Lima;0;0;0;0;0;0
2800;Floresta;Santa Tereza;200;0;120;32;0;200
2801;Floresta;Santana;250;150;34;12;200;50
2802;Floresta;Santo Antônio;150;0;77;45;0;150
2803;Floresta;Sarandi;400;0;196;65;150;250
2804;Floresta;Serraria;50;50;0;0;50;0
2805;Floresta;São Caetano;0;0;0;0;0;0
2806;Floresta;São Geraldo;3890;1200;857;352;2590;1300
2807;Floresta;São José;100;50;22;15;50;50
2808;Floresta;São João;2250;50;1053;597;250;2000
2809;Floresta;São Sebastião;150;0;81;38;0;150
2810;Floresta;Sétimo Céu;50;0;29;20;0;50
2811;Floresta;Teresópolis;50;50;0;0;50;0
2812;Floresta;Tristeza;50;0;28;11;0;50
2813;Floresta;Três Figueiras;200;0;58;27;100;100
2814;Floresta;Vila Assunção;0;0;0;0;0;0
2815;Floresta;Vila Conceição;50;0;0;0;50;0
2816;Floresta;Vila Ipiranga;50;0;25;13;0;50
2817;Floresta;Vila Jardim;0;0;0;0;0;0
2818;Floresta;Vila João Pessoa;50;0;0;0;50;0
2819;Floresta;Vila Nova;100;0;60;26;0;100
2820;Glória;Aberta dos Morros;200;50;85;22;50;150
2821;Glória;Agronomia;250;100;58;16;150;100
2822;Glória;Anchieta;50;0;28;8;0;50
2823;Glória;Arquipélago;50;50;0;0;50;0
2824;Glória;Auxiliadora;100;100;0;0;100;0
2825;Glória;Azenha;200;50;81;34;50;150
2826;Glória;Bela Vista;250;100;118;26;150;100
2827;Glória;Belém Novo;100;50;23;15;50;50
2828;Glória;Belém Velho;250;0;150;46;0;250
2829;Glória;Boa Vista;200;0;103;50;0;200
2830;Glória;Boa Vista do Sul;50;50;0;0;50;0
2831;Glória;Bom Fim;0;0;0;0;0;0
2832;Glória;Bom Jesus;200;100;54;20;100;100
2833;Glória;Camaquã;350;100;79;41;200;150
2834;Glória;Campo Novo;100;0;61;21;0;100
2835;Glória;Cascata;1450;250;574;171;450;1000
2836;Glória;Cavalhada;50;0;0;0;50;0
2837;Glória;Cel. Aparício Borges;4700;500;2179;784;700;4000
2838;Glória;Centro Histórico;100;0;58;24;0;100
2839;Glória;Chapéu do Sol;50;0;22;13;0;50
2840;Glória;Chácara das Pedras;50;0;29;6;0;50
2841;Glória;Cidade Baixa;50;0;21;9;0;50
2842;Glória;Costa e Silva;150;0;64;8;50;100
2843;Glória;Cristal;150;0;60;20;50;100
2844;Glória;Cristo Redentor;200;0;31;4;150;50
2845;Glória;Espírito Santo;50;0;0;0;50;0
2846;Glória;Extrema;200;0;97;35;50;150
2847;Glória;Farrapos;200;0;74;36;50;150
2848;Glória;Farroupilha;0;0;0;0;0;0
2849;Glória;Floresta;300;100;114;49;100;200
2850;Glória;Glória;8800;1200;3568;1234;2900;5900
2851;Glória;Guarujá;150;100;0;0;150;0
2852;Glória;Higienópolis;50;0;27;13;0;50
2853;Glória;Humaitá;100;50;21;12;50;50
2854;Glória;Hípica;100;50;50;0;100;0
2855;Glória;Independência;50;0;37;7;0;50
2856;Glória;Ipanema;100;0;36;13;50;50
2857;Glória;Jardim Botânico;350;50;156;51;150;200
2858;Glória;Jardim Carvalho;250;0;117;38;50;200
2859;Glória;Jardim Europa;0;0;0;0;0;0
2860;Glória;Jardim Floresta;50;0;22;10;0;50
2861;Glória;Jardim Isabel;200;100;60;21;100;100
2862;Glória;Jardim Itú;50;0;31;7;0;50
2863;Glória;Jardim Leopoldina;150;50;68;19;50;100
2864;Glória;Jardim Lindóia;0;0;0;0;0;0
2865;Glória;Jardim Sabará;150;0;51;26;50;100
2866;Glória;Jardim São Pedro;100;0;30;16;50;50
2867;Glória;Jardim do Salso;100;50;0;0;100;0
2868;Glória;Lageado;50;0;20;16;0;50
2869;Glória;Lami;200;0;94;27;50;150
2870;Glória;Lomba do Pinheiro;700;50;367;103;50;650
2871;Glória;Medianeira;400;50;118;38;200;200
2872;Glória;Menino Deus;150;50;56;23;50;100
2873;Glória;Moinhos de Vento;100;0;0;0;100;0
2874;Glória;Mont'Serrat;0;0;0;0;0;0
2875;Glória;Morro Santana;0;0;0;0;0;0
2876;Glória;Mário Quintana;150;0;82;25;0;150
2877;Glória;Navegantes;50;50;0;0;50;0
2878;Glória;Nonoai;1200;200;494;160;450;750
2879;Glória;Parque Santa Fé;0;0;0;0;0;0
2880;Glória;Partenon;13750;4450;2662;824;10000;3750
2881;Glória;Passo D'Areia;150;100;23;18;100;50
2882;Glória;Passo das Pedras;50;0;31;12;0;50
2883;Glória;Pedra Redonda;0;0;0;0;0;0
2884;Glória;Petrópolis;200;50;48;23;100;100
2885;Glória;Pitinga;150;50;61;17;50;100
2886;Glória;Ponta Grossa;200;50;83;30;50;150
2887;Glória;Praia de Belas;100;100;0;0;100;0
2888;Glória;Restinga;500;50;244;74;50;450
2889;Glória;Rio Branco;250;200;0;0;250;0
2890;Glória;Rubem Berta;50;50;0;0;50;0
2891;Glória;Santa Cecília;150;50;48;27;50;100
2892;Glória;Santa Maria Goretti;50;0;27;9;0;50
2893;Glória;Santa Rosa de Lima;200;50;61;20;100;100
2894;Glória;Santa Tereza;1000;300;258;77;550;450
2895;Glória;Santana;350;50;122;79;100;250
2896;Glória;Santo Antônio;550;100;233;91;150;400
2897;Glória;Sarandi;250;50;86;33;100;150
2898;Glória;Serraria;50;0;22;17;0;50
2899;Glória;São Caetano;50;0;22;13;0;50
2900;Glória;São Geraldo;300;50;136;64;50;250
2901;Glória;São José;650;100;149;46;400;250
2902;Glória;São João;100;0;26;18;50;50
2903;Glória;São Sebastião;100;0;26;10;50;50
2904;Glória;Sétimo Céu;50;0;32;11;0;50
2905;Glória;Teresópolis;1550;900;214;82;1200;350
2906;Glória;Tristeza;150;50;34;16;100;50
2907;Glória;Três Figueiras;150;0;27;16;100;50
2908;Glória;Vila Assunção;50;0;23;10;0;50
2909;Glória;Vila Conceição;0;0;0;0;0;0
2910;Glória;Vila Ipiranga;100;50;0;0;100;0
2911;Glória;Vila Jardim;0;0;0;0;0;0
2912;Glória;Vila João Pessoa;1200;150;450;179;400;800
2913;Glória;Vila Nova;750;100;254;117;300;450
2914;Guarujá;Aberta dos Morros;500;0;189;58;200;300
2915;Guarujá;Agronomia;0;0;0;0;0;0
2916;Guarujá;Anchieta;0;0;0;0;0;0
2917;Guarujá;Arquipélago;100;0;56;15;0;100
2918;Guarujá;Auxiliadora;0;0;0;0;0;0
2919;Guarujá;Azenha;50;50;0;0;50;0
2920;Guarujá;Bela Vista;100;0;64;28;0;100
2921;Guarujá;Belém Novo;300;50;152;40;50;250
2922;Guarujá;Belém Velho;100;50;21;8;50;50
2923;Guarujá;Boa Vista;0;0;0;0;0;0
2924;Guarujá;Boa Vista do Sul;0;0;0;0;0;0
2925;Guarujá;Bom Fim;0;0;0;0;0;0
2926;Guarujá;Bom Jesus;250;50;89;16;100;150
2927;Guarujá;Camaquã;500;150;203;37;250;250
2928;Guarujá;Campo Novo;350;50;140;29;200;150
2929;Guarujá;Cascata;200;50;64;16;100;100
2930;Guarujá;Cavalhada;450;50;146;50;200;250
2931;Guarujá;Cel. Aparício Borges;100;50;25;11;50;50
2932;Guarujá;Centro Histórico;0;0;0;0;0;0
2933;Guarujá;Chapéu do Sol;50;50;0;0;50;0
2934;Guarujá;Chácara das Pedras;50;0;31;13;0;50
2935;Guarujá;Cidade Baixa;50;0;24;14;0;50
2936;Guarujá;Costa e Silva;0;0;0;0;0;0
2937;Guarujá;Cristal;0;0;0;0;0;0
2938;Guarujá;Cristo Redentor;50;0;29;14;0;50
2939;Guarujá;Espírito Santo;900;100;464;149;150;750
2940;Guarujá;Extrema;0;0;0;0;0;0
2941;Guarujá;Farrapos;50;0;0;0;50;0
2942;Guarujá;Farroupilha;0;0;0;0;0;0
2943;Guarujá;Floresta;0;0;0;0;0;0
2944;Guarujá;Glória;150;100;0;0;150;0
2945;Guarujá;Guarujá;4200;1000;1670;388;2100;2100
2946;Guarujá;Higienópolis;50;50;0;0;50;0
2947;Guarujá;Humaitá;50;0;28;12;0;50
2948;Guarujá;Hípica;200;50;83;30;50;150
2949;Guarujá;Independência;50;0;31;7;0;50
2950;Guarujá;Ipanema;0;0;0;0;0;0
2951;Guarujá;Jardim Botânico;50;0;0;0;50;0
2952;Guarujá;Jardim Carvalho;200;0;82;25;50;150
2953;Guarujá;Jardim Europa;0;0;0;0;0;0
2954;Guarujá;Jardim Floresta;0;0;0;0;0;0
2955;Guarujá;Jardim Isabel;0;0;0;0;0;0
2956;Guarujá;Jardim Itú;100;50;24;13;50;50
2957;Guarujá;Jardim Leopoldina;100;0;31;7;50;50
2958;Guarujá;Jardim Lindóia;0;0;0;0;0;0
2959;Guarujá;Jardim Sabará;0;0;0;0;0;0
2960;Guarujá;Jardim São Pedro;0;0;0;0;0;0
2961;Guarujá;Jardim do Salso;50;0;40;8;0;50
2962;Guarujá;Lageado;0;0;0;0;0;0
2963;Guarujá;Lami;0;0;0;0;0;0
2964;Guarujá;Lomba do Pinheiro;50;0;33;7;0;50
2965;Guarujá;Medianeira;50;0;39;3;0;50
2966;Guarujá;Menino Deus;200;0;55;35;100;100
2967;Guarujá;Moinhos de Vento;50;0;28;9;0;50
2968;Guarujá;Mont'Serrat;0;0;0;0;0;0
2969;Guarujá;Morro Santana;100;0;64;23;0;100
2970;Guarujá;Mário Quintana;50;50;0;0;50;0
2971;Guarujá;Navegantes;0;0;0;0;0;0
2972;Guarujá;Nonoai;50;0;23;22;0;50
2973;Guarujá;Parque Santa Fé;50;50;0;0;50;0
2974;Guarujá;Partenon;250;50;113;48;50;200
2975;Guarujá;Passo D'Areia;0;0;0;0;0;0
2976;Guarujá;Passo das Pedras;50;0;33;5;0;50
2977;Guarujá;Pedra Redonda;50;50;0;0;50;0
2978;Guarujá;Petrópolis;150;50;32;13;100;50
2979;Guarujá;Pitinga;0;0;0;0;0;0
2980;Guarujá;Ponta Grossa;850;150;324;96;300;550
2981;Guarujá;Praia de Belas;0;0;0;0;0;0
2982;Guarujá;Restinga;1000;200;428;119;250;750
2983;Guarujá;Rio Branco;50;0;33;16;0;50
2984;Guarujá;Rubem Berta;0;0;0;0;0;0
2985;Guarujá;Santa Cecília;50;0;36;5;0;50
2986;Guarujá;Santa Maria Goretti;100;0;63;16;0;100
2987;Guarujá;Santa Rosa de Lima;50;50;0;0;50;0
2988;Guarujá;Santa Tereza;250;50;100;43;50;200
2989;Guarujá;Santana;0;0;0;0;0;0
2990;Guarujá;Santo Antônio;0;0;0;0;0;0
2991;Guarujá;Sarandi;200;50;52;27;100;100
2992;Guarujá;Serraria;1800;650;483;159;1050;750
2993;Guarujá;São Caetano;0;0;0;0;0;0
2994;Guarujá;São Geraldo;0;0;0;0;0;0
2995;Guarujá;São José;0;0;0;0;0;0
2996;Guarujá;São João;0;0;0;0;0;0
2997;Guarujá;São Sebastião;0;0;0;0;0;0
2998;Guarujá;Sétimo Céu;200;0;82;23;50;150
2999;Guarujá;Teresópolis;0;0;0;0;0;0
3000;Guarujá;Tristeza;100;50;33;15;50;50
3001;Guarujá;Três Figueiras;0;0;0;0;0;0
3002;Guarujá;Vila Assunção;0;0;0;0;0;0
3003;Guarujá;Vila Conceição;0;0;0;0;0;0
3004;Guarujá;Vila Ipiranga;0;0;0;0;0;0
3005;Guarujá;Vila Jardim;0;0;0;0;0;0
3006;Guarujá;Vila João Pessoa;50;0;36;9;0;50
3007;Guarujá;Vila Nova;200;0;121;44;0;200
3008;Higienópolis;Aberta dos Morros;50;0;30;12;0;50
3009;Higienópolis;Agronomia;150;0;93;26;0;150
3010;Higienópolis;Anchieta;100;0;33;3;50;50
3011;Higienópolis;Arquipélago;0;0;0;0;0;0
3012;Higienópolis;Auxiliadora;400;100;88;30;250;150
3013;Higienópolis;Azenha;100;50;0;0;100;0
3014;Higienópolis;Bela Vista;50;0;31;15;0;50
3015;Higienópolis;Belém Novo;150;100;29;5;100;50
3016;Higienópolis;Belém Velho;150;0;86;32;0;150
3017;Higienópolis;Boa Vista;1400;150;669;275;250;1150
3018;Higienópolis;Boa Vista do Sul;0;0;0;0;0;0
3019;Higienópolis;Bom Fim;200;50;40;8;150;50
3020;Higienópolis;Bom Jesus;300;100;103;32;150;150
3021;Higienópolis;Camaquã;50;0;0;0;50;0
3022;Higienópolis;Campo Novo;50;0;0;0;50;0
3023;Higienópolis;Cascata;100;50;31;4;50;50
3024;Higienópolis;Cavalhada;50;0;24;10;0;50
3025;Higienópolis;Cel. Aparício Borges;150;100;30;7;100;50
3026;Higienópolis;Centro Histórico;700;0;319;137;150;550
3027;Higienópolis;Chapéu do Sol;150;0;95;33;0;150
3028;Higienópolis;Chácara das Pedras;100;50;36;8;50;50
3029;Higienópolis;Cidade Baixa;250;0;117;52;50;200
3030;Higienópolis;Costa e Silva;50;0;33;5;0;50
3031;Higienópolis;Cristal;150;50;30;9;100;50
3032;Higienópolis;Cristo Redentor;550;50;201;85;200;350
3033;Higienópolis;Espírito Santo;100;0;24;11;50;50
3034;Higienópolis;Extrema;0;0;0;0;0;0
3035;Higienópolis;Farrapos;400;150;88;22;250;150
3036;Higienópolis;Farroupilha;50;0;32;16;0;50
3037;Higienópolis;Floresta;400;0;226;95;50;350
3038;Higienópolis;Glória;50;0;27;13;0;50
3039;Higienópolis;Guarujá;50;50;0;0;50;0
3040;Higienópolis;Higienópolis;8900;1100;4024;1452;2800;6100
3041;Higienópolis;Humaitá;400;100;161;41;150;250
3042;Higienópolis;Hípica;100;0;58;22;0;100
3043;Higienópolis;Independência;150;0;60;18;50;100
3044;Higienópolis;Ipanema;0;0;0;0;0;0
3045;Higienópolis;Jardim Botânico;150;50;78;15;100;50
3046;Higienópolis;Jardim Carvalho;0;0;0;0;0;0
3047;Higienópolis;Jardim Europa;100;0;65;19;0;100
3048;Higienópolis;Jardim Floresta;200;50;88;39;50;150
3049;Higienópolis;Jardim Isabel;0;0;0;0;0;0
3050;Higienópolis;Jardim Itú;150;0;111;23;50;100
3051;Higienópolis;Jardim Leopoldina;350;0;165;48;100;250
3052;Higienópolis;Jardim Lindóia;100;50;31;10;50;50
3053;Higienópolis;Jardim Sabará;200;50;89;33;50;150
3054;Higienópolis;Jardim São Pedro;150;50;75;23;50;100
3055;Higienópolis;Jardim do Salso;100;50;23;11;50;50
3056;Higienópolis;Lageado;0;0;0;0;0;0
3057;Higienópolis;Lami;50;50;0;0;50;0
3058;Higienópolis;Lomba do Pinheiro;150;50;31;4;100;50
3059;Higienópolis;Medianeira;100;0;60;24;0;100
3060;Higienópolis;Menino Deus;0;0;0;0;0;0
3061;Higienópolis;Moinhos de Vento;100;0;53;33;0;100
3062;Higienópolis;Mont'Serrat;1015;50;475;201;215;800
3063;Higienópolis;Morro Santana;200;100;55;20;100;100
3064;Higienópolis;Mário Quintana;0;0;0;0;0;0
3065;Higienópolis;Navegantes;100;0;64;19;0;100
3066;Higienópolis;Nonoai;0;0;0;0;0;0
3067;Higienópolis;Parque Santa Fé;100;0;0;0;100;0
3068;Higienópolis;Partenon;50;0;35;12;0;50
3069;Higienópolis;Passo D'Areia;3900;400;1364;1106;750;3150
3070;Higienópolis;Passo das Pedras;0;0;0;0;0;0
3071;Higienópolis;Pedra Redonda;0;0;0;0;0;0
3072;Higienópolis;Petrópolis;500;100;177;71;200;300
3073;Higienópolis;Pitinga;100;0;67;24;0;100
3074;Higienópolis;Ponta Grossa;100;0;33;17;50;50
3075;Higienópolis;Praia de Belas;0;0;0;0;0;0
3076;Higienópolis;Restinga;50;0;0;0;50;0
3077;Higienópolis;Rio Branco;150;0;102;23;50;100
3078;Higienópolis;Rubem Berta;50;50;0;0;50;0
3079;Higienópolis;Santa Cecília;50;0;29;20;0;50
3080;Higienópolis;Santa Maria Goretti;1050;300;328;100;500;550
3081;Higienópolis;Santa Rosa de Lima;0;0;0;0;0;0
3082;Higienópolis;Santa Tereza;100;50;26;11;50;50
3083;Higienópolis;Santana;100;0;63;21;0;100
3084;Higienópolis;Santo Antônio;0;0;0;0;0;0
3085;Higienópolis;Sarandi;750;0;342;180;100;650
3086;Higienópolis;Serraria;0;0;0;0;0;0
3087;Higienópolis;São Caetano;50;0;0;0;50;0
3088;Higienópolis;São Geraldo;100;0;56;27;0;100
3089;Higienópolis;São José;50;0;32;15;0;50
3090;Higienópolis;São João;1000;350;166;48;800;200
3091;Higienópolis;São Sebastião;100;50;30;9;50;50
3092;Higienópolis;Sétimo Céu;50;0;0;0;50;0
3093;Higienópolis;Teresópolis;250;0;111;53;50;200
3094;Higienópolis;Tristeza;50;50;0;0;50;0
3095;Higienópolis;Três Figueiras;250;0;121;50;50;200
3096;Higienópolis;Vila Assunção;0;0;0;0;0;0
3097;Higienópolis;Vila Conceição;0;0;0;0;0;0
3098;Higienópolis;Vila Ipiranga;250;0;167;41;50;200
3099;Higienópolis;Vila Jardim;100;0;55;30;0;100
3100;Higienópolis;Vila João Pessoa;150;50;34;9;100;50
3101;Higienópolis;Vila Nova;100;0;70;18;0;100
3102;Humaitá;Aberta dos Morros;50;0;27;10;0;50
3103;Humaitá;Agronomia;0;0;0;0;0;0
3104;Humaitá;Anchieta;486;50;69;9;386;100
3105;Humaitá;Arquipélago;0;0;0;0;0;0
3106;Humaitá;Auxiliadora;0;0;0;0;0;0
3107;Humaitá;Azenha;50;0;33;4;0;50
3108;Humaitá;Bela Vista;50;0;33;3;0;50
3109;Humaitá;Belém Novo;50;0;0;0;50;0
3110;Humaitá;Belém Velho;50;0;31;6;0;50
3111;Humaitá;Boa Vista;100;50;39;5;50;50
3112;Humaitá;Boa Vista do Sul;150;50;35;7;100;50
3113;Humaitá;Bom Fim;100;0;71;11;0;100
3114;Humaitá;Bom Jesus;200;0;115;32;0;200
3115;Humaitá;Camaquã;100;50;28;7;50;50
3116;Humaitá;Campo Novo;200;0;120;31;0;200
3117;Humaitá;Cascata;100;100;0;0;100;0
3118;Humaitá;Cavalhada;100;0;65;17;0;100
3119;Humaitá;Cel. Aparício Borges;200;50;89;17;50;150
3120;Humaitá;Centro Histórico;150;0;89;35;0;150
3121;Humaitá;Chapéu do Sol;50;0;31;7;0;50
3122;Humaitá;Chácara das Pedras;100;0;27;13;50;50
3123;Humaitá;Cidade Baixa;50;0;22;7;0;50
3124;Humaitá;Costa e Silva;200;50;68;18;100;100
3125;Humaitá;Cristal;250;0;144;54;0;250
3126;Humaitá;Cristo Redentor;100;0;27;7;50;50
3127;Humaitá;Espírito Santo;31;0;31;0;31;0
3128;Humaitá;Extrema;50;0;24;13;0;50
3129;Humaitá;Farrapos;7550;2350;2451;575;3900;3650
3130;Humaitá;Farroupilha;0;0;0;0;0;0
3131;Humaitá;Floresta;100;50;0;0;100;0
3132;Humaitá;Glória;100;50;21;12;50;50
3133;Humaitá;Guarujá;50;0;28;12;0;50
3134;Humaitá;Higienópolis;400;100;161;41;150;250
3135;Humaitá;Humaitá;6300;1600;1660;368;3800;2500
3136;Humaitá;Hípica;50;0;38;5;0;50
3137;Humaitá;Independência;100;0;72;15;0;100
3138;Humaitá;Ipanema;100;0;72;17;0;100
3139;Humaitá;Jardim Botânico;100;50;0;0;100;0
3140;Humaitá;Jardim Carvalho;50;0;32;13;0;50
3141;Humaitá;Jardim Europa;150;0;112;19;0;150
3142;Humaitá;Jardim Floresta;250;50;99;27;100;150
3143;Humaitá;Jardim Isabel;100;0;71;16;0;100
3144;Humaitá;Jardim Itú;100;0;26;9;50;50
3145;Humaitá;Jardim Leopoldina;50;50;0;0;50;0
3146;Humaitá;Jardim Lindóia;150;0;66;24;50;100
3147;Humaitá;Jardim Sabará;150;0;96;43;0;150
3148;Humaitá;Jardim São Pedro;450;0;257;58;50;400
3149;Humaitá;Jardim do Salso;150;50;73;15;50;100
3150;Humaitá;Lageado;100;0;31;6;50;50
3151;Humaitá;Lami;150;0;92;23;0;150
3152;Humaitá;Lomba do Pinheiro;150;0;90;12;0;150
3153;Humaitá;Medianeira;50;0;31;8;0;50
3154;Humaitá;Menino Deus;150;0;60;30;50;100
3155;Humaitá;Moinhos de Vento;100;0;65;13;0;100
3156;Humaitá;Mont'Serrat;0;0;0;0;0;0
3157;Humaitá;Morro Santana;50;50;0;0;50;0
3158;Humaitá;Mário Quintana;100;50;26;4;50;50
3159;Humaitá;Navegantes;1402;600;264;75;952;450
3160;Humaitá;Nonoai;50;50;0;0;50;0
3161;Humaitá;Parque Santa Fé;0;0;0;0;0;0
3162;Humaitá;Partenon;200;50;58;27;100;100
3163;Humaitá;Passo D'Areia;150;0;56;18;50;100
3164;Humaitá;Passo das Pedras;50;50;0;0;50;0
3165;Humaitá;Pedra Redonda;0;0;0;0;0;0
3166;Humaitá;Petrópolis;150;50;25;16;100;50
3167;Humaitá;Pitinga;50;0;28;9;0;50
3168;Humaitá;Ponta Grossa;100;0;58;17;0;100
3169;Humaitá;Praia de Belas;50;0;29;10;0;50
3170;Humaitá;Restinga;400;50;154;40;150;250
3171;Humaitá;Rio Branco;50;0;28;21;0;50
3172;Humaitá;Rubem Berta;100;0;57;20;0;100
3173;Humaitá;Santa Cecília;100;0;63;19;0;100
3174;Humaitá;Santa Maria Goretti;350;150;37;8;300;50
3175;Humaitá;Santa Rosa de Lima;100;0;41;6;50;50
3176;Humaitá;Santa Tereza;100;0;59;16;0;100
3177;Humaitá;Santana;100;0;52;11;0;100
3178;Humaitá;Santo Antônio;0;0;0;0;0;0
3179;Humaitá;Sarandi;300;100;87;30;150;150
3180;Humaitá;Serraria;0;0;0;0;0;0
3181;Humaitá;São Caetano;50;0;39;7;0;50
3182;Humaitá;São Geraldo;200;50;89;35;50;150
3183;Humaitá;São José;50;0;35;6;0;50
3184;Humaitá;São João;250;100;63;11;150;100
3185;Humaitá;São Sebastião;50;0;37;8;0;50
3186;Humaitá;Sétimo Céu;0;0;0;0;0;0
3187;Humaitá;Teresópolis;50;0;50;0;50;0
3188;Humaitá;Tristeza;50;0;0;0;50;0
3189;Humaitá;Três Figueiras;50;0;32;7;0;50
3190;Humaitá;Vila Assunção;100;50;35;9;50;50
3191;Humaitá;Vila Conceição;0;0;0;0;0;0
3192;Humaitá;Vila Ipiranga;50;0;28;6;0;50
3193;Humaitá;Vila Jardim;150;100;29;12;100;50
3194;Humaitá;Vila João Pessoa;100;0;60;17;0;100
3195;Humaitá;Vila Nova;150;50;54;18;50;100
3196;Hípica;Aberta dos Morros;1600;300;711;154;600;1000
3197;Hípica;Agronomia;50;50;0;0;50;0
3198;Hípica;Anchieta;100;50;27;5;50;50
3199;Hípica;Arquipélago;0;0;0;0;0;0
3200;Hípica;Auxiliadora;50;0;0;0;50;0
3201;Hípica;Azenha;150;50;32;8;100;50
3202;Hípica;Bela Vista;200;0;105;28;50;150
3203;Hípica;Belém Novo;2250;300;1108;312;450;1800
3204;Hípica;Belém Velho;450;150;174;42;150;300
3205;Hípica;Boa Vista;0;0;0;0;0;0
3206;Hípica;Boa Vista do Sul;150;0;87;25;0;150
3207;Hípica;Bom Fim;50;50;0;0;50;0
3208;Hípica;Bom Jesus;150;50;25;6;100;50
3209;Hípica;Camaquã;150;0;92;34;0;150
3210;Hípica;Campo Novo;300;100;120;29;100;200
3211;Hípica;Cascata;150;50;36;5;100;50
3212;Hípica;Cavalhada;550;50;199;69;200;350
3213;Hípica;Cel. Aparício Borges;150;0;97;20;0;150
3214;Hípica;Centro Histórico;100;0;42;27;0;100
3215;Hípica;Chapéu do Sol;5300;1000;2127;489;2200;3100
3216;Hípica;Chácara das Pedras;50;50;0;0;50;0
3217;Hípica;Cidade Baixa;100;0;62;13;0;100
3218;Hípica;Costa e Silva;0;0;0;0;0;0
3219;Hípica;Cristal;200;0;98;23;50;150
3220;Hípica;Cristo Redentor;50;0;32;13;0;50
3221;Hípica;Espírito Santo;200;0;103;16;50;150
3222;Hípica;Extrema;100;0;67;14;0;100
3223;Hípica;Farrapos;150;100;24;8;100;50
3224;Hípica;Farroupilha;0;0;0;0;0;0
3225;Hípica;Floresta;50;50;0;0;50;0
3226;Hípica;Glória;100;50;50;0;100;0
3227;Hípica;Guarujá;200;50;83;30;50;150
3228;Hípica;Higienópolis;100;0;58;22;0;100
3229;Hípica;Humaitá;50;0;38;5;0;50
3230;Hípica;Hípica;8180;3400;1160;200;6780;1400
3231;Hípica;Independência;0;0;0;0;0;0
3232;Hípica;Ipanema;400;0;179;43;150;250
3233;Hípica;Jardim Botânico;150;0;59;14;50;100
3234;Hípica;Jardim Carvalho;50;50;0;0;50;0
3235;Hípica;Jardim Europa;50;0;29;8;0;50
3236;Hípica;Jardim Floresta;50;50;0;0;50;0
3237;Hípica;Jardim Isabel;200;0;68;17;100;100
3238;Hípica;Jardim Itú;50;0;29;8;0;50
3239;Hípica;Jardim Leopoldina;50;0;40;8;0;50
3240;Hípica;Jardim Lindóia;0;0;0;0;0;0
3241;Hípica;Jardim Sabará;50;50;0;0;50;0
3242;Hípica;Jardim São Pedro;50;50;0;0;50;0
3243;Hípica;Jardim do Salso;0;0;0;0;0;0
3244;Hípica;Lageado;300;0;210;43;0;300
3245;Hípica;Lami;150;0;89;26;0;150
3246;Hípica;Lomba do Pinheiro;200;100;30;2;150;50
3247;Hípica;Medianeira;250;50;103;25;100;150
3248;Hípica;Menino Deus;100;0;42;34;0;100
3249;Hípica;Moinhos de Vento;100;0;0;0;100;0
3250;Hípica;Mont'Serrat;50;0;25;13;0;50
3251;Hípica;Morro Santana;150;0;63;17;50;100
3252;Hípica;Mário Quintana;0;0;0;0;0;0
3253;Hípica;Navegantes;0;0;0;0;0;0
3254;Hípica;Nonoai;250;0;159;50;0;250
3255;Hípica;Parque Santa Fé;100;0;62;16;0;100
3256;Hípica;Partenon;300;0;145;49;50;250
3257;Hípica;Passo D'Areia;0;0;0;0;0;0
3258;Hípica;Passo das Pedras;50;0;37;3;0;50
3259;Hípica;Pedra Redonda;150;0;83;19;0;150
3260;Hípica;Petrópolis;50;0;0;0;50;0
3261;Hípica;Pitinga;350;50;163;41;100;250
3262;Hípica;Ponta Grossa;800;150;329;84;300;500
3263;Hípica;Praia de Belas;0;0;0;0;0;0
3264;Hípica;Restinga;1450;300;530;140;550;900
3265;Hípica;Rio Branco;100;50;25;8;50;50
3266;Hípica;Rubem Berta;250;50;44;27;150;100
3267;Hípica;Santa Cecília;200;0;62;25;100;100
3268;Hípica;Santa Maria Goretti;0;0;0;0;0;0
3269;Hípica;Santa Rosa de Lima;0;0;0;0;0;0
3270;Hípica;Santa Tereza;200;50;86;19;50;150
3271;Hípica;Santana;100;0;41;33;0;100
3272;Hípica;Santo Antônio;150;0;78;39;0;150
3273;Hípica;Sarandi;50;0;28;7;0;50
3274;Hípica;Serraria;600;50;319;84;100;500
3275;Hípica;São Caetano;150;50;33;8;100;50
3276;Hípica;São Geraldo;0;0;0;0;0;0
3277;Hípica;São José;150;50;76;11;50;100
3278;Hípica;São João;150;50;59;25;50;100
3279;Hípica;São Sebastião;0;0;0;0;0;0
3280;Hípica;Sétimo Céu;50;0;36;6;0;50
3281;Hípica;Teresópolis;100;0;67;21;0;100
3282;Hípica;Tristeza;200;0;142;23;0;200
3283;Hípica;Três Figueiras;100;0;35;6;50;50
3284;Hípica;Vila Assunção;50;50;0;0;50;0
3285;Hípica;Vila Conceição;50;0;0;0;50;0
3286;Hípica;Vila Ipiranga;0;0;0;0;0;0
3287;Hípica;Vila Jardim;0;0;0;0;0;0
3288;Hípica;Vila João Pessoa;300;50;133;34;100;200
3289;Hípica;Vila Nova;450;100;140;27;300;150
3290;Independência;Aberta dos Morros;0;0;0;0;0;0
3291;Independência;Agronomia;0;0;0;0;0;0
3292;Independência;Anchieta;100;0;23;8;50;50
3293;Independência;Arquipélago;200;0;84;19;50;150
3294;Independência;Auxiliadora;300;50;88;52;150;150
3295;Independência;Azenha;450;100;134;72;200;250
3296;Independência;Bela Vista;250;100;75;51;100;150
3297;Independência;Belém Novo;0;0;0;0;0;0
3298;Independência;Belém Velho;50;0;31;15;0;50
3299;Independência;Boa Vista;100;0;26;18;50;50
3300;Independência;Boa Vista do Sul;50;0;26;14;0;50
3301;Independência;Bom Fim;3550;400;1088;631;1350;2200
3302;Independência;Bom Jesus;100;0;64;19;0;100
3303;Independência;Camaquã;0;0;0;0;0;0
3304;Independência;Campo Novo;0;0;0;0;0;0
3305;Independência;Cascata;150;50;73;20;100;50
3306;Independência;Cavalhada;100;0;32;14;50;50
3307;Independência;Cel. Aparício Borges;50;0;25;25;0;50
3308;Independência;Centro Histórico;1650;150;578;233;750;900
3309;Independência;Chapéu do Sol;0;0;0;0;0;0
3310;Independência;Chácara das Pedras;50;0;18;16;0;50
3311;Independência;Cidade Baixa;1200;50;447;267;300;900
3312;Independência;Costa e Silva;100;0;30;7;50;50
3313;Independência;Cristal;100;50;27;6;50;50
3314;Independência;Cristo Redentor;50;0;25;11;0;50
3315;Independência;Espírito Santo;50;0;36;7;0;50
3316;Independência;Extrema;50;0;0;0;50;0
3317;Independência;Farrapos;300;100;114;49;100;200
3318;Independência;Farroupilha;700;0;292;162;150;550
3319;Independência;Floresta;650;200;247;69;400;250
3320;Independência;Glória;50;0;37;7;0;50
3321;Independência;Guarujá;50;0;31;7;0;50
3322;Independência;Higienópolis;150;0;60;18;50;100
3323;Independência;Humaitá;100;0;72;15;0;100
3324;Independência;Hípica;0;0;0;0;0;0
3325;Independência;Independência;2600;600;458;280;1700;900
3326;Independência;Ipanema;50;0;0;0;50;0
3327;Independência;Jardim Botânico;150;0;92;43;0;150
3328;Independência;Jardim Carvalho;100;0;28;13;50;50
3329;Independência;Jardim Europa;100;50;24;10;50;50
3330;Independência;Jardim Floresta;100;0;27;11;50;50
3331;Independência;Jardim Isabel;0;0;0;0;0;0
3332;Independência;Jardim Itú;50;0;0;0;50;0
3333;Independência;Jardim Leopoldina;100;0;68;15;0;100
3334;Independência;Jardim Lindóia;0;0;0;0;0;0
3335;Independência;Jardim Sabará;150;50;32;14;100;50
3336;Independência;Jardim São Pedro;100;50;0;0;100;0
3337;Independência;Jardim do Salso;100;50;0;0;100;0
3338;Independência;Lageado;0;0;0;0;0;0
3339;Independência;Lami;0;0;0;0;0;0
3340;Independência;Lomba do Pinheiro;50;0;0;0;50;0
3341;Independência;Medianeira;200;0;109;44;0;200
3342;Independência;Menino Deus;350;50;72;48;200;150
3343;Independência;Moinhos de Vento;950;150;348;253;250;700
3344;Independência;Mont'Serrat;250;50;109;61;50;200
3345;Independência;Morro Santana;0;0;0;0;0;0
3346;Independência;Mário Quintana;50;0;28;5;0;50
3347;Independência;Navegantes;50;0;0;0;50;0
3348;Independência;Nonoai;150;50;57;24;50;100
3349;Independência;Parque Santa Fé;100;0;27;13;50;50
3350;Independência;Partenon;500;50;239;87;50;450
3351;Independência;Passo D'Areia;250;0;91;80;50;200
3352;Independência;Passo das Pedras;50;0;34;9;0;50
3353;Independência;Pedra Redonda;0;0;0;0;0;0
3354;Independência;Petrópolis;200;50;90;46;50;150
3355;Independência;Pitinga;0;0;0;0;0;0
3356;Independência;Ponta Grossa;0;0;0;0;0;0
3357;Independência;Praia de Belas;100;0;17;17;50;50
3358;Independência;Restinga;50;0;50;0;50;0
3359;Independência;Rio Branco;1400;250;427;265;500;900
3360;Independência;Rubem Berta;50;0;31;16;0;50
3361;Independência;Santa Cecília;500;150;70;38;350;150
3362;Independência;Santa Maria Goretti;100;0;34;3;50;50
3363;Independência;Santa Rosa de Lima;50;0;0;0;50;0
3364;Independência;Santa Tereza;450;50;172;68;100;350
3365;Independência;Santana;650;100;211;81;350;300
3366;Independência;Santo Antônio;150;0;69;18;100;50
3367;Independência;Sarandi;300;150;58;25;200;100
3368;Independência;Serraria;0;0;0;0;0;0
3369;Independência;São Caetano;50;0;0;0;50;0
3370;Independência;São Geraldo;300;0;160;92;0;300
3371;Independência;São José;150;0;21;19;100;50
3372;Independência;São João;200;0;23;19;150;50
3373;Independência;São Sebastião;150;0;62;25;50;100
3374;Independência;Sétimo Céu;0;0;0;0;0;0
3375;Independência;Teresópolis;0;0;0;0;0;0
3376;Independência;Tristeza;0;0;0;0;0;0
3377;Independência;Três Figueiras;50;0;0;0;50;0
3378;Independência;Vila Assunção;50;0;0;0;50;0
3379;Independência;Vila Conceição;0;0;0;0;0;0
3380;Independência;Vila Ipiranga;50;0;0;0;50;0
3381;Independência;Vila Jardim;100;0;66;23;0;100
3382;Independência;Vila João Pessoa;100;0;0;0;100;0
3383;Independência;Vila Nova;100;0;21;15;50;50
3384;Ipanema;Aberta dos Morros;200;50;85;32;50;150
3385;Ipanema;Agronomia;100;0;63;30;0;100
3386;Ipanema;Anchieta;50;0;0;0;50;0
3387;Ipanema;Arquipélago;100;0;57;15;0;100
3388;Ipanema;Auxiliadora;50;0;21;14;0;50
3389;Ipanema;Azenha;50;0;32;14;0;50
3390;Ipanema;Bela Vista;150;0;88;32;0;150
3391;Ipanema;Belém Novo;50;50;0;0;50;0
3392;Ipanema;Belém Velho;400;50;211;67;50;350
3393;Ipanema;Boa Vista;50;50;0;0;50;0
3394;Ipanema;Boa Vista do Sul;50;0;27;15;0;50
3395;Ipanema;Bom Fim;0;0;0;0;0;0
3396;Ipanema;Bom Jesus;50;0;22;9;0;50
3397;Ipanema;Camaquã;550;150;224;74;200;350
3398;Ipanema;Campo Novo;700;0;413;138;0;700
3399;Ipanema;Cascata;50;0;0;0;50;0
3400;Ipanema;Cavalhada;2000;750;242;83;1600;400
3401;Ipanema;Cel. Aparício Borges;0;0;0;0;0;0
3402;Ipanema;Centro Histórico;200;100;57;20;100;100
3403;Ipanema;Chapéu do Sol;50;50;0;0;50;0
3404;Ipanema;Chácara das Pedras;50;50;0;0;50;0
3405;Ipanema;Cidade Baixa;300;50;141;63;50;250
3406;Ipanema;Costa e Silva;0;0;0;0;0;0
3407;Ipanema;Cristal;250;0;126;52;50;200
3408;Ipanema;Cristo Redentor;50;0;34;13;0;50
3409;Ipanema;Espírito Santo;700;50;327;112;150;550
3410;Ipanema;Extrema;0;0;0;0;0;0
3411;Ipanema;Farrapos;150;0;34;10;100;50
3412;Ipanema;Farroupilha;0;0;0;0;0;0
3413;Ipanema;Floresta;150;0;63;24;50;100
3414;Ipanema;Glória;100;0;36;13;50;50
3415;Ipanema;Guarujá;0;0;0;0;0;0
3416;Ipanema;Higienópolis;0;0;0;0;0;0
3417;Ipanema;Humaitá;100;0;72;17;0;100
3418;Ipanema;Hípica;400;0;179;43;150;250
3419;Ipanema;Independência;50;0;0;0;50;0
3420;Ipanema;Ipanema;5022;2400;410;94;4522;500
3421;Ipanema;Jardim Botânico;100;0;61;21;0;100
3422;Ipanema;Jardim Carvalho;0;0;0;0;0;0
3423;Ipanema;Jardim Europa;50;0;33;9;0;50
3424;Ipanema;Jardim Floresta;0;0;0;0;0;0
3425;Ipanema;Jardim Isabel;2050;550;627;237;1050;1000
3426;Ipanema;Jardim Itú;0;0;0;0;0;0
3427;Ipanema;Jardim Leopoldina;100;0;26;15;50;50
3428;Ipanema;Jardim Lindóia;50;0;37;10;0;50
3429;Ipanema;Jardim Sabará;100;0;58;19;0;100
3430;Ipanema;Jardim São Pedro;0;0;0;0;0;0
3431;Ipanema;Jardim do Salso;0;0;0;0;0;0
3432;Ipanema;Lageado;50;0;28;11;0;50
3433;Ipanema;Lami;0;0;0;0;0;0
3434;Ipanema;Lomba do Pinheiro;0;0;0;0;0;0
3435;Ipanema;Medianeira;100;50;26;9;50;50
3436;Ipanema;Menino Deus;50;0;25;16;0;50
3437;Ipanema;Moinhos de Vento;0;0;0;0;0;0
3438;Ipanema;Mont'Serrat;0;0;0;0;0;0
3439;Ipanema;Morro Santana;0;0;0;0;0;0
3440;Ipanema;Mário Quintana;100;50;30;8;50;50
3441;Ipanema;Navegantes;50;0;28;11;0;50
3442;Ipanema;Nonoai;300;0;179;61;0;300
3443;Ipanema;Parque Santa Fé;0;0;0;0;0;0
3444;Ipanema;Partenon;100;0;60;17;0;100
3445;Ipanema;Passo D'Areia;0;0;0;0;0;0
3446;Ipanema;Passo das Pedras;100;0;71;16;0;100
3447;Ipanema;Pedra Redonda;400;50;143;33;250;150
3448;Ipanema;Petrópolis;200;0;111;49;0;200
3449;Ipanema;Pitinga;0;0;0;0;0;0
3450;Ipanema;Ponta Grossa;700;50;382;110;150;550
3451;Ipanema;Praia de Belas;150;50;61;16;50;100
3452;Ipanema;Restinga;700;100;277;61;250;450
3453;Ipanema;Rio Branco;50;0;23;12;0;50
3454;Ipanema;Rubem Berta;0;0;0;0;0;0
3455;Ipanema;Santa Cecília;0;0;0;0;0;0
3456;Ipanema;Santa Maria Goretti;0;0;0;0;0;0
3457;Ipanema;Santa Rosa de Lima;100;0;33;13;50;50
3458;Ipanema;Santa Tereza;300;0;145;42;50;250
3459;Ipanema;Santana;400;0;175;104;50;350
3460;Ipanema;Santo Antônio;200;0;93;34;50;150
3461;Ipanema;Sarandi;50;0;22;16;0;50
3462;Ipanema;Serraria;750;50;357;107;150;600
3463;Ipanema;São Caetano;100;50;21;10;50;50
3464;Ipanema;São Geraldo;0;0;0;0;0;0
3465;Ipanema;São José;50;0;34;12;0;50
3466;Ipanema;São João;50;0;0;0;50;0
3467;Ipanema;São Sebastião;150;0;82;35;0;150
3468;Ipanema;Sétimo Céu;1350;300;568;200;500;850
3469;Ipanema;Teresópolis;550;200;178;45;350;200
3470;Ipanema;Tristeza;700;100;312;128;200;500
3471;Ipanema;Três Figueiras;0;0;0;0;0;0
3472;Ipanema;Vila Assunção;100;0;0;0;100;0
3473;Ipanema;Vila Conceição;1100;100;568;187;200;900
3474;Ipanema;Vila Ipiranga;150;50;63;32;50;100
3475;Ipanema;Vila Jardim;100;0;62;24;0;100
3476;Ipanema;Vila João Pessoa;0;0;0;0;0;0
3477;Ipanema;Vila Nova;1750;0;950;371;150;1600
3478;Jardim Botânico;Aberta dos Morros;50;0;25;9;0;50
3479;Jardim Botânico;Agronomia;50;0;0;0;50;0
3480;Jardim Botânico;Anchieta;0;0;0;0;0;0
3481;Jardim Botânico;Arquipélago;50;0;50;0;50;0
3482;Jardim Botânico;Auxiliadora;150;0;75;36;0;150
3483;Jardim Botânico;Azenha;300;0;82;35;150;150
3484;Jardim Botânico;Bela Vista;350;200;33;9;300;50
3485;Jardim Botânico;Belém Novo;50;0;0;0;50;0
3486;Jardim Botânico;Belém Velho;50;0;34;11;0;50
3487;Jardim Botânico;Boa Vista;0;0;0;0;0;0
3488;Jardim Botânico;Boa Vista do Sul;0;0;0;0;0;0
3489;Jardim Botânico;Bom Fim;350;0;180;82;50;300
3490;Jardim Botânico;Bom Jesus;700;200;200;70;350;350
3491;Jardim Botânico;Camaquã;50;0;0;0;50;0
3492;Jardim Botânico;Campo Novo;100;50;36;10;50;50
3493;Jardim Botânico;Cascata;450;0;206;65;100;350
3494;Jardim Botânico;Cavalhada;150;50;30;10;100;50
3495;Jardim Botânico;Cel. Aparício Borges;1100;200;406;87;500;600
3496;Jardim Botânico;Centro Histórico;400;50;182;79;50;350
3497;Jardim Botânico;Chapéu do Sol;50;0;0;0;50;0
3498;Jardim Botânico;Chácara das Pedras;150;0;83;46;0;150
3499;Jardim Botânico;Cidade Baixa;100;0;60;18;0;100
3500;Jardim Botânico;Costa e Silva;0;0;0;0;0;0
3501;Jardim Botânico;Cristal;300;0;117;44;100;200
3502;Jardim Botânico;Cristo Redentor;100;0;28;12;50;50
3503;Jardim Botânico;Espírito Santo;50;50;0;0;50;0
3504;Jardim Botânico;Extrema;0;0;0;0;0;0
3505;Jardim Botânico;Farrapos;0;0;0;0;0;0
3506;Jardim Botânico;Farroupilha;150;100;31;7;100;50
3507;Jardim Botânico;Floresta;150;0;87;37;0;150
3508;Jardim Botânico;Glória;350;50;156;51;150;200
3509;Jardim Botânico;Guarujá;50;0;0;0;50;0
3510;Jardim Botânico;Higienópolis;150;50;78;15;100;50
3511;Jardim Botânico;Humaitá;100;50;0;0;100;0
3512;Jardim Botânico;Hípica;150;0;59;14;50;100
3513;Jardim Botânico;Independência;150;0;92;43;0;150
3514;Jardim Botânico;Ipanema;100;0;61;21;0;100
3515;Jardim Botânico;Jardim Botânico;7200;500;3754;1496;600;6600
3516;Jardim Botânico;Jardim Carvalho;300;50;120;35;100;200
3517;Jardim Botânico;Jardim Europa;100;0;65;17;0;100
3518;Jardim Botânico;Jardim Floresta;0;0;0;0;0;0
3519;Jardim Botânico;Jardim Isabel;0;0;0;0;0;0
3520;Jardim Botânico;Jardim Itú;200;50;66;23;100;100
3521;Jardim Botânico;Jardim Leopoldina;0;0;0;0;0;0
3522;Jardim Botânico;Jardim Lindóia;150;50;62;20;50;100
3523;Jardim Botânico;Jardim Sabará;200;50;64;18;100;100
3524;Jardim Botânico;Jardim São Pedro;50;0;24;17;0;50
3525;Jardim Botânico;Jardim do Salso;618;50;268;64;318;300
3526;Jardim Botânico;Lageado;100;50;31;9;50;50
3527;Jardim Botânico;Lami;50;0;50;0;50;0
3528;Jardim Botânico;Lomba do Pinheiro;500;0;278;51;50;450
3529;Jardim Botânico;Medianeira;200;50;80;37;50;150
3530;Jardim Botânico;Menino Deus;400;150;133;38;250;150
3531;Jardim Botânico;Moinhos de Vento;200;0;73;54;50;150
3532;Jardim Botânico;Mont'Serrat;450;100;190;76;100;350
3533;Jardim Botânico;Morro Santana;100;50;30;14;50;50
3534;Jardim Botânico;Mário Quintana;100;50;0;0;100;0
3535;Jardim Botânico;Navegantes;0;0;0;0;0;0
3536;Jardim Botânico;Nonoai;200;50;83;36;50;150
3537;Jardim Botânico;Parque Santa Fé;100;50;33;9;50;50
3538;Jardim Botânico;Partenon;1500;100;752;252;200;1300
3539;Jardim Botânico;Passo D'Areia;100;0;13;18;50;50
3540;Jardim Botânico;Passo das Pedras;50;50;0;0;50;0
3541;Jardim Botânico;Pedra Redonda;50;50;0;0;50;0
3542;Jardim Botânico;Petrópolis;2850;650;577;176;2200;650
3543;Jardim Botânico;Pitinga;100;50;26;12;50;50
3544;Jardim Botânico;Ponta Grossa;100;0;0;0;100;0
3545;Jardim Botânico;Praia de Belas;250;0;136;71;0;250
3546;Jardim Botânico;Restinga;500;50;173;55;200;300
3547;Jardim Botânico;Rio Branco;500;50;249;84;200;300
3548;Jardim Botânico;Rubem Berta;100;50;0;0;100;0
3549;Jardim Botânico;Santa Cecília;450;100;107;58;250;200
3550;Jardim Botânico;Santa Maria Goretti;150;50;56;19;50;100
3551;Jardim Botânico;Santa Rosa de Lima;150;50;31;7;100;50
3552;Jardim Botânico;Santa Tereza;300;0;83;27;150;150
3553;Jardim Botânico;Santana;200;0;80;38;50;150
3554;Jardim Botânico;Santo Antônio;500;50;186;63;250;250
3555;Jardim Botânico;Sarandi;100;50;0;0;100;0
3556;Jardim Botânico;Serraria;50;0;32;12;0;50
3557;Jardim Botânico;São Caetano;50;0;31;13;0;50
3558;Jardim Botânico;São Geraldo;150;0;53;26;50;100
3559;Jardim Botânico;São José;650;0;389;113;0;650
3560;Jardim Botânico;São João;200;0;122;42;0;200
3561;Jardim Botânico;São Sebastião;200;0;88;28;50;150
3562;Jardim Botânico;Sétimo Céu;0;0;0;0;0;0
3563;Jardim Botânico;Teresópolis;250;50;27;13;200;50
3564;Jardim Botânico;Tristeza;100;0;30;16;50;50
3565;Jardim Botânico;Três Figueiras;300;100;88;34;150;150
3566;Jardim Botânico;Vila Assunção;50;0;30;12;0;50
3567;Jardim Botânico;Vila Conceição;200;50;109;32;100;100
3568;Jardim Botânico;Vila Ipiranga;50;0;28;10;0;50
3569;Jardim Botânico;Vila Jardim;250;0;143;61;0;250
3570;Jardim Botânico;Vila João Pessoa;1300;350;407;151;600;700
3571;Jardim Botânico;Vila Nova;300;100;64;21;200;100
3572;Jardim Carvalho;Aberta dos Morros;100;0;59;21;0;100
3573;Jardim Carvalho;Agronomia;3000;1550;321;59;2650;350
3574;Jardim Carvalho;Anchieta;100;100;0;0;100;0
3575;Jardim Carvalho;Arquipélago;50;0;30;16;0;50
3576;Jardim Carvalho;Auxiliadora;100;50;35;11;50;50
3577;Jardim Carvalho;Azenha;150;100;30;12;100;50
3578;Jardim Carvalho;Bela Vista;200;0;128;38;0;200
3579;Jardim Carvalho;Belém Novo;200;0;75;38;50;150
3580;Jardim Carvalho;Belém Velho;150;50;38;6;100;50
3581;Jardim Carvalho;Boa Vista;50;0;23;14;0;50
3582;Jardim Carvalho;Boa Vista do Sul;50;0;28;6;0;50
3583;Jardim Carvalho;Bom Fim;250;0;83;41;100;150
3584;Jardim Carvalho;Bom Jesus;1600;400;520;138;850;750
3585;Jardim Carvalho;Camaquã;0;0;0;0;0;0
3586;Jardim Carvalho;Campo Novo;0;0;0;0;0;0
3587;Jardim Carvalho;Cascata;750;200;365;96;200;550
3588;Jardim Carvalho;Cavalhada;250;0;166;52;0;250
3589;Jardim Carvalho;Cel. Aparício Borges;377;0;135;37;127;250
3590;Jardim Carvalho;Centro Histórico;100;0;19;9;50;50
3591;Jardim Carvalho;Chapéu do Sol;250;100;86;33;100;150
3592;Jardim Carvalho;Chácara das Pedras;250;0;156;41;0;250
3593;Jardim Carvalho;Cidade Baixa;100;0;71;11;0;100
3594;Jardim Carvalho;Costa e Silva;150;0;68;12;50;100
3595;Jardim Carvalho;Cristal;100;0;25;11;50;50
3596;Jardim Carvalho;Cristo Redentor;250;0;166;50;0;250
3597;Jardim Carvalho;Espírito Santo;150;0;82;28;0;150
3598;Jardim Carvalho;Extrema;100;0;67;20;0;100
3599;Jardim Carvalho;Farrapos;50;0;20;10;0;50
3600;Jardim Carvalho;Farroupilha;100;50;25;11;50;50
3601;Jardim Carvalho;Floresta;300;50;85;29;150;150
3602;Jardim Carvalho;Glória;250;0;117;38;50;200
3603;Jardim Carvalho;Guarujá;200;0;82;25;50;150
3604;Jardim Carvalho;Higienópolis;0;0;0;0;0;0
3605;Jardim Carvalho;Humaitá;50;0;32;13;0;50
3606;Jardim Carvalho;Hípica;50;50;0;0;50;0
3607;Jardim Carvalho;Independência;100;0;28;13;50;50
3608;Jardim Carvalho;Ipanema;0;0;0;0;0;0
3609;Jardim Carvalho;Jardim Botânico;300;50;120;35;100;200
3610;Jardim Carvalho;Jardim Carvalho;20900;3000;9420;2960;5400;15500
3611;Jardim Carvalho;Jardim Europa;350;200;68;27;250;100
3612;Jardim Carvalho;Jardim Floresta;100;0;45;25;0;100
3613;Jardim Carvalho;Jardim Isabel;100;0;64;21;0;100
3614;Jardim Carvalho;Jardim Itú;150;50;64;20;50;100
3615;Jardim Carvalho;Jardim Leopoldina;300;50;94;20;150;150
3616;Jardim Carvalho;Jardim Lindóia;200;0;89;36;50;150
3617;Jardim Carvalho;Jardim Sabará;450;100;166;54;200;250
3618;Jardim Carvalho;Jardim São Pedro;50;0;22;9;0;50
3619;Jardim Carvalho;Jardim do Salso;1150;200;447;114;450;700
3620;Jardim Carvalho;Lageado;200;50;92;18;50;150
3621;Jardim Carvalho;Lami;100;0;62;20;0;100
3622;Jardim Carvalho;Lomba do Pinheiro;1400;150;649;148;350;1050
3623;Jardim Carvalho;Medianeira;100;50;42;2;50;50
3624;Jardim Carvalho;Menino Deus;250;100;53;26;150;100
3625;Jardim Carvalho;Moinhos de Vento;100;0;59;31;0;100
3626;Jardim Carvalho;Mont'Serrat;200;150;33;4;150;50
3627;Jardim Carvalho;Morro Santana;800;250;315;88;350;450
3628;Jardim Carvalho;Mário Quintana;150;100;28;6;100;50
3629;Jardim Carvalho;Navegantes;150;50;22;17;100;50
3630;Jardim Carvalho;Nonoai;150;0;81;38;0;150
3631;Jardim Carvalho;Parque Santa Fé;100;50;31;12;50;50
3632;Jardim Carvalho;Partenon;1950;1000;95;36;1800;150
3633;Jardim Carvalho;Passo D'Areia;100;0;58;21;0;100
3634;Jardim Carvalho;Passo das Pedras;250;100;58;26;150;100
3635;Jardim Carvalho;Pedra Redonda;0;0;0;0;0;0
3636;Jardim Carvalho;Petrópolis;600;100;254;87;200;400
3637;Jardim Carvalho;Pitinga;150;50;30;5;100;50
3638;Jardim Carvalho;Ponta Grossa;300;50;158;33;50;250
3639;Jardim Carvalho;Praia de Belas;150;0;62;22;50;100
3640;Jardim Carvalho;Restinga;250;0;107;41;50;200
3641;Jardim Carvalho;Rio Branco;150;0;105;24;50;100
3642;Jardim Carvalho;Rubem Berta;300;0;121;84;50;250
3643;Jardim Carvalho;Santa Cecília;300;50;139;53;50;250
3644;Jardim Carvalho;Santa Maria Goretti;100;0;0;0;100;0
3645;Jardim Carvalho;Santa Rosa de Lima;150;0;84;30;0;150
3646;Jardim Carvalho;Santa Tereza;150;50;26;7;100;50
3647;Jardim Carvalho;Santana;100;0;35;7;50;50
3648;Jardim Carvalho;Santo Antônio;150;50;65;26;50;100
3649;Jardim Carvalho;Sarandi;250;50;95;36;100;150
3650;Jardim Carvalho;Serraria;50;0;35;9;0;50
3651;Jardim Carvalho;São Caetano;150;0;76;18;50;100
3652;Jardim Carvalho;São Geraldo;50;0;32;6;0;50
3653;Jardim Carvalho;São José;1043;200;329;86;593;450
3654;Jardim Carvalho;São João;100;0;49;27;0;100
3655;Jardim Carvalho;São Sebastião;100;50;31;5;50;50
3656;Jardim Carvalho;Sétimo Céu;50;0;36;11;0;50
3657;Jardim Carvalho;Teresópolis;250;0;83;26;100;150
3658;Jardim Carvalho;Tristeza;100;0;56;28;0;100
3659;Jardim Carvalho;Três Figueiras;0;0;0;0;0;0
3660;Jardim Carvalho;Vila Assunção;100;0;27;15;50;50
3661;Jardim Carvalho;Vila Conceição;150;0;93;25;0;150
3662;Jardim Carvalho;Vila Ipiranga;250;50;75;35;100;150
3663;Jardim Carvalho;Vila Jardim;500;100;175;74;200;300
3664;Jardim Carvalho;Vila João Pessoa;1150;0;618;215;100;1050
3665;Jardim Carvalho;Vila Nova;150;50;26;11;100;50
3666;Jardim Europa;Aberta dos Morros;50;0;0;0;50;0
3667;Jardim Europa;Agronomia;50;0;33;9;0;50
3668;Jardim Europa;Anchieta;50;0;0;0;50;0
3669;Jardim Europa;Arquipélago;50;0;24;14;0;50
3670;Jardim Europa;Auxiliadora;250;50;76;36;100;150
3671;Jardim Europa;Azenha;50;50;0;0;50;0
3672;Jardim Europa;Bela Vista;50;0;31;12;0;50
3673;Jardim Europa;Belém Novo;0;0;0;0;0;0
3674;Jardim Europa;Belém Velho;0;0;0;0;0;0
3675;Jardim Europa;Boa Vista;250;50;85;26;100;150
3676;Jardim Europa;Boa Vista do Sul;0;0;0;0;0;0
3677;Jardim Europa;Bom Fim;100;0;31;12;50;50
3678;Jardim Europa;Bom Jesus;619;150;160;62;319;300
3679;Jardim Europa;Camaquã;150;0;65;15;50;100
3680;Jardim Europa;Campo Novo;0;0;0;0;0;0
3681;Jardim Europa;Cascata;0;0;0;0;0;0
3682;Jardim Europa;Cavalhada;50;50;0;0;50;0
3683;Jardim Europa;Cel. Aparício Borges;150;50;66;16;50;100
3684;Jardim Europa;Centro Histórico;200;0;94;49;0;200
3685;Jardim Europa;Chapéu do Sol;0;0;0;0;0;0
3686;Jardim Europa;Chácara das Pedras;400;250;84;15;350;50
3687;Jardim Europa;Cidade Baixa;100;0;51;27;0;100
3688;Jardim Europa;Costa e Silva;50;0;32;5;0;50
3689;Jardim Europa;Cristal;150;100;28;10;100;50
3690;Jardim Europa;Cristo Redentor;550;150;206;83;200;350
3691;Jardim Europa;Espírito Santo;0;0;0;0;0;0
3692;Jardim Europa;Extrema;0;0;0;0;0;0
3693;Jardim Europa;Farrapos;100;0;70;15;0;100
3694;Jardim Europa;Farroupilha;0;0;0;0;0;0
3695;Jardim Europa;Floresta;100;0;32;16;50;50
3696;Jardim Europa;Glória;0;0;0;0;0;0
3697;Jardim Europa;Guarujá;0;0;0;0;0;0
3698;Jardim Europa;Higienópolis;100;0;65;19;0;100
3699;Jardim Europa;Humaitá;150;0;112;19;0;150
3700;Jardim Europa;Hípica;50;0;29;8;0;50
3701;Jardim Europa;Independência;100;50;24;10;50;50
3702;Jardim Europa;Ipanema;50;0;33;9;0;50
3703;Jardim Europa;Jardim Botânico;100;0;65;17;0;100
3704;Jardim Europa;Jardim Carvalho;350;200;68;27;250;100
3705;Jardim Europa;Jardim Europa;1692;0;1016;298;192;1500
3706;Jardim Europa;Jardim Floresta;50;0;23;9;0;50
3707;Jardim Europa;Jardim Isabel;0;0;0;0;0;0
3708;Jardim Europa;Jardim Itú;500;50;281;89;50;450
3709;Jardim Europa;Jardim Leopoldina;150;50;70;21;50;100
3710;Jardim Europa;Jardim Lindóia;300;50;142;58;50;250
3711;Jardim Europa;Jardim Sabará;250;0;157;62;0;250
3712;Jardim Europa;Jardim São Pedro;150;50;23;18;100;50
3713;Jardim Europa;Jardim do Salso;50;0;28;18;0;50
3714;Jardim Europa;Lageado;0;0;0;0;0;0
3715;Jardim Europa;Lami;0;0;0;0;0;0
3716;Jardim Europa;Lomba do Pinheiro;100;0;28;5;50;50
3717;Jardim Europa;Medianeira;0;0;0;0;0;0
3718;Jardim Europa;Menino Deus;150;0;55;31;50;100
3719;Jardim Europa;Moinhos de Vento;50;0;29;18;0;50
3720;Jardim Europa;Mont'Serrat;50;0;34;12;0;50
3721;Jardim Europa;Morro Santana;200;0;112;36;0;200
3722;Jardim Europa;Mário Quintana;300;0;156;32;50;250
3723;Jardim Europa;Navegantes;0;0;0;0;0;0
3724;Jardim Europa;Nonoai;50;50;0;0;50;0
3725;Jardim Europa;Parque Santa Fé;0;0;0;0;0;0
3726;Jardim Europa;Partenon;50;0;0;0;50;0
3727;Jardim Europa;Passo D'Areia;700;150;243;146;300;400
3728;Jardim Europa;Passo das Pedras;50;0;0;0;50;0
3729;Jardim Europa;Pedra Redonda;0;0;0;0;0;0
3730;Jardim Europa;Petrópolis;500;0;181;103;200;300
3731;Jardim Europa;Pitinga;0;0;0;0;0;0
3732;Jardim Europa;Ponta Grossa;0;0;0;0;0;0
3733;Jardim Europa;Praia de Belas;0;0;0;0;0;0
3734;Jardim Europa;Restinga;100;0;29;6;50;50
3735;Jardim Europa;Rio Branco;250;50;85;46;100;150
3736;Jardim Europa;Rubem Berta;100;50;23;21;50;50
3737;Jardim Europa;Santa Cecília;100;0;0;0;100;0
3738;Jardim Europa;Santa Maria Goretti;100;0;73;14;0;100
3739;Jardim Europa;Santa Rosa de Lima;100;0;58;17;0;100
3740;Jardim Europa;Santa Tereza;200;0;119;30;0;200
3741;Jardim Europa;Santana;100;0;51;31;0;100
3742;Jardim Europa;Santo Antônio;0;0;0;0;0;0
3743;Jardim Europa;Sarandi;950;0;429;218;150;800
3744;Jardim Europa;Serraria;50;0;0;0;50;0
3745;Jardim Europa;São Caetano;0;0;0;0;0;0
3746;Jardim Europa;São Geraldo;100;50;22;14;50;50
3747;Jardim Europa;São José;200;0;90;21;50;150
3748;Jardim Europa;São João;150;0;56;27;50;100
3749;Jardim Europa;São Sebastião;50;50;0;0;50;0
3750;Jardim Europa;Sétimo Céu;50;0;29;9;0;50
3751;Jardim Europa;Teresópolis;0;0;0;0;0;0
3752;Jardim Europa;Tristeza;50;0;36;11;0;50
3753;Jardim Europa;Três Figueiras;300;150;70;22;200;100
3754;Jardim Europa;Vila Assunção;50;0;26;12;0;50
3755;Jardim Europa;Vila Conceição;50;0;28;17;0;50
3756;Jardim Europa;Vila Ipiranga;2800;300;1414;601;350;2450
3757;Jardim Europa;Vila Jardim;400;0;214;112;0;400
3758;Jardim Europa;Vila João Pessoa;200;0;122;48;0;200
3759;Jardim Europa;Vila Nova;50;50;0;0;50;0
3760;Jardim Floresta;Aberta dos Morros;0;0;0;0;0;0
3761;Jardim Floresta;Agronomia;0;0;0;0;0;0
3762;Jardim Floresta;Anchieta;50;0;26;5;0;50
3763;Jardim Floresta;Arquipélago;0;0;0;0;0;0
3764;Jardim Floresta;Auxiliadora;150;50;57;23;50;100
3765;Jardim Floresta;Azenha;50;0;30;12;0;50
3766;Jardim Floresta;Bela Vista;50;0;32;14;0;50
3767;Jardim Floresta;Belém Novo;0;0;0;0;0;0
3768;Jardim Floresta;Belém Velho;0;0;0;0;0;0
3769;Jardim Floresta;Boa Vista;200;0;139;38;50;150
3770;Jardim Floresta;Boa Vista do Sul;0;0;0;0;0;0
3771;Jardim Floresta;Bom Fim;100;0;50;22;0;100
3772;Jardim Floresta;Bom Jesus;100;0;60;14;0;100
3773;Jardim Floresta;Camaquã;0;0;0;0;0;0
3774;Jardim Floresta;Campo Novo;50;50;0;0;50;0
3775;Jardim Floresta;Cascata;0;0;0;0;0;0
3776;Jardim Floresta;Cavalhada;0;0;0;0;0;0
3777;Jardim Floresta;Cel. Aparício Borges;50;0;38;4;0;50
3778;Jardim Floresta;Centro Histórico;100;50;0;0;100;0
3779;Jardim Floresta;Chapéu do Sol;0;0;0;0;0;0
3780;Jardim Floresta;Chácara das Pedras;0;0;0;0;0;0
3781;Jardim Floresta;Cidade Baixa;0;0;0;0;0;0
3782;Jardim Floresta;Costa e Silva;100;50;29;5;50;50
3783;Jardim Floresta;Cristal;0;0;0;0;0;0
3784;Jardim Floresta;Cristo Redentor;2350;200;1098;467;450;1900
3785;Jardim Floresta;Espírito Santo;0;0;0;0;0;0
3786;Jardim Floresta;Extrema;50;0;0;0;50;0
3787;Jardim Floresta;Farrapos;150;0;93;18;0;150
3788;Jardim Floresta;Farroupilha;0;0;0;0;0;0
3789;Jardim Floresta;Floresta;100;50;27;13;50;50
3790;Jardim Floresta;Glória;50;0;22;10;0;50
3791;Jardim Floresta;Guarujá;0;0;0;0;0;0
3792;Jardim Floresta;Higienópolis;200;50;88;39;50;150
3793;Jardim Floresta;Humaitá;250;50;99;27;100;150
3794;Jardim Floresta;Hípica;50;50;0;0;50;0
3795;Jardim Floresta;Independência;100;0;27;11;50;50
3796;Jardim Floresta;Ipanema;0;0;0;0;0;0
3797;Jardim Floresta;Jardim Botânico;0;0;0;0;0;0
3798;Jardim Floresta;Jardim Carvalho;100;0;45;25;0;100
3799;Jardim Floresta;Jardim Europa;50;0;23;9;0;50
3800;Jardim Floresta;Jardim Floresta;1000;0;390;172;300;700
3801;Jardim Floresta;Jardim Isabel;0;0;0;0;0;0
3802;Jardim Floresta;Jardim Itú;150;0;74;19;50;100
3803;Jardim Floresta;Jardim Leopoldina;0;0;0;0;0;0
3804;Jardim Floresta;Jardim Lindóia;1700;450;559;248;800;900
3805;Jardim Floresta;Jardim Sabará;100;50;0;0;100;0
3806;Jardim Floresta;Jardim São Pedro;500;200;112;43;300;200
3807;Jardim Floresta;Jardim do Salso;50;50;0;0;50;0
3808;Jardim Floresta;Lageado;50;0;25;18;0;50
3809;Jardim Floresta;Lami;0;0;0;0;0;0
3810;Jardim Floresta;Lomba do Pinheiro;100;0;60;15;0;100
3811;Jardim Floresta;Medianeira;0;0;0;0;0;0
3812;Jardim Floresta;Menino Deus;100;50;0;0;100;0
3813;Jardim Floresta;Moinhos de Vento;100;100;0;0;100;0
3814;Jardim Floresta;Mont'Serrat;250;50;97;38;100;150
3815;Jardim Floresta;Morro Santana;100;50;0;0;100;0
3816;Jardim Floresta;Mário Quintana;250;50;94;14;100;150
3817;Jardim Floresta;Navegantes;50;50;0;0;50;0
3818;Jardim Floresta;Nonoai;50;0;31;9;0;50
3819;Jardim Floresta;Parque Santa Fé;0;0;0;0;0;0
3820;Jardim Floresta;Partenon;100;0;52;25;0;100
3821;Jardim Floresta;Passo D'Areia;400;50;70;75;200;200
3822;Jardim Floresta;Passo das Pedras;150;0;52;19;50;100
3823;Jardim Floresta;Pedra Redonda;0;0;0;0;0;0
3824;Jardim Floresta;Petrópolis;400;100;119;81;150;250
3825;Jardim Floresta;Pitinga;0;0;0;0;0;0
3826;Jardim Floresta;Ponta Grossa;0;0;0;0;0;0
3827;Jardim Floresta;Praia de Belas;50;0;29;9;0;50
3828;Jardim Floresta;Restinga;250;0;106;31;50;200
3829;Jardim Floresta;Rio Branco;150;0;75;40;0;150
3830;Jardim Floresta;Rubem Berta;100;50;29;18;50;50
3831;Jardim Floresta;Santa Cecília;100;0;51;35;0;100
3832;Jardim Floresta;Santa Maria Goretti;100;50;27;12;50;50
3833;Jardim Floresta;Santa Rosa de Lima;200;0;97;22;50;150
3834;Jardim Floresta;Santa Tereza;100;50;24;8;50;50
3835;Jardim Floresta;Santana;50;0;28;19;0;50
3836;Jardim Floresta;Santo Antônio;50;0;0;0;50;0
3837;Jardim Floresta;Sarandi;800;100;354;153;250;550
3838;Jardim Floresta;Serraria;0;0;0;0;0;0
3839;Jardim Floresta;São Caetano;0;0;0;0;0;0
3840;Jardim Floresta;São Geraldo;50;0;22;15;0;50
3841;Jardim Floresta;São José;50;50;0;0;50;0
3842;Jardim Floresta;São João;50;0;0;0;50;0
3843;Jardim Floresta;São Sebastião;700;150;295;102;250;450
3844;Jardim Floresta;Sétimo Céu;0;0;0;0;0;0
3845;Jardim Floresta;Teresópolis;50;0;32;7;0;50
3846;Jardim Floresta;Tristeza;50;0;32;14;0;50
3847;Jardim Floresta;Três Figueiras;0;0;0;0;0;0
3848;Jardim Floresta;Vila Assunção;0;0;0;0;0;0
3849;Jardim Floresta;Vila Conceição;0;0;0;0;0;0
3850;Jardim Floresta;Vila Ipiranga;350;50;117;53;150;200
3851;Jardim Floresta;Vila Jardim;200;50;77;48;50;150
3852;Jardim Floresta;Vila João Pessoa;0;0;0;0;0;0
3853;Jardim Floresta;Vila Nova;50;0;32;6;0;50
3854;Jardim Isabel;Aberta dos Morros;400;0;224;59;50;350
3855;Jardim Isabel;Agronomia;0;0;0;0;0;0
3856;Jardim Isabel;Anchieta;0;0;0;0;0;0
3857;Jardim Isabel;Arquipélago;0;0;0;0;0;0
3858;Jardim Isabel;Auxiliadora;50;50;0;0;50;0
3859;Jardim Isabel;Azenha;0;0;0;0;0;0
3860;Jardim Isabel;Bela Vista;0;0;0;0;0;0
3861;Jardim Isabel;Belém Novo;0;0;0;0;0;0
3862;Jardim Isabel;Belém Velho;50;50;0;0;50;0
3863;Jardim Isabel;Boa Vista;0;0;0;0;0;0
3864;Jardim Isabel;Boa Vista do Sul;0;0;0;0;0;0
3865;Jardim Isabel;Bom Fim;0;0;0;0;0;0
3866;Jardim Isabel;Bom Jesus;150;100;22;8;100;50
3867;Jardim Isabel;Camaquã;1700;100;857;344;150;1550
3868;Jardim Isabel;Campo Novo;150;50;64;20;50;100
3869;Jardim Isabel;Cascata;0;0;0;0;0;0
3870;Jardim Isabel;Cavalhada;5050;450;2561;871;800;4250
3871;Jardim Isabel;Cel. Aparício Borges;50;50;0;0;50;0
3872;Jardim Isabel;Centro Histórico;0;0;0;0;0;0
3873;Jardim Isabel;Chapéu do Sol;50;0;30;4;0;50
3874;Jardim Isabel;Chácara das Pedras;0;0;0;0;0;0
3875;Jardim Isabel;Cidade Baixa;0;0;0;0;0;0
3876;Jardim Isabel;Costa e Silva;50;0;31;8;0;50
3877;Jardim Isabel;Cristal;350;50;141;49;100;250
3878;Jardim Isabel;Cristo Redentor;50;0;26;8;0;50
3879;Jardim Isabel;Espírito Santo;200;50;35;6;150;50
3880;Jardim Isabel;Extrema;0;0;0;0;0;0
3881;Jardim Isabel;Farrapos;50;50;0;0;50;0
3882;Jardim Isabel;Farroupilha;0;0;0;0;0;0
3883;Jardim Isabel;Floresta;0;0;0;0;0;0
3884;Jardim Isabel;Glória;200;100;60;21;100;100
3885;Jardim Isabel;Guarujá;0;0;0;0;0;0
3886;Jardim Isabel;Higienópolis;0;0;0;0;0;0
3887;Jardim Isabel;Humaitá;100;0;71;16;0;100
3888;Jardim Isabel;Hípica;200;0;68;17;100;100
3889;Jardim Isabel;Independência;0;0;0;0;0;0
3890;Jardim Isabel;Ipanema;2050;550;627;237;1050;1000
3891;Jardim Isabel;Jardim Botânico;0;0;0;0;0;0
3892;Jardim Isabel;Jardim Carvalho;100;0;64;21;0;100
3893;Jardim Isabel;Jardim Europa;0;0;0;0;0;0
3894;Jardim Isabel;Jardim Floresta;0;0;0;0;0;0
3895;Jardim Isabel;Jardim Isabel;1000;300;270;128;500;500
3896;Jardim Isabel;Jardim Itú;50;0;31;9;0;50
3897;Jardim Isabel;Jardim Leopoldina;50;0;35;10;0;50
3898;Jardim Isabel;Jardim Lindóia;0;0;0;0;0;0
3899;Jardim Isabel;Jardim Sabará;50;0;26;7;0;50
3900;Jardim Isabel;Jardim São Pedro;100;0;67;20;0;100
3901;Jardim Isabel;Jardim do Salso;0;0;0;0;0;0
3902;Jardim Isabel;Lageado;0;0;0;0;0;0
3903;Jardim Isabel;Lami;50;0;31;13;0;50
3904;Jardim Isabel;Lomba do Pinheiro;200;0;118;29;0;200
3905;Jardim Isabel;Medianeira;0;0;0;0;0;0
3906;Jardim Isabel;Menino Deus;150;0;60;22;50;100
3907;Jardim Isabel;Moinhos de Vento;0;0;0;0;0;0
3908;Jardim Isabel;Mont'Serrat;0;0;0;0;0;0
3909;Jardim Isabel;Morro Santana;150;0;91;25;0;150
3910;Jardim Isabel;Mário Quintana;50;0;33;4;0;50
3911;Jardim Isabel;Navegantes;0;0;0;0;0;0
3912;Jardim Isabel;Nonoai;250;0;83;39;100;150
3913;Jardim Isabel;Parque Santa Fé;0;0;0;0;0;0
3914;Jardim Isabel;Partenon;100;0;54;21;0;100
3915;Jardim Isabel;Passo D'Areia;0;0;0;0;0;0
3916;Jardim Isabel;Passo das Pedras;0;0;0;0;0;0
3917;Jardim Isabel;Pedra Redonda;500;50;224;87;150;350
3918;Jardim Isabel;Petrópolis;200;50;85;44;50;150
3919;Jardim Isabel;Pitinga;0;0;0;0;0;0
3920;Jardim Isabel;Ponta Grossa;0;0;0;0;0;0
3921;Jardim Isabel;Praia de Belas;50;0;29;11;0;50
3922;Jardim Isabel;Restinga;50;50;0;0;50;0
3923;Jardim Isabel;Rio Branco;0;0;0;0;0;0
3924;Jardim Isabel;Rubem Berta;0;0;0;0;0;0
3925;Jardim Isabel;Santa Cecília;0;0;0;0;0;0
3926;Jardim Isabel;Santa Maria Goretti;0;0;0;0;0;0
3927;Jardim Isabel;Santa Rosa de Lima;150;100;30;11;100;50
3928;Jardim Isabel;Santa Tereza;200;50;89;27;50;150
3929;Jardim Isabel;Santana;0;0;0;0;0;0
3930;Jardim Isabel;Santo Antônio;100;0;68;13;0;100
3931;Jardim Isabel;Sarandi;100;0;66;23;0;100
3932;Jardim Isabel;Serraria;50;0;24;5;0;50
3933;Jardim Isabel;São Caetano;0;0;0;0;0;0
3934;Jardim Isabel;São Geraldo;0;0;0;0;0;0
3935;Jardim Isabel;São José;0;0;0;0;0;0
3936;Jardim Isabel;São João;0;0;0;0;0;0
3937;Jardim Isabel;São Sebastião;50;0;32;6;0;50
3938;Jardim Isabel;Sétimo Céu;496;0;259;64;96;400
3939;Jardim Isabel;Teresópolis;0;0;0;0;0;0
3940;Jardim Isabel;Tristeza;1000;0;531;258;100;900
3941;Jardim Isabel;Três Figueiras;50;0;35;7;0;50
3942;Jardim Isabel;Vila Assunção;0;0;0;0;0;0
3943;Jardim Isabel;Vila Conceição;400;200;150;31;250;150
3944;Jardim Isabel;Vila Ipiranga;50;0;26;11;0;50
3945;Jardim Isabel;Vila Jardim;50;0;26;12;0;50
3946;Jardim Isabel;Vila João Pessoa;50;0;31;11;0;50
3947;Jardim Isabel;Vila Nova;300;0;143;51;50;250
3948;Jardim Itú;Aberta dos Morros;0;0;0;0;0;0
3949;Jardim Itú;Agronomia;250;50;139;39;50;200
3950;Jardim Itú;Anchieta;50;50;0;0;50;0
3951;Jardim Itú;Arquipélago;100;0;31;9;50;50
3952;Jardim Itú;Auxiliadora;200;0;92;37;50;150
3953;Jardim Itú;Azenha;50;0;27;11;0;50
3954;Jardim Itú;Bela Vista;0;0;0;0;0;0
3955;Jardim Itú;Belém Novo;0;0;0;0;0;0
3956;Jardim Itú;Belém Velho;0;0;0;0;0;0
3957;Jardim Itú;Boa Vista;201;50;68;20;101;100
3958;Jardim Itú;Boa Vista do Sul;50;0;23;10;0;50
3959;Jardim Itú;Bom Fim;100;0;61;26;0;100
3960;Jardim Itú;Bom Jesus;350;0;156;59;50;300
3961;Jardim Itú;Camaquã;0;0;0;0;0;0
3962;Jardim Itú;Campo Novo;100;0;33;11;50;50
3963;Jardim Itú;Cascata;0;0;0;0;0;0
3964;Jardim Itú;Cavalhada;100;0;59;15;0;100
3965;Jardim Itú;Cel. Aparício Borges;150;0;25;10;100;50
3966;Jardim Itú;Centro Histórico;100;0;63;22;0;100
3967;Jardim Itú;Chapéu do Sol;0;0;0;0;0;0
3968;Jardim Itú;Chácara das Pedras;300;50;117;50;100;200
3969;Jardim Itú;Cidade Baixa;350;100;179;35;150;200
3970;Jardim Itú;Costa e Silva;950;100;306;90;450;500
3971;Jardim Itú;Cristal;250;50;125;31;100;150
3972;Jardim Itú;Cristo Redentor;350;50;157;68;50;300
3973;Jardim Itú;Espírito Santo;100;100;0;0;100;0
3974;Jardim Itú;Extrema;150;0;53;25;50;100
3975;Jardim Itú;Farrapos;200;0;85;25;50;150
3976;Jardim Itú;Farroupilha;250;0;163;39;0;250
3977;Jardim Itú;Floresta;100;0;82;15;50;50
3978;Jardim Itú;Glória;50;0;31;7;0;50
3979;Jardim Itú;Guarujá;100;50;24;13;50;50
3980;Jardim Itú;Higienópolis;150;0;111;23;50;100
3981;Jardim Itú;Humaitá;100;0;26;9;50;50
3982;Jardim Itú;Hípica;50;0;29;8;0;50
3983;Jardim Itú;Independência;50;0;0;0;50;0
3984;Jardim Itú;Ipanema;0;0;0;0;0;0
3985;Jardim Itú;Jardim Botânico;200;50;66;23;100;100
3986;Jardim Itú;Jardim Carvalho;150;50;64;20;50;100
3987;Jardim Itú;Jardim Europa;500;50;281;89;50;450
3988;Jardim Itú;Jardim Floresta;150;0;74;19;50;100
3989;Jardim Itú;Jardim Isabel;50;0;31;9;0;50
3990;Jardim Itú;Jardim Itú;11000;3700;2668;834;7100;3900
3991;Jardim Itú;Jardim Leopoldina;600;300;149;48;350;250
3992;Jardim Itú;Jardim Lindóia;350;50;144;58;100;250
3993;Jardim Itú;Jardim Sabará;1700;350;584;251;700;1000
3994;Jardim Itú;Jardim São Pedro;150;50;30;12;100;50
3995;Jardim Itú;Jardim do Salso;150;100;0;0;150;0
3996;Jardim Itú;Lageado;0;0;0;0;0;0
3997;Jardim Itú;Lami;50;0;30;15;0;50
3998;Jardim Itú;Lomba do Pinheiro;200;50;93;19;50;150
3999;Jardim Itú;Medianeira;100;0;34;12;50;50
4000;Jardim Itú;Menino Deus;150;0;63;24;50;100
4001;Jardim Itú;Moinhos de Vento;150;50;58;28;50;100
4002;Jardim Itú;Mont'Serrat;50;0;0;0;50;0
4003;Jardim Itú;Morro Santana;550;50;231;75;200;350
4004;Jardim Itú;Mário Quintana;500;50;189;53;200;300
4005;Jardim Itú;Navegantes;0;0;0;0;0;0
4006;Jardim Itú;Nonoai;200;100;66;20;100;100
4007;Jardim Itú;Parque Santa Fé;350;100;148;56;100;250
4008;Jardim Itú;Partenon;500;100;163;70;200;300
4009;Jardim Itú;Passo D'Areia;400;100;184;63;100;300
4010;Jardim Itú;Passo das Pedras;4250;700;1734;600;1400;2850
4011;Jardim Itú;Pedra Redonda;0;0;0;0;0;0
4012;Jardim Itú;Petrópolis;400;0;171;84;100;300
4013;Jardim Itú;Pitinga;150;0;95;24;0;150
4014;Jardim Itú;Ponta Grossa;100;0;65;17;0;100
4015;Jardim Itú;Praia de Belas;150;0;94;31;0;150
4016;Jardim Itú;Restinga;200;50;59;20;100;100
4017;Jardim Itú;Rio Branco;200;50;28;22;150;50
4018;Jardim Itú;Rubem Berta;850;350;185;145;450;400
4019;Jardim Itú;Santa Cecília;50;0;29;15;0;50
4020;Jardim Itú;Santa Maria Goretti;400;0;237;84;0;400
4021;Jardim Itú;Santa Rosa de Lima;500;100;232;73;100;400
4022;Jardim Itú;Santa Tereza;400;50;207;42;150;250
4023;Jardim Itú;Santana;100;0;69;25;0;100
4024;Jardim Itú;Santo Antônio;100;0;56;31;0;100
4025;Jardim Itú;Sarandi;450;0;175;83;150;300
4026;Jardim Itú;Serraria;0;0;0;0;0;0
4027;Jardim Itú;São Caetano;100;0;55;27;0;100
4028;Jardim Itú;São Geraldo;0;0;0;0;0;0
4029;Jardim Itú;São José;150;100;27;9;100;50
4030;Jardim Itú;São João;150;50;53;24;50;100
4031;Jardim Itú;São Sebastião;550;50;187;64;250;300
4032;Jardim Itú;Sétimo Céu;50;0;0;0;50;0
4033;Jardim Itú;Teresópolis;100;0;33;8;50;50
4034;Jardim Itú;Tristeza;100;0;59;32;0;100
4035;Jardim Itú;Três Figueiras;200;50;87;38;50;150
4036;Jardim Itú;Vila Assunção;50;50;0;0;50;0
4037;Jardim Itú;Vila Conceição;50;50;0;0;50;0
4038;Jardim Itú;Vila Ipiranga;850;200;309;113;300;550
4039;Jardim Itú;Vila Jardim;1400;50;756;307;100;1300
4040;Jardim Itú;Vila João Pessoa;350;0;207;87;0;350
4041;Jardim Itú;Vila Nova;100;0;33;12;50;50
4042;Jardim Leopoldina;Aberta dos Morros;50;0;36;6;0;50
4043;Jardim Leopoldina;Agronomia;250;0;110;38;50;200
4044;Jardim Leopoldina;Anchieta;0;0;0;0;0;0
4045;Jardim Leopoldina;Arquipélago;50;0;0;0;50;0
4046;Jardim Leopoldina;Auxiliadora;50;0;41;5;0;50
4047;Jardim Leopoldina;Azenha;50;0;27;13;0;50
4048;Jardim Leopoldina;Bela Vista;0;0;0;0;0;0
4049;Jardim Leopoldina;Belém Novo;100;0;59;14;0;100
4050;Jardim Leopoldina;Belém Velho;200;0;121;30;0;200
4051;Jardim Leopoldina;Boa Vista;250;50;84;10;200;50
4052;Jardim Leopoldina;Boa Vista do Sul;150;100;0;0;150;0
4053;Jardim Leopoldina;Bom Fim;100;50;0;0;100;0
4054;Jardim Leopoldina;Bom Jesus;250;50;83;30;100;150
4055;Jardim Leopoldina;Camaquã;50;0;34;8;0;50
4056;Jardim Leopoldina;Campo Novo;50;0;0;0;50;0
4057;Jardim Leopoldina;Cascata;0;0;0;0;0;0
4058;Jardim Leopoldina;Cavalhada;50;50;0;0;50;0
4059;Jardim Leopoldina;Cel. Aparício Borges;50;0;30;8;0;50
4060;Jardim Leopoldina;Centro Histórico;0;0;0;0;0;0
4061;Jardim Leopoldina;Chapéu do Sol;100;50;0;0;100;0
4062;Jardim Leopoldina;Chácara das Pedras;350;0;218;74;0;350
4063;Jardim Leopoldina;Cidade Baixa;0;0;0;0;0;0
4064;Jardim Leopoldina;Costa e Silva;4350;200;2296;662;650;3700
4065;Jardim Leopoldina;Cristal;150;50;55;27;50;100
4066;Jardim Leopoldina;Cristo Redentor;100;0;70;14;0;100
4067;Jardim Leopoldina;Espírito Santo;0;0;0;0;0;0
4068;Jardim Leopoldina;Extrema;100;50;24;11;50;50
4069;Jardim Leopoldina;Farrapos;50;50;0;0;50;0
4070;Jardim Leopoldina;Farroupilha;50;0;23;11;0;50
4071;Jardim Leopoldina;Floresta;50;0;50;0;50;0
4072;Jardim Leopoldina;Glória;150;50;68;19;50;100
4073;Jardim Leopoldina;Guarujá;100;0;31;7;50;50
4074;Jardim Leopoldina;Higienópolis;350;0;165;48;100;250
4075;Jardim Leopoldina;Humaitá;50;50;0;0;50;0
4076;Jardim Leopoldina;Hípica;50;0;40;8;0;50
4077;Jardim Leopoldina;Independência;100;0;68;15;0;100
4078;Jardim Leopoldina;Ipanema;100;0;26;15;50;50
4079;Jardim Leopoldina;Jardim Botânico;0;0;0;0;0;0
4080;Jardim Leopoldina;Jardim Carvalho;300;50;94;20;150;150
4081;Jardim Leopoldina;Jardim Europa;150;50;70;21;50;100
4082;Jardim Leopoldina;Jardim Floresta;0;0;0;0;0;0
4083;Jardim Leopoldina;Jardim Isabel;50;0;35;10;0;50
4084;Jardim Leopoldina;Jardim Itú;600;300;149;48;350;250
4085;Jardim Leopoldina;Jardim Leopoldina;15992;3700;6040;1740;6192;9800
4086;Jardim Leopoldina;Jardim Lindóia;100;0;33;11;50;50
4087;Jardim Leopoldina;Jardim Sabará;700;150;200;77;350;350
4088;Jardim Leopoldina;Jardim São Pedro;50;0;0;0;50;0
4089;Jardim Leopoldina;Jardim do Salso;100;0;50;0;100;0
4090;Jardim Leopoldina;Lageado;0;0;0;0;0;0
4091;Jardim Leopoldina;Lami;0;0;0;0;0;0
4092;Jardim Leopoldina;Lomba do Pinheiro;400;50;196;51;50;350
4093;Jardim Leopoldina;Medianeira;100;0;58;28;0;100
4094;Jardim Leopoldina;Menino Deus;50;0;0;0;50;0
4095;Jardim Leopoldina;Moinhos de Vento;50;50;0;0;50;0
4096;Jardim Leopoldina;Mont'Serrat;200;100;59;19;100;100
4097;Jardim Leopoldina;Morro Santana;800;100;264;88;350;450
4098;Jardim Leopoldina;Mário Quintana;1900;400;756;175;700;1200
4099;Jardim Leopoldina;Navegantes;0;0;0;0;0;0
4100;Jardim Leopoldina;Nonoai;0;0;0;0;0;0
4101;Jardim Leopoldina;Parque Santa Fé;1900;500;487;111;1300;600
4102;Jardim Leopoldina;Partenon;250;0;109;52;50;200
4103;Jardim Leopoldina;Passo D'Areia;150;50;0;0;150;0
4104;Jardim Leopoldina;Passo das Pedras;1450;400;635;173;500;950
4105;Jardim Leopoldina;Pedra Redonda;0;0;0;0;0;0
4106;Jardim Leopoldina;Petrópolis;100;0;57;25;0;100
4107;Jardim Leopoldina;Pitinga;0;0;0;0;0;0
4108;Jardim Leopoldina;Ponta Grossa;50;0;37;6;0;50
4109;Jardim Leopoldina;Praia de Belas;0;0;0;0;0;0
4110;Jardim Leopoldina;Restinga;200;0;114;24;0;200
4111;Jardim Leopoldina;Rio Branco;100;0;65;15;0;100
4112;Jardim Leopoldina;Rubem Berta;3150;1000;727;410;1850;1300
4113;Jardim Leopoldina;Santa Cecília;0;0;0;0;0;0
4114;Jardim Leopoldina;Santa Maria Goretti;0;0;0;0;0;0
4115;Jardim Leopoldina;Santa Rosa de Lima;2286;700;555;177;1386;900
4116;Jardim Leopoldina;Santa Tereza;100;50;29;9;50;50
4117;Jardim Leopoldina;Santana;100;0;0;0;100;0
4118;Jardim Leopoldina;Santo Antônio;50;0;29;7;0;50
4119;Jardim Leopoldina;Sarandi;400;0;170;67;100;300
4120;Jardim Leopoldina;Serraria;50;0;0;0;50;0
4121;Jardim Leopoldina;São Caetano;100;0;59;14;0;100
4122;Jardim Leopoldina;São Geraldo;50;0;25;13;0;50
4123;Jardim Leopoldina;São José;50;50;0;0;50;0
4124;Jardim Leopoldina;São João;50;0;28;6;0;50
4125;Jardim Leopoldina;São Sebastião;350;100;85;28;200;150
4126;Jardim Leopoldina;Sétimo Céu;50;0;35;8;0;50
4127;Jardim Leopoldina;Teresópolis;50;0;32;6;0;50
4128;Jardim Leopoldina;Tristeza;50;50;0;0;50;0
4129;Jardim Leopoldina;Três Figueiras;200;50;61;18;100;100
4130;Jardim Leopoldina;Vila Assunção;50;0;28;8;0;50
4131;Jardim Leopoldina;Vila Conceição;0;0;0;0;0;0
4132;Jardim Leopoldina;Vila Ipiranga;200;50;91;26;50;150
4133;Jardim Leopoldina;Vila Jardim;0;0;0;0;0;0
4134;Jardim Leopoldina;Vila João Pessoa;50;0;33;4;0;50
4135;Jardim Leopoldina;Vila Nova;350;0;165;65;50;300
4136;Jardim Lindóia;Aberta dos Morros;0;0;0;0;0;0
4137;Jardim Lindóia;Agronomia;0;0;0;0;0;0
4138;Jardim Lindóia;Anchieta;0;0;0;0;0;0
4139;Jardim Lindóia;Arquipélago;0;0;0;0;0;0
4140;Jardim Lindóia;Auxiliadora;150;0;39;35;50;100
4141;Jardim Lindóia;Azenha;0;0;0;0;0;0
4142;Jardim Lindóia;Bela Vista;150;0;110;22;50;100
4143;Jardim Lindóia;Belém Novo;100;0;51;31;0;100
4144;Jardim Lindóia;Belém Velho;150;0;98;35;50;100
4145;Jardim Lindóia;Boa Vista;200;50;31;11;150;50
4146;Jardim Lindóia;Boa Vista do Sul;50;0;23;10;0;50
4147;Jardim Lindóia;Bom Fim;100;0;63;24;0;100
4148;Jardim Lindóia;Bom Jesus;200;100;63;15;100;100
4149;Jardim Lindóia;Camaquã;0;0;0;0;0;0
4150;Jardim Lindóia;Campo Novo;0;0;0;0;0;0
4151;Jardim Lindóia;Cascata;200;0;49;25;100;100
4152;Jardim Lindóia;Cavalhada;200;100;55;27;100;100
4153;Jardim Lindóia;Cel. Aparício Borges;50;0;35;6;0;50
4154;Jardim Lindóia;Centro Histórico;0;0;0;0;0;0
4155;Jardim Lindóia;Chapéu do Sol;0;0;0;0;0;0
4156;Jardim Lindóia;Chácara das Pedras;50;0;28;17;0;50
4157;Jardim Lindóia;Cidade Baixa;150;0;64;26;50;100
4158;Jardim Lindóia;Costa e Silva;500;100;219;69;150;350
4159;Jardim Lindóia;Cristal;150;0;78;10;100;50
4160;Jardim Lindóia;Cristo Redentor;1800;100;927;397;250;1550
4161;Jardim Lindóia;Espírito Santo;0;0;0;0;0;0
4162;Jardim Lindóia;Extrema;0;0;0;0;0;0
4163;Jardim Lindóia;Farrapos;100;0;52;20;0;100
4164;Jardim Lindóia;Farroupilha;50;0;32;12;0;50
4165;Jardim Lindóia;Floresta;50;0;28;18;0;50
4166;Jardim Lindóia;Glória;0;0;0;0;0;0
4167;Jardim Lindóia;Guarujá;0;0;0;0;0;0
4168;Jardim Lindóia;Higienópolis;100;50;31;10;50;50
4169;Jardim Lindóia;Humaitá;150;0;66;24;50;100
4170;Jardim Lindóia;Hípica;0;0;0;0;0;0
4171;Jardim Lindóia;Independência;0;0;0;0;0;0
4172;Jardim Lindóia;Ipanema;50;0;37;10;0;50
4173;Jardim Lindóia;Jardim Botânico;150;50;62;20;50;100
4174;Jardim Lindóia;Jardim Carvalho;200;0;89;36;50;150
4175;Jardim Lindóia;Jardim Europa;300;50;142;58;50;250
4176;Jardim Lindóia;Jardim Floresta;1700;450;559;248;800;900
4177;Jardim Lindóia;Jardim Isabel;0;0;0;0;0;0
4178;Jardim Lindóia;Jardim Itú;350;50;144;58;100;250
4179;Jardim Lindóia;Jardim Leopoldina;100;0;33;11;50;50
4180;Jardim Lindóia;Jardim Lindóia;1600;300;420;232;800;800
4181;Jardim Lindóia;Jardim Sabará;50;50;0;0;50;0
4182;Jardim Lindóia;Jardim São Pedro;300;150;56;34;200;100
4183;Jardim Lindóia;Jardim do Salso;100;0;21;18;50;50
4184;Jardim Lindóia;Lageado;0;0;0;0;0;0
4185;Jardim Lindóia;Lami;50;0;28;15;0;50
4186;Jardim Lindóia;Lomba do Pinheiro;50;0;0;0;50;0
4187;Jardim Lindóia;Medianeira;50;0;31;8;0;50
4188;Jardim Lindóia;Menino Deus;50;0;20;15;0;50
4189;Jardim Lindóia;Moinhos de Vento;100;0;45;42;0;100
4190;Jardim Lindóia;Mont'Serrat;50;0;30;14;0;50
4191;Jardim Lindóia;Morro Santana;100;0;61;26;0;100
4192;Jardim Lindóia;Mário Quintana;300;150;63;6;200;100
4193;Jardim Lindóia;Navegantes;50;50;0;0;50;0
4194;Jardim Lindóia;Nonoai;250;100;88;30;100;150
4195;Jardim Lindóia;Parque Santa Fé;50;0;26;18;0;50
4196;Jardim Lindóia;Partenon;400;50;163;18;300;100
4197;Jardim Lindóia;Passo D'Areia;550;0;234;139;100;450
4198;Jardim Lindóia;Passo das Pedras;450;0;261;86;100;350
4199;Jardim Lindóia;Pedra Redonda;0;0;0;0;0;0
4200;Jardim Lindóia;Petrópolis;350;50;136;72;100;250
4201;Jardim Lindóia;Pitinga;0;0;0;0;0;0
4202;Jardim Lindóia;Ponta Grossa;100;0;62;24;0;100
4203;Jardim Lindóia;Praia de Belas;0;0;0;0;0;0
4204;Jardim Lindóia;Restinga;100;50;29;7;50;50
4205;Jardim Lindóia;Rio Branco;200;0;78;40;50;150
4206;Jardim Lindóia;Rubem Berta;300;100;22;21;250;50
4207;Jardim Lindóia;Santa Cecília;100;0;74;13;50;50
4208;Jardim Lindóia;Santa Maria Goretti;100;0;69;5;0;100
4209;Jardim Lindóia;Santa Rosa de Lima;1200;100;656;196;150;1050
4210;Jardim Lindóia;Santa Tereza;250;0;142;31;100;150
4211;Jardim Lindóia;Santana;50;0;27;15;0;50
4212;Jardim Lindóia;Santo Antônio;0;0;0;0;0;0
4213;Jardim Lindóia;Sarandi;950;50;407;204;200;750
4214;Jardim Lindóia;Serraria;100;0;0;0;100;0
4215;Jardim Lindóia;São Caetano;0;0;0;0;0;0
4216;Jardim Lindóia;São Geraldo;0;0;0;0;0;0
4217;Jardim Lindóia;São José;50;0;31;11;0;50
4218;Jardim Lindóia;São João;150;100;24;12;100;50
4219;Jardim Lindóia;São Sebastião;1850;300;822;352;500;1350
4220;Jardim Lindóia;Sétimo Céu;0;0;0;0;0;0
4221;Jardim Lindóia;Teresópolis;100;0;31;11;50;50
4222;Jardim Lindóia;Tristeza;0;0;0;0;0;0
4223;Jardim Lindóia;Três Figueiras;100;0;50;0;100;0
4224;Jardim Lindóia;Vila Assunção;0;0;0;0;0;0
4225;Jardim Lindóia;Vila Conceição;0;0;0;0;0;0
4226;Jardim Lindóia;Vila Ipiranga;600;100;132;75;350;250
4227;Jardim Lindóia;Vila Jardim;350;50;179;95;50;300
4228;Jardim Lindóia;Vila João Pessoa;50;0;0;0;50;0
4229;Jardim Lindóia;Vila Nova;300;100;111;56;100;200
4230;Jardim Sabará;Aberta dos Morros;50;0;0;0;50;0
4231;Jardim Sabará;Agronomia;200;50;87;21;50;150
4232;Jardim Sabará;Anchieta;150;0;57;21;50;100
4233;Jardim Sabará;Arquipélago;100;0;47;29;0;100
4234;Jardim Sabará;Auxiliadora;200;50;74;45;50;150
4235;Jardim Sabará;Azenha;200;0;87;33;50;150
4236;Jardim Sabará;Bela Vista;0;0;0;0;0;0
4237;Jardim Sabará;Belém Novo;0;0;0;0;0;0
4238;Jardim Sabará;Belém Velho;50;50;0;0;50;0
4239;Jardim Sabará;Boa Vista;150;0;86;38;0;150
4240;Jardim Sabará;Boa Vista do Sul;100;0;24;12;50;50
4241;Jardim Sabará;Bom Fim;150;0;51;29;50;100
4242;Jardim Sabará;Bom Jesus;2800;50;1384;426;450;2350
4243;Jardim Sabará;Camaquã;0;0;0;0;0;0
4244;Jardim Sabará;Campo Novo;0;0;0;0;0;0
4245;Jardim Sabará;Cascata;150;0;50;20;50;100
4246;Jardim Sabará;Cavalhada;50;0;25;11;0;50
4247;Jardim Sabará;Cel. Aparício Borges;300;0;108;36;100;200
4248;Jardim Sabará;Centro Histórico;150;0;56;26;50;100
4249;Jardim Sabará;Chapéu do Sol;100;0;57;29;0;100
4250;Jardim Sabará;Chácara das Pedras;750;50;335;156;100;650
4251;Jardim Sabará;Cidade Baixa;0;0;0;0;0;0
4252;Jardim Sabará;Costa e Silva;150;50;28;4;100;50
4253;Jardim Sabará;Cristal;100;0;27;10;50;50
4254;Jardim Sabará;Cristo Redentor;200;150;0;0;200;0
4255;Jardim Sabará;Espírito Santo;0;0;0;0;0;0
4256;Jardim Sabará;Extrema;100;50;25;14;50;50
4257;Jardim Sabará;Farrapos;50;0;27;13;0;50
4258;Jardim Sabará;Farroupilha;100;50;29;11;50;50
4259;Jardim Sabará;Floresta;100;0;60;25;0;100
4260;Jardim Sabará;Glória;150;0;51;26;50;100
4261;Jardim Sabará;Guarujá;0;0;0;0;0;0
4262;Jardim Sabará;Higienópolis;200;50;89;33;50;150
4263;Jardim Sabará;Humaitá;150;0;96;43;0;150
4264;Jardim Sabará;Hípica;50;50;0;0;50;0
4265;Jardim Sabará;Independência;150;50;32;14;100;50
4266;Jardim Sabará;Ipanema;100;0;58;19;0;100
4267;Jardim Sabará;Jardim Botânico;200;50;64;18;100;100
4268;Jardim Sabará;Jardim Carvalho;450;100;166;54;200;250
4269;Jardim Sabará;Jardim Europa;250;0;157;62;0;250
4270;Jardim Sabará;Jardim Floresta;100;50;0;0;100;0
4271;Jardim Sabará;Jardim Isabel;50;0;26;7;0;50
4272;Jardim Sabará;Jardim Itú;1700;350;584;251;700;1000
4273;Jardim Sabará;Jardim Leopoldina;700;150;200;77;350;350
4274;Jardim Sabará;Jardim Lindóia;50;50;0;0;50;0
4275;Jardim Sabará;Jardim Sabará;4800;1700;1000;382;3200;1600
4276;Jardim Sabará;Jardim São Pedro;100;0;49;34;0;100
4277;Jardim Sabará;Jardim do Salso;900;50;453;191;100;800
4278;Jardim Sabará;Lageado;0;0;0;0;0;0
4279;Jardim Sabará;Lami;50;0;27;15;0;50
4280;Jardim Sabará;Lomba do Pinheiro;500;100;227;52;100;400
4281;Jardim Sabará;Medianeira;0;0;0;0;0;0
4282;Jardim Sabará;Menino Deus;100;0;23;10;50;50
4283;Jardim Sabará;Moinhos de Vento;200;0;83;44;50;150
4284;Jardim Sabará;Mont'Serrat;50;50;0;0;50;0
4285;Jardim Sabará;Morro Santana;1050;100;509;197;150;900
4286;Jardim Sabará;Mário Quintana;1250;150;541;116;350;900
4287;Jardim Sabará;Navegantes;50;0;0;0;50;0
4288;Jardim Sabará;Nonoai;200;50;75;18;150;50
4289;Jardim Sabará;Parque Santa Fé;150;50;61;26;50;100
4290;Jardim Sabará;Partenon;150;0;103;28;50;100
4291;Jardim Sabará;Passo D'Areia;250;100;55;61;100;150
4292;Jardim Sabará;Passo das Pedras;550;50;254;107;100;450
4293;Jardim Sabará;Pedra Redonda;50;0;28;11;0;50
4294;Jardim Sabará;Petrópolis;350;50;144;61;100;250
4295;Jardim Sabará;Pitinga;100;50;30;10;50;50
4296;Jardim Sabará;Ponta Grossa;0;0;0;0;0;0
4297;Jardim Sabará;Praia de Belas;50;0;0;0;50;0
4298;Jardim Sabará;Restinga;100;50;26;9;50;50
4299;Jardim Sabará;Rio Branco;100;50;33;14;50;50
4300;Jardim Sabará;Rubem Berta;650;150;151;115;350;300
4301;Jardim Sabará;Santa Cecília;50;0;23;17;0;50
4302;Jardim Sabará;Santa Maria Goretti;200;50;68;19;100;100
4303;Jardim Sabará;Santa Rosa de Lima;400;100;84;37;250;150
4304;Jardim Sabará;Santa Tereza;150;50;60;19;50;100
4305;Jardim Sabará;Santana;50;0;26;10;0;50
4306;Jardim Sabará;Santo Antônio;100;0;53;16;0;100
4307;Jardim Sabará;Sarandi;500;0;230;100;150;350
4308;Jardim Sabará;Serraria;50;0;0;0;50;0
4309;Jardim Sabará;São Caetano;0;0;0;0;0;0
4310;Jardim Sabará;São Geraldo;100;0;53;33;0;100
4311;Jardim Sabará;São José;50;0;25;15;0;50
4312;Jardim Sabará;São João;100;0;29;16;50;50
4313;Jardim Sabará;São Sebastião;250;50;88;27;100;150
4314;Jardim Sabará;Sétimo Céu;0;0;0;0;0;0
4315;Jardim Sabará;Teresópolis;150;50;56;20;50;100
4316;Jardim Sabará;Tristeza;100;0;58;28;0;100
4317;Jardim Sabará;Três Figueiras;200;0;52;25;100;100
4318;Jardim Sabará;Vila Assunção;0;0;0;0;0;0
4319;Jardim Sabará;Vila Conceição;50;0;29;12;0;50
4320;Jardim Sabará;Vila Ipiranga;400;0;186;71;100;300
4321;Jardim Sabará;Vila Jardim;3133;1050;545;193;2333;800
4322;Jardim Sabará;Vila João Pessoa;100;0;22;17;50;50
4323;Jardim Sabará;Vila Nova;250;0;119;27;50;200
4324;Jardim São Pedro;Aberta dos Morros;0;0;0;0;0;0
4325;Jardim São Pedro;Agronomia;100;0;50;0;100;0
4326;Jardim São Pedro;Anchieta;500;150;195;38;200;300
4327;Jardim São Pedro;Arquipélago;100;0;58;23;0;100
4328;Jardim São Pedro;Auxiliadora;150;0;47;29;50;100
4329;Jardim São Pedro;Azenha;50;0;0;0;50;0
4330;Jardim São Pedro;Bela Vista;50;0;0;0;50;0
4331;Jardim São Pedro;Belém Novo;50;0;29;12;0;50
4332;Jardim São Pedro;Belém Velho;0;0;0;0;0;0
4333;Jardim São Pedro;Boa Vista;400;50;179;62;100;300
4334;Jardim São Pedro;Boa Vista do Sul;0;0;0;0;0;0
4335;Jardim São Pedro;Bom Fim;100;0;25;16;50;50
4336;Jardim São Pedro;Bom Jesus;0;0;0;0;0;0
4337;Jardim São Pedro;Camaquã;0;0;0;0;0;0
4338;Jardim São Pedro;Campo Novo;50;0;38;3;0;50
4339;Jardim São Pedro;Cascata;150;0;92;24;0;150
4340;Jardim São Pedro;Cavalhada;0;0;0;0;0;0
4341;Jardim São Pedro;Cel. Aparício Borges;50;0;29;5;0;50
4342;Jardim São Pedro;Centro Histórico;200;0;106;59;0;200
4343;Jardim São Pedro;Chapéu do Sol;0;0;0;0;0;0
4344;Jardim São Pedro;Chácara das Pedras;50;0;24;16;0;50
4345;Jardim São Pedro;Cidade Baixa;50;0;34;11;0;50
4346;Jardim São Pedro;Costa e Silva;150;100;33;9;100;50
4347;Jardim São Pedro;Cristal;200;0;117;58;0;200
4348;Jardim São Pedro;Cristo Redentor;3200;1150;565;175;2350;850
4349;Jardim São Pedro;Espírito Santo;50;0;33;11;0;50
4350;Jardim São Pedro;Extrema;0;0;0;0;0;0
4351;Jardim São Pedro;Farrapos;396;100;178;24;196;200
4352;Jardim São Pedro;Farroupilha;0;0;0;0;0;0
4353;Jardim São Pedro;Floresta;200;0;116;43;0;200
4354;Jardim São Pedro;Glória;100;0;30;16;50;50
4355;Jardim São Pedro;Guarujá;0;0;0;0;0;0
4356;Jardim São Pedro;Higienópolis;150;50;75;23;50;100
4357;Jardim São Pedro;Humaitá;450;0;257;58;50;400
4358;Jardim São Pedro;Hípica;50;50;0;0;50;0
4359;Jardim São Pedro;Independência;100;50;0;0;100;0
4360;Jardim São Pedro;Ipanema;0;0;0;0;0;0
4361;Jardim São Pedro;Jardim Botânico;50;0;24;17;0;50
4362;Jardim São Pedro;Jardim Carvalho;50;0;22;9;0;50
4363;Jardim São Pedro;Jardim Europa;150;50;23;18;100;50
4364;Jardim São Pedro;Jardim Floresta;500;200;112;43;300;200
4365;Jardim São Pedro;Jardim Isabel;100;0;67;20;0;100
4366;Jardim São Pedro;Jardim Itú;150;50;30;12;100;50
4367;Jardim São Pedro;Jardim Leopoldina;50;0;0;0;50;0
4368;Jardim São Pedro;Jardim Lindóia;300;150;56;34;200;100
4369;Jardim São Pedro;Jardim Sabará;100;0;49;34;0;100
4370;Jardim São Pedro;Jardim São Pedro;1300;200;194;96;900;400
4371;Jardim São Pedro;Jardim do Salso;0;0;0;0;0;0
4372;Jardim São Pedro;Lageado;50;0;26;12;0;50
4373;Jardim São Pedro;Lami;0;0;0;0;0;0
4374;Jardim São Pedro;Lomba do Pinheiro;0;0;0;0;0;0
4375;Jardim São Pedro;Medianeira;50;50;0;0;50;0
4376;Jardim São Pedro;Menino Deus;100;0;28;12;50;50
4377;Jardim São Pedro;Moinhos de Vento;0;0;0;0;0;0
4378;Jardim São Pedro;Mont'Serrat;200;0;61;34;100;100
4379;Jardim São Pedro;Morro Santana;150;50;63;17;50;100
4380;Jardim São Pedro;Mário Quintana;250;0;110;23;50;200
4381;Jardim São Pedro;Navegantes;50;0;27;12;0;50
4382;Jardim São Pedro;Nonoai;0;0;0;0;0;0
4383;Jardim São Pedro;Parque Santa Fé;0;0;0;0;0;0
4384;Jardim São Pedro;Partenon;200;0;115;40;0;200
4385;Jardim São Pedro;Passo D'Areia;1843;400;359;329;943;900
4386;Jardim São Pedro;Passo das Pedras;150;50;63;21;50;100
4387;Jardim São Pedro;Pedra Redonda;50;0;33;11;0;50
4388;Jardim São Pedro;Petrópolis;200;50;30;4;150;50
4389;Jardim São Pedro;Pitinga;0;0;0;0;0;0
4390;Jardim São Pedro;Ponta Grossa;0;0;0;0;0;0
4391;Jardim São Pedro;Praia de Belas;0;0;0;0;0;0
4392;Jardim São Pedro;Restinga;50;0;29;10;0;50
4393;Jardim São Pedro;Rio Branco;300;100;111;51;100;200
4394;Jardim São Pedro;Rubem Berta;150;50;40;43;50;100
4395;Jardim São Pedro;Santa Cecília;0;0;0;0;0;0
4396;Jardim São Pedro;Santa Maria Goretti;1500;100;751;366;150;1350
4397;Jardim São Pedro;Santa Rosa de Lima;150;50;0;0;150;0
4398;Jardim São Pedro;Santa Tereza;100;0;29;6;50;50
4399;Jardim São Pedro;Santana;100;0;27;16;50;50
4400;Jardim São Pedro;Santo Antônio;0;0;0;0;0;0
4401;Jardim São Pedro;Sarandi;800;0;367;157;200;600
4402;Jardim São Pedro;Serraria;0;0;0;0;0;0
4403;Jardim São Pedro;São Caetano;0;0;0;0;0;0
4404;Jardim São Pedro;São Geraldo;50;0;0;0;50;0
4405;Jardim São Pedro;São José;0;0;0;0;0;0
4406;Jardim São Pedro;São João;200;0;136;55;50;150
4407;Jardim São Pedro;São Sebastião;100;50;33;14;50;50
4408;Jardim São Pedro;Sétimo Céu;50;50;0;0;50;0
4409;Jardim São Pedro;Teresópolis;50;0;23;14;0;50
4410;Jardim São Pedro;Tristeza;50;50;0;0;50;0
4411;Jardim São Pedro;Três Figueiras;150;50;62;20;50;100
4412;Jardim São Pedro;Vila Assunção;0;0;0;0;0;0
4413;Jardim São Pedro;Vila Conceição;0;0;0;0;0;0
4414;Jardim São Pedro;Vila Ipiranga;500;50;215;116;100;400
4415;Jardim São Pedro;Vila Jardim;0;0;0;0;0;0
4416;Jardim São Pedro;Vila João Pessoa;0;0;0;0;0;0
4417;Jardim São Pedro;Vila Nova;100;0;54;23;0;100
4418;Jardim do Salso;Aberta dos Morros;50;0;36;5;0;50
4419;Jardim do Salso;Agronomia;0;0;0;0;0;0
4420;Jardim do Salso;Anchieta;0;0;0;0;0;0
4421;Jardim do Salso;Arquipélago;0;0;0;0;0;0
4422;Jardim do Salso;Auxiliadora;0;0;0;0;0;0
4423;Jardim do Salso;Azenha;50;0;23;12;0;50
4424;Jardim do Salso;Bela Vista;100;0;60;21;0;100
4425;Jardim do Salso;Belém Novo;0;0;0;0;0;0
4426;Jardim do Salso;Belém Velho;50;0;0;0;50;0
4427;Jardim do Salso;Boa Vista;50;50;0;0;50;0
4428;Jardim do Salso;Boa Vista do Sul;150;50;27;12;100;50
4429;Jardim do Salso;Bom Fim;0;0;0;0;0;0
4430;Jardim do Salso;Bom Jesus;2750;500;1202;378;700;2050
4431;Jardim do Salso;Camaquã;50;0;26;9;0;50
4432;Jardim do Salso;Campo Novo;0;0;0;0;0;0
4433;Jardim do Salso;Cascata;250;50;113;31;50;200
4434;Jardim do Salso;Cavalhada;0;0;0;0;0;0
4435;Jardim do Salso;Cel. Aparício Borges;750;150;334;102;150;600
4436;Jardim do Salso;Centro Histórico;150;0;58;34;50;100
4437;Jardim do Salso;Chapéu do Sol;50;0;24;10;0;50
4438;Jardim do Salso;Chácara das Pedras;350;0;151;92;50;300
4439;Jardim do Salso;Cidade Baixa;50;0;35;11;0;50
4440;Jardim do Salso;Costa e Silva;100;50;0;0;100;0
4441;Jardim do Salso;Cristal;100;100;0;0;100;0
4442;Jardim do Salso;Cristo Redentor;150;100;32;5;100;50
4443;Jardim do Salso;Espírito Santo;0;0;0;0;0;0
4444;Jardim do Salso;Extrema;0;0;0;0;0;0
4445;Jardim do Salso;Farrapos;0;0;0;0;0;0
4446;Jardim do Salso;Farroupilha;0;0;0;0;0;0
4447;Jardim do Salso;Floresta;50;0;30;10;0;50
4448;Jardim do Salso;Glória;100;50;0;0;100;0
4449;Jardim do Salso;Guarujá;50;0;40;8;0;50
4450;Jardim do Salso;Higienópolis;100;50;23;11;50;50
4451;Jardim do Salso;Humaitá;150;50;73;15;50;100
4452;Jardim do Salso;Hípica;0;0;0;0;0;0
4453;Jardim do Salso;Independência;100;50;0;0;100;0
4454;Jardim do Salso;Ipanema;0;0;0;0;0;0
4455;Jardim do Salso;Jardim Botânico;618;50;268;64;318;300
4456;Jardim do Salso;Jardim Carvalho;1150;200;447;114;450;700
4457;Jardim do Salso;Jardim Europa;50;0;28;18;0;50
4458;Jardim do Salso;Jardim Floresta;50;50;0;0;50;0
4459;Jardim do Salso;Jardim Isabel;0;0;0;0;0;0
4460;Jardim do Salso;Jardim Itú;150;100;0;0;150;0
4461;Jardim do Salso;Jardim Leopoldina;100;0;50;0;100;0
4462;Jardim do Salso;Jardim Lindóia;100;0;21;18;50;50
4463;Jardim do Salso;Jardim Sabará;900;50;453;191;100;800
4464;Jardim do Salso;Jardim São Pedro;0;0;0;0;0;0
4465;Jardim do Salso;Jardim do Salso;2700;100;1498;522;200;2500
4466;Jardim do Salso;Lageado;0;0;0;0;0;0
4467;Jardim do Salso;Lami;0;0;0;0;0;0
4468;Jardim do Salso;Lomba do Pinheiro;350;0;223;36;0;350
4469;Jardim do Salso;Medianeira;50;0;0;0;50;0
4470;Jardim do Salso;Menino Deus;100;0;79;15;50;50
4471;Jardim do Salso;Moinhos de Vento;100;0;50;48;0;100
4472;Jardim do Salso;Mont'Serrat;0;0;0;0;0;0
4473;Jardim do Salso;Morro Santana;50;0;0;0;50;0
4474;Jardim do Salso;Mário Quintana;0;0;0;0;0;0
4475;Jardim do Salso;Navegantes;0;0;0;0;0;0
4476;Jardim do Salso;Nonoai;200;50;89;27;50;150
4477;Jardim do Salso;Parque Santa Fé;0;0;0;0;0;0
4478;Jardim do Salso;Partenon;1500;750;179;60;1250;250
4479;Jardim do Salso;Passo D'Areia;150;0;58;53;0;150
4480;Jardim do Salso;Passo das Pedras;100;0;29;5;50;50
4481;Jardim do Salso;Pedra Redonda;50;0;30;6;0;50
4482;Jardim do Salso;Petrópolis;1500;400;189;63;1250;250
4483;Jardim do Salso;Pitinga;0;0;0;0;0;0
4484;Jardim do Salso;Ponta Grossa;50;0;34;3;0;50
4485;Jardim do Salso;Praia de Belas;0;0;0;0;0;0
4486;Jardim do Salso;Restinga;150;0;92;21;0;150
4487;Jardim do Salso;Rio Branco;200;0;102;59;0;200
4488;Jardim do Salso;Rubem Berta;50;0;27;13;0;50
4489;Jardim do Salso;Santa Cecília;50;0;30;17;0;50
4490;Jardim do Salso;Santa Maria Goretti;50;0;0;0;50;0
4491;Jardim do Salso;Santa Rosa de Lima;0;0;0;0;0;0
4492;Jardim do Salso;Santa Tereza;100;0;59;22;0;100
4493;Jardim do Salso;Santana;300;50;48;25;200;100
4494;Jardim do Salso;Santo Antônio;150;0;89;36;0;150
4495;Jardim do Salso;Sarandi;300;0;82;33;150;150
4496;Jardim do Salso;Serraria;0;0;0;0;0;0
4497;Jardim do Salso;São Caetano;50;0;35;12;0;50
4498;Jardim do Salso;São Geraldo;0;0;0;0;0;0
4499;Jardim do Salso;São José;850;150;258;76;400;450
4500;Jardim do Salso;São João;150;0;68;43;0;150
4501;Jardim do Salso;São Sebastião;0;0;0;0;0;0
4502;Jardim do Salso;Sétimo Céu;0;0;0;0;0;0
4503;Jardim do Salso;Teresópolis;50;0;29;12;0;50
4504;Jardim do Salso;Tristeza;0;0;0;0;0;0
4505;Jardim do Salso;Três Figueiras;0;0;0;0;0;0
4506;Jardim do Salso;Vila Assunção;0;0;0;0;0;0
4507;Jardim do Salso;Vila Conceição;0;0;0;0;0;0
4508;Jardim do Salso;Vila Ipiranga;150;0;70;41;0;150
4509;Jardim do Salso;Vila Jardim;350;100;132;65;100;250
4510;Jardim do Salso;Vila João Pessoa;1150;200;472;192;350;800
4511;Jardim do Salso;Vila Nova;50;0;31;8;0;50
4512;Lageado;Aberta dos Morros;150;100;33;7;100;50
4513;Lageado;Agronomia;50;50;0;0;50;0
4514;Lageado;Anchieta;0;0;0;0;0;0
4515;Lageado;Arquipélago;50;0;0;0;50;0
4516;Lageado;Auxiliadora;50;0;20;19;0;50
4517;Lageado;Azenha;250;50;71;36;100;150
4518;Lageado;Bela Vista;100;0;61;21;0;100
4519;Lageado;Belém Novo;150;100;35;8;100;50
4520;Lageado;Belém Velho;50;50;0;0;50;0
4521;Lageado;Boa Vista;0;0;0;0;0;0
4522;Lageado;Boa Vista do Sul;50;0;0;0;50;0
4523;Lageado;Bom Fim;50;0;30;14;0;50
4524;Lageado;Bom Jesus;100;0;59;16;0;100
4525;Lageado;Camaquã;0;0;0;0;0;0
4526;Lageado;Campo Novo;50;0;36;6;0;50
4527;Lageado;Cascata;0;0;0;0;0;0
4528;Lageado;Cavalhada;50;50;0;0;50;0
4529;Lageado;Cel. Aparício Borges;50;0;24;9;0;50
4530;Lageado;Centro Histórico;200;100;27;6;150;50
4531;Lageado;Chapéu do Sol;450;50;239;58;50;400
4532;Lageado;Chácara das Pedras;0;0;0;0;0;0
4533;Lageado;Cidade Baixa;0;0;0;0;0;0
4534;Lageado;Costa e Silva;0;0;0;0;0;0
4535;Lageado;Cristal;150;0;61;18;50;100
4536;Lageado;Cristo Redentor;100;50;28;10;50;50
4537;Lageado;Espírito Santo;50;0;27;6;0;50
4538;Lageado;Extrema;400;0;237;61;0;400
4539;Lageado;Farrapos;50;0;33;4;0;50
4540;Lageado;Farroupilha;0;0;0;0;0;0
4541;Lageado;Floresta;50;0;28;6;0;50
4542;Lageado;Glória;50;0;20;16;0;50
4543;Lageado;Guarujá;0;0;0;0;0;0
4544;Lageado;Higienópolis;0;0;0;0;0;0
4545;Lageado;Humaitá;100;0;31;6;50;50
4546;Lageado;Hípica;300;0;210;43;0;300
4547;Lageado;Independência;0;0;0;0;0;0
4548;Lageado;Ipanema;50;0;28;11;0;50
4549;Lageado;Jardim Botânico;100;50;31;9;50;50
4550;Lageado;Jardim Carvalho;200;50;92;18;50;150
4551;Lageado;Jardim Europa;0;0;0;0;0;0
4552;Lageado;Jardim Floresta;50;0;25;18;0;50
4553;Lageado;Jardim Isabel;0;0;0;0;0;0
4554;Lageado;Jardim Itú;0;0;0;0;0;0
4555;Lageado;Jardim Leopoldina;0;0;0;0;0;0
4556;Lageado;Jardim Lindóia;0;0;0;0;0;0
4557;Lageado;Jardim Sabará;0;0;0;0;0;0
4558;Lageado;Jardim São Pedro;50;0;26;12;0;50
4559;Lageado;Jardim do Salso;0;0;0;0;0;0
4560;Lageado;Lageado;400;100;210;58;100;300
4561;Lageado;Lami;800;0;465;108;50;750
4562;Lageado;Lomba do Pinheiro;300;50;90;22;150;150
4563;Lageado;Medianeira;0;0;0;0;0;0
4564;Lageado;Menino Deus;450;100;91;65;250;200
4565;Lageado;Moinhos de Vento;50;0;0;0;50;0
4566;Lageado;Mont'Serrat;0;0;0;0;0;0
4567;Lageado;Morro Santana;100;0;28;9;50;50
4568;Lageado;Mário Quintana;150;100;32;8;100;50
4569;Lageado;Navegantes;50;0;0;0;50;0
4570;Lageado;Nonoai;100;0;74;19;0;100
4571;Lageado;Parque Santa Fé;0;0;0;0;0;0
4572;Lageado;Partenon;200;50;58;16;100;100
4573;Lageado;Passo D'Areia;50;0;0;0;50;0
4574;Lageado;Passo das Pedras;50;0;29;6;0;50
4575;Lageado;Pedra Redonda;0;0;0;0;0;0
4576;Lageado;Petrópolis;150;0;90;44;0;150
4577;Lageado;Pitinga;150;50;64;15;50;100
4578;Lageado;Ponta Grossa;0;0;0;0;0;0
4579;Lageado;Praia de Belas;0;0;0;0;0;0
4580;Lageado;Restinga;1200;150;474;102;500;700
4581;Lageado;Rio Branco;0;0;0;0;0;0
4582;Lageado;Rubem Berta;250;250;0;0;250;0
4583;Lageado;Santa Cecília;100;0;55;27;0;100
4584;Lageado;Santa Maria Goretti;0;0;0;0;0;0
4585;Lageado;Santa Rosa de Lima;100;0;31;8;50;50
4586;Lageado;Santa Tereza;150;50;34;10;100;50
4587;Lageado;Santana;0;0;0;0;0;0
4588;Lageado;Santo Antônio;100;0;29;11;50;50
4589;Lageado;Sarandi;0;0;0;0;0;0
4590;Lageado;Serraria;0;0;0;0;0;0
4591;Lageado;São Caetano;1800;300;666;167;700;1100
4592;Lageado;São Geraldo;0;0;0;0;0;0
4593;Lageado;São José;0;0;0;0;0;0
4594;Lageado;São João;0;0;0;0;0;0
4595;Lageado;São Sebastião;50;0;0;0;50;0
4596;Lageado;Sétimo Céu;0;0;0;0;0;0
4597;Lageado;Teresópolis;50;0;0;0;50;0
4598;Lageado;Tristeza;100;0;62;23;0;100
4599;Lageado;Três Figueiras;50;0;23;13;0;50
4600;Lageado;Vila Assunção;0;0;0;0;0;0
4601;Lageado;Vila Conceição;0;0;0;0;0;0
4602;Lageado;Vila Ipiranga;100;0;25;9;50;50
4603;Lageado;Vila Jardim;50;0;25;21;0;50
4604;Lageado;Vila João Pessoa;50;0;27;11;0;50
4605;Lageado;Vila Nova;250;150;0;0;250;0
4606;Lami;Aberta dos Morros;0;0;0;0;0;0
4607;Lami;Agronomia;50;0;0;0;50;0
4608;Lami;Anchieta;0;0;0;0;0;0
4609;Lami;Arquipélago;100;0;32;5;50;50
4610;Lami;Auxiliadora;0;0;0;0;0;0
4611;Lami;Azenha;100;50;32;5;50;50
4612;Lami;Bela Vista;100;0;58;29;0;100
4613;Lami;Belém Novo;100;50;29;11;50;50
4614;Lami;Belém Velho;0;0;0;0;0;0
4615;Lami;Boa Vista;0;0;0;0;0;0
4616;Lami;Boa Vista do Sul;100;0;31;4;50;50
4617;Lami;Bom Fim;100;0;31;8;50;50
4618;Lami;Bom Jesus;150;0;98;21;0;150
4619;Lami;Camaquã;50;50;0;0;50;0
4620;Lami;Campo Novo;50;50;0;0;50;0
4621;Lami;Cascata;150;0;119;8;50;100
4622;Lami;Cavalhada;0;0;0;0;0;0
4623;Lami;Cel. Aparício Borges;150;0;88;21;0;150
4624;Lami;Centro Histórico;250;0;80;36;100;150
4625;Lami;Chapéu do Sol;100;0;52;13;0;100
4626;Lami;Chácara das Pedras;50;0;0;0;50;0
4627;Lami;Cidade Baixa;0;0;0;0;0;0
4628;Lami;Costa e Silva;100;0;29;13;50;50
4629;Lami;Cristal;0;0;0;0;0;0
4630;Lami;Cristo Redentor;0;0;0;0;0;0
4631;Lami;Espírito Santo;50;0;29;8;0;50
4632;Lami;Extrema;300;50;146;38;50;250
4633;Lami;Farrapos;50;50;0;0;50;0
4634;Lami;Farroupilha;0;0;0;0;0;0
4635;Lami;Floresta;0;0;0;0;0;0
4636;Lami;Glória;200;0;94;27;50;150
4637;Lami;Guarujá;0;0;0;0;0;0
4638;Lami;Higienópolis;50;50;0;0;50;0
4639;Lami;Humaitá;150;0;92;23;0;150
4640;Lami;Hípica;150;0;89;26;0;150
4641;Lami;Independência;0;0;0;0;0;0
4642;Lami;Ipanema;0;0;0;0;0;0
4643;Lami;Jardim Botânico;50;0;50;0;50;0
4644;Lami;Jardim Carvalho;100;0;62;20;0;100
4645;Lami;Jardim Europa;0;0;0;0;0;0
4646;Lami;Jardim Floresta;0;0;0;0;0;0
4647;Lami;Jardim Isabel;50;0;31;13;0;50
4648;Lami;Jardim Itú;50;0;30;15;0;50
4649;Lami;Jardim Leopoldina;0;0;0;0;0;0
4650;Lami;Jardim Lindóia;50;0;28;15;0;50
4651;Lami;Jardim Sabará;50;0;27;15;0;50
4652;Lami;Jardim São Pedro;0;0;0;0;0;0
4653;Lami;Jardim do Salso;0;0;0;0;0;0
4654;Lami;Lageado;800;0;465;108;50;750
4655;Lami;Lami;3000;0;1752;502;0;3000
4656;Lami;Lomba do Pinheiro;100;50;32;7;50;50
4657;Lami;Medianeira;0;0;0;0;0;0
4658;Lami;Menino Deus;0;0;0;0;0;0
4659;Lami;Moinhos de Vento;0;0;0;0;0;0
4660;Lami;Mont'Serrat;50;50;0;0;50;0
4661;Lami;Morro Santana;50;0;0;0;50;0
4662;Lami;Mário Quintana;100;50;0;0;100;0
4663;Lami;Navegantes;0;0;0;0;0;0
4664;Lami;Nonoai;100;50;0;0;100;0
4665;Lami;Parque Santa Fé;50;0;0;0;50;0
4666;Lami;Partenon;350;100;107;50;150;200
4667;Lami;Passo D'Areia;100;0;31;41;0;100
4668;Lami;Passo das Pedras;100;0;56;22;0;100
4669;Lami;Pedra Redonda;0;0;0;0;0;0
4670;Lami;Petrópolis;150;0;84;32;0;150
4671;Lami;Pitinga;150;0;87;18;0;150
4672;Lami;Ponta Grossa;0;0;0;0;0;0
4673;Lami;Praia de Belas;0;0;0;0;0;0
4674;Lami;Restinga;200;0;75;35;50;150
4675;Lami;Rio Branco;0;0;0;0;0;0
4676;Lami;Rubem Berta;250;100;80;57;100;150
4677;Lami;Santa Cecília;50;0;0;0;50;0
4678;Lami;Santa Maria Goretti;0;0;0;0;0;0
4679;Lami;Santa Rosa de Lima;100;0;79;9;50;50
4680;Lami;Santa Tereza;50;0;0;0;50;0
4681;Lami;Santana;100;0;26;19;50;50
4682;Lami;Santo Antônio;200;50;59;27;100;100
4683;Lami;Sarandi;200;0;30;13;150;50
4684;Lami;Serraria;0;0;0;0;0;0
4685;Lami;São Caetano;650;100;321;84;100;550
4686;Lami;São Geraldo;50;0;32;8;0;50
4687;Lami;São José;100;0;64;14;0;100
4688;Lami;São João;0;0;0;0;0;0
4689;Lami;São Sebastião;0;0;0;0;0;0
4690;Lami;Sétimo Céu;0;0;0;0;0;0
4691;Lami;Teresópolis;150;50;62;18;50;100
4692;Lami;Tristeza;0;0;0;0;0;0
4693;Lami;Três Figueiras;0;0;0;0;0;0
4694;Lami;Vila Assunção;0;0;0;0;0;0
4695;Lami;Vila Conceição;0;0;0;0;0;0
4696;Lami;Vila Ipiranga;100;0;32;10;50;50
4697;Lami;Vila Jardim;100;0;23;23;50;50
4698;Lami;Vila João Pessoa;150;0;90;32;0;150
4699;Lami;Vila Nova;250;0;93;23;100;150
4700;Lomba do Pinheiro;Aberta dos Morros;150;50;56;17;50;100
4701;Lomba do Pinheiro;Agronomia;5200;550;2522;601;1000;4200
4702;Lomba do Pinheiro;Anchieta;250;0;159;27;0;250
4703;Lomba do Pinheiro;Arquipélago;450;100;193;39;150;300
4704;Lomba do Pinheiro;Auxiliadora;100;0;30;7;50;50
4705;Lomba do Pinheiro;Azenha;50;50;0;0;50;0
4706;Lomba do Pinheiro;Bela Vista;150;0;105;30;0;150
4707;Lomba do Pinheiro;Belém Novo;50;0;32;8;0;50
4708;Lomba do Pinheiro;Belém Velho;1500;100;802;172;250;1250
4709;Lomba do Pinheiro;Boa Vista;150;0;95;22;0;150
4710;Lomba do Pinheiro;Boa Vista do Sul;350;100;119;34;150;200
4711;Lomba do Pinheiro;Bom Fim;100;50;0;0;100;0
4712;Lomba do Pinheiro;Bom Jesus;750;200;156;28;500;250
4713;Lomba do Pinheiro;Camaquã;150;0;53;27;50;100
4714;Lomba do Pinheiro;Campo Novo;250;50;91;31;100;150
4715;Lomba do Pinheiro;Cascata;1200;100;592;136;200;1000
4716;Lomba do Pinheiro;Cavalhada;50;0;28;8;0;50
4717;Lomba do Pinheiro;Cel. Aparício Borges;250;50;94;9;100;150
4718;Lomba do Pinheiro;Centro Histórico;200;0;104;34;0;200
4719;Lomba do Pinheiro;Chapéu do Sol;500;100;178;26;300;200
4720;Lomba do Pinheiro;Chácara das Pedras;200;0;69;13;100;100
4721;Lomba do Pinheiro;Cidade Baixa;50;0;28;7;0;50
4722;Lomba do Pinheiro;Costa e Silva;100;0;0;0;100;0
4723;Lomba do Pinheiro;Cristal;100;0;29;11;50;50
4724;Lomba do Pinheiro;Cristo Redentor;150;0;102;15;50;100
4725;Lomba do Pinheiro;Espírito Santo;0;0;0;0;0;0
4726;Lomba do Pinheiro;Extrema;50;0;31;4;0;50
4727;Lomba do Pinheiro;Farrapos;150;0;89;15;0;150
4728;Lomba do Pinheiro;Farroupilha;100;0;26;5;50;50
4729;Lomba do Pinheiro;Floresta;150;50;84;14;100;50
4730;Lomba do Pinheiro;Glória;700;50;367;103;50;650
4731;Lomba do Pinheiro;Guarujá;50;0;33;7;0;50
4732;Lomba do Pinheiro;Higienópolis;150;50;31;4;100;50
4733;Lomba do Pinheiro;Humaitá;150;0;90;12;0;150
4734;Lomba do Pinheiro;Hípica;200;100;30;2;150;50
4735;Lomba do Pinheiro;Independência;50;0;0;0;50;0
4736;Lomba do Pinheiro;Ipanema;0;0;0;0;0;0
4737;Lomba do Pinheiro;Jardim Botânico;500;0;278;51;50;450
4738;Lomba do Pinheiro;Jardim Carvalho;1400;150;649;148;350;1050
4739;Lomba do Pinheiro;Jardim Europa;100;0;28;5;50;50
4740;Lomba do Pinheiro;Jardim Floresta;100;0;60;15;0;100
4741;Lomba do Pinheiro;Jardim Isabel;200;0;118;29;0;200
4742;Lomba do Pinheiro;Jardim Itú;200;50;93;19;50;150
4743;Lomba do Pinheiro;Jardim Leopoldina;400;50;196;51;50;350
4744;Lomba do Pinheiro;Jardim Lindóia;50;0;0;0;50;0
4745;Lomba do Pinheiro;Jardim Sabará;500;100;227;52;100;400
4746;Lomba do Pinheiro;Jardim São Pedro;0;0;0;0;0;0
4747;Lomba do Pinheiro;Jardim do Salso;350;0;223;36;0;350
4748;Lomba do Pinheiro;Lageado;300;50;90;22;150;150
4749;Lomba do Pinheiro;Lami;100;50;32;7;50;50
4750;Lomba do Pinheiro;Lomba do Pinheiro;19000;1500;8688;2078;4100;14900
4751;Lomba do Pinheiro;Medianeira;200;0;116;42;0;200
4752;Lomba do Pinheiro;Menino Deus;0;0;0;0;0;0
4753;Lomba do Pinheiro;Moinhos de Vento;100;0;59;10;0;100
4754;Lomba do Pinheiro;Mont'Serrat;200;0;105;35;0;200
4755;Lomba do Pinheiro;Morro Santana;1150;50;564;142;200;950
4756;Lomba do Pinheiro;Mário Quintana;950;100;365;80;350;600
4757;Lomba do Pinheiro;Navegantes;150;0;32;3;100;50
4758;Lomba do Pinheiro;Nonoai;250;0;155;30;0;250
4759;Lomba do Pinheiro;Parque Santa Fé;250;50;57;18;150;100
4760;Lomba do Pinheiro;Partenon;250;50;57;13;150;100
4761;Lomba do Pinheiro;Passo D'Areia;50;0;0;0;50;0
4762;Lomba do Pinheiro;Passo das Pedras;150;50;59;16;50;100
4763;Lomba do Pinheiro;Pedra Redonda;150;50;60;15;50;100
4764;Lomba do Pinheiro;Petrópolis;750;150;341;134;200;550
4765;Lomba do Pinheiro;Pitinga;1750;200;826;198;350;1400
4766;Lomba do Pinheiro;Ponta Grossa;200;50;52;15;100;100
4767;Lomba do Pinheiro;Praia de Belas;100;0;70;13;0;100
4768;Lomba do Pinheiro;Restinga;1300;250;501;129;450;850
4769;Lomba do Pinheiro;Rio Branco;150;0;59;16;50;100
4770;Lomba do Pinheiro;Rubem Berta;200;0;106;36;0;200
4771;Lomba do Pinheiro;Santa Cecília;50;0;26;9;0;50
4772;Lomba do Pinheiro;Santa Maria Goretti;0;0;0;0;0;0
4773;Lomba do Pinheiro;Santa Rosa de Lima;100;50;0;0;100;0
4774;Lomba do Pinheiro;Santa Tereza;700;150;264;58;400;300
4775;Lomba do Pinheiro;Santana;50;0;0;0;50;0
4776;Lomba do Pinheiro;Santo Antônio;0;0;0;0;0;0
4777;Lomba do Pinheiro;Sarandi;100;50;30;12;50;50
4778;Lomba do Pinheiro;Serraria;150;0;60;11;50;100
4779;Lomba do Pinheiro;São Caetano;100;0;34;9;50;50
4780;Lomba do Pinheiro;São Geraldo;100;0;28;3;50;50
4781;Lomba do Pinheiro;São José;1000;250;404;98;350;650
4782;Lomba do Pinheiro;São João;400;100;115;39;200;200
4783;Lomba do Pinheiro;São Sebastião;200;0;115;30;0;200
4784;Lomba do Pinheiro;Sétimo Céu;100;50;22;9;50;50
4785;Lomba do Pinheiro;Teresópolis;50;0;27;5;0;50
4786;Lomba do Pinheiro;Tristeza;350;50;159;47;50;300
4787;Lomba do Pinheiro;Três Figueiras;300;100;113;27;100;200
4788;Lomba do Pinheiro;Vila Assunção;150;0;92;17;0;150
4789;Lomba do Pinheiro;Vila Conceição;150;0;88;27;0;150
4790;Lomba do Pinheiro;Vila Ipiranga;300;100;80;38;150;150
4791;Lomba do Pinheiro;Vila Jardim;100;0;56;13;0;100
4792;Lomba do Pinheiro;Vila João Pessoa;1300;50;683;153;150;1150
4793;Lomba do Pinheiro;Vila Nova;300;150;55;11;200;100
4794;Medianeira;Aberta dos Morros;100;0;63;20;0;100
4795;Medianeira;Agronomia;100;0;49;33;0;100
4796;Medianeira;Anchieta;50;50;0;0;50;0
4797;Medianeira;Arquipélago;50;0;26;7;0;50
4798;Medianeira;Auxiliadora;50;0;0;0;50;0
4799;Medianeira;Azenha;3150;550;1151;527;1100;2050
4800;Medianeira;Bela Vista;200;100;56;26;100;100
4801;Medianeira;Belém Novo;0;0;0;0;0;0
4802;Medianeira;Belém Velho;0;0;0;0;0;0
4803;Medianeira;Boa Vista;100;0;57;20;0;100
4804;Medianeira;Boa Vista do Sul;50;0;26;13;0;50
4805;Medianeira;Bom Fim;100;0;56;23;0;100
4806;Medianeira;Bom Jesus;0;0;0;0;0;0
4807;Medianeira;Camaquã;450;150;166;51;250;200
4808;Medianeira;Campo Novo;50;0;0;0;50;0
4809;Medianeira;Cascata;150;0;75;35;0;150
4810;Medianeira;Cavalhada;150;0;68;23;50;100
4811;Medianeira;Cel. Aparício Borges;250;150;53;16;150;100
4812;Medianeira;Centro Histórico;350;100;72;44;200;150
4813;Medianeira;Chapéu do Sol;0;0;0;0;0;0
4814;Medianeira;Chácara das Pedras;0;0;0;0;0;0
4815;Medianeira;Cidade Baixa;300;0;78;41;150;150
4816;Medianeira;Costa e Silva;100;50;31;8;50;50
4817;Medianeira;Cristal;300;100;89;28;150;150
4818;Medianeira;Cristo Redentor;0;0;0;0;0;0
4819;Medianeira;Espírito Santo;0;0;0;0;0;0
4820;Medianeira;Extrema;50;0;26;13;0;50
4821;Medianeira;Farrapos;0;0;0;0;0;0
4822;Medianeira;Farroupilha;100;0;32;14;50;50
4823;Medianeira;Floresta;0;0;0;0;0;0
4824;Medianeira;Glória;400;50;118;38;200;200
4825;Medianeira;Guarujá;50;0;39;3;0;50
4826;Medianeira;Higienópolis;100;0;60;24;0;100
4827;Medianeira;Humaitá;50;0;31;8;0;50
4828;Medianeira;Hípica;250;50;103;25;100;150
4829;Medianeira;Independência;200;0;109;44;0;200
4830;Medianeira;Ipanema;100;50;26;9;50;50
4831;Medianeira;Jardim Botânico;200;50;80;37;50;150
4832;Medianeira;Jardim Carvalho;100;50;42;2;50;50
4833;Medianeira;Jardim Europa;0;0;0;0;0;0
4834;Medianeira;Jardim Floresta;0;0;0;0;0;0
4835;Medianeira;Jardim Isabel;0;0;0;0;0;0
4836;Medianeira;Jardim Itú;100;0;34;12;50;50
4837;Medianeira;Jardim Leopoldina;100;0;58;28;0;100
4838;Medianeira;Jardim Lindóia;50;0;31;8;0;50
4839;Medianeira;Jardim Sabará;0;0;0;0;0;0
4840;Medianeira;Jardim São Pedro;50;50;0;0;50;0
4841;Medianeira;Jardim do Salso;50;0;0;0;50;0
4842;Medianeira;Lageado;0;0;0;0;0;0
4843;Medianeira;Lami;0;0;0;0;0;0
4844;Medianeira;Lomba do Pinheiro;200;0;116;42;0;200
4845;Medianeira;Medianeira;10340;2800;3450;1756;4240;6100
4846;Medianeira;Menino Deus;500;100;192;90;150;350
4847;Medianeira;Moinhos de Vento;50;0;30;11;0;50
4848;Medianeira;Mont'Serrat;150;0;97;32;0;150
4849;Medianeira;Morro Santana;0;0;0;0;0;0
4850;Medianeira;Mário Quintana;0;0;0;0;0;0
4851;Medianeira;Navegantes;100;100;0;0;100;0
4852;Medianeira;Nonoai;550;100;256;121;100;450
4853;Medianeira;Parque Santa Fé;50;50;0;0;50;0
4854;Medianeira;Partenon;4350;500;2056;797;800;3550
4855;Medianeira;Passo D'Areia;250;50;79;56;50;200
4856;Medianeira;Passo das Pedras;150;0;51;22;50;100
4857;Medianeira;Pedra Redonda;0;0;0;0;0;0
4858;Medianeira;Petrópolis;400;100;180;72;100;300
4859;Medianeira;Pitinga;100;50;28;10;50;50
4860;Medianeira;Ponta Grossa;50;0;31;6;0;50
4861;Medianeira;Praia de Belas;200;50;59;25;100;100
4862;Medianeira;Restinga;50;0;28;7;0;50
4863;Medianeira;Rio Branco;250;0;129;68;0;250
4864;Medianeira;Rubem Berta;50;0;30;18;0;50
4865;Medianeira;Santa Cecília;300;100;106;52;100;200
4866;Medianeira;Santa Maria Goretti;0;0;0;0;0;0
4867;Medianeira;Santa Rosa de Lima;50;0;28;11;0;50
4868;Medianeira;Santa Tereza;4500;2200;591;199;3500;1000
4869;Medianeira;Santana;650;100;249;101;350;300
4870;Medianeira;Santo Antônio;1200;200;309;123;700;500
4871;Medianeira;Sarandi;50;0;0;0;50;0
4872;Medianeira;Serraria;50;50;0;0;50;0
4873;Medianeira;São Caetano;50;0;0;0;50;0
4874;Medianeira;São Geraldo;100;0;0;0;100;0
4875;Medianeira;São José;50;0;32;11;0;50
4876;Medianeira;São João;150;0;57;19;50;100
4877;Medianeira;São Sebastião;0;0;0;0;0;0
4878;Medianeira;Sétimo Céu;50;0;30;9;0;50
4879;Medianeira;Teresópolis;350;50;115;50;150;200
4880;Medianeira;Tristeza;200;0;91;55;50;150
4881;Medianeira;Três Figueiras;100;50;30;8;50;50
4882;Medianeira;Vila Assunção;150;0;55;23;50;100
4883;Medianeira;Vila Conceição;0;0;0;0;0;0
4884;Medianeira;Vila Ipiranga;50;0;23;24;0;50
4885;Medianeira;Vila Jardim;50;50;0;0;50;0
4886;Medianeira;Vila João Pessoa;100;50;30;16;50;50
4887;Medianeira;Vila Nova;150;100;31;11;100;50
4888;Menino Deus;Aberta dos Morros;200;0;59;26;100;100
4889;Menino Deus;Agronomia;50;0;27;12;0;50
4890;Menino Deus;Anchieta;50;0;29;9;0;50
4891;Menino Deus;Arquipélago;400;50;211;83;50;350
4892;Menino Deus;Auxiliadora;400;100;158;58;200;200
4893;Menino Deus;Azenha;1850;300;706;348;650;1200
4894;Menino Deus;Bela Vista;650;150;199;112;300;350
4895;Menino Deus;Belém Novo;200;0;82;39;50;150
4896;Menino Deus;Belém Velho;200;100;56;24;100;100
4897;Menino Deus;Boa Vista;150;0;81;35;0;150
4898;Menino Deus;Boa Vista do Sul;200;0;53;23;100;100
4899;Menino Deus;Bom Fim;700;100;270;162;200;500
4900;Menino Deus;Bom Jesus;50;0;28;6;0;50
4901;Menino Deus;Camaquã;150;50;30;12;100;50
4902;Menino Deus;Campo Novo;150;0;102;26;0;150
4903;Menino Deus;Cascata;150;0;64;20;50;100
4904;Menino Deus;Cavalhada;350;50;164;87;50;300
4905;Menino Deus;Cel. Aparício Borges;350;0;159;57;100;250
4906;Menino Deus;Centro Histórico;1650;350;350;140;1150;500
4907;Menino Deus;Chapéu do Sol;150;100;28;12;100;50
4908;Menino Deus;Chácara das Pedras;250;0;151;74;0;250
4909;Menino Deus;Cidade Baixa;11350;1000;4958;2535;2350;9000
4910;Menino Deus;Costa e Silva;200;0;116;47;0;200
4911;Menino Deus;Cristal;450;0;212;88;50;400
4912;Menino Deus;Cristo Redentor;0;0;0;0;0;0
4913;Menino Deus;Espírito Santo;50;0;29;20;0;50
4914;Menino Deus;Extrema;100;50;21;18;50;50
4915;Menino Deus;Farrapos;0;0;0;0;0;0
4916;Menino Deus;Farroupilha;2800;250;1164;648;650;2150
4917;Menino Deus;Floresta;300;50;100;61;100;200
4918;Menino Deus;Glória;150;50;56;23;50;100
4919;Menino Deus;Guarujá;200;0;55;35;100;100
4920;Menino Deus;Higienópolis;0;0;0;0;0;0
4921;Menino Deus;Humaitá;150;0;60;30;50;100
4922;Menino Deus;Hípica;100;0;42;34;0;100
4923;Menino Deus;Independência;350;50;72;48;200;150
4924;Menino Deus;Ipanema;50;0;25;16;0;50
4925;Menino Deus;Jardim Botânico;400;150;133;38;250;150
4926;Menino Deus;Jardim Carvalho;250;100;53;26;150;100
4927;Menino Deus;Jardim Europa;150;0;55;31;50;100
4928;Menino Deus;Jardim Floresta;100;50;0;0;100;0
4929;Menino Deus;Jardim Isabel;150;0;60;22;50;100
4930;Menino Deus;Jardim Itú;150;0;63;24;50;100
4931;Menino Deus;Jardim Leopoldina;50;0;0;0;50;0
4932;Menino Deus;Jardim Lindóia;50;0;20;15;0;50
4933;Menino Deus;Jardim Sabará;100;0;23;10;50;50
4934;Menino Deus;Jardim São Pedro;100;0;28;12;50;50
4935;Menino Deus;Jardim do Salso;100;0;79;15;50;50
4936;Menino Deus;Lageado;450;100;91;65;250;200
4937;Menino Deus;Lami;0;0;0;0;0;0
4938;Menino Deus;Lomba do Pinheiro;0;0;0;0;0;0
4939;Menino Deus;Medianeira;500;100;192;90;150;350
4940;Menino Deus;Menino Deus;6100;2800;616;208;5500;600
4941;Menino Deus;Moinhos de Vento;400;100;137;77;150;250
4942;Menino Deus;Mont'Serrat;400;150;62;31;300;100
4943;Menino Deus;Morro Santana;250;100;64;25;150;100
4944;Menino Deus;Mário Quintana;200;50;79;28;50;150
4945;Menino Deus;Navegantes;0;0;0;0;0;0
4946;Menino Deus;Nonoai;400;50;161;66;100;300
4947;Menino Deus;Parque Santa Fé;50;0;24;21;0;50
4948;Menino Deus;Partenon;600;100;249;111;150;450
4949;Menino Deus;Passo D'Areia;500;0;197;130;100;400
4950;Menino Deus;Passo das Pedras;100;50;30;5;50;50
4951;Menino Deus;Pedra Redonda;50;0;25;16;0;50
4952;Menino Deus;Petrópolis;400;50;145;80;100;300
4953;Menino Deus;Pitinga;50;0;23;15;0;50
4954;Menino Deus;Ponta Grossa;50;0;24;11;0;50
4955;Menino Deus;Praia de Belas;2850;200;1309;620;500;2350
4956;Menino Deus;Restinga;300;100;81;36;150;150
4957;Menino Deus;Rio Branco;950;100;222;152;500;450
4958;Menino Deus;Rubem Berta;300;50;84;38;150;150
4959;Menino Deus;Santa Cecília;750;50;259;156;250;500
4960;Menino Deus;Santa Maria Goretti;300;0;44;29;200;100
4961;Menino Deus;Santa Rosa de Lima;300;150;58;32;200;100
4962;Menino Deus;Santa Tereza;1450;250;617;215;500;950
4963;Menino Deus;Santana;1200;150;380;209;450;750
4964;Menino Deus;Santo Antônio;900;150;255;113;450;450
4965;Menino Deus;Sarandi;1050;150;461;222;200;850
4966;Menino Deus;Serraria;200;0;115;49;0;200
4967;Menino Deus;São Caetano;50;0;28;20;0;50
4968;Menino Deus;São Geraldo;150;0;85;43;0;150
4969;Menino Deus;São José;50;50;0;0;50;0
4970;Menino Deus;São João;400;0;192;83;150;250
4971;Menino Deus;São Sebastião;250;0;138;59;0;250
4972;Menino Deus;Sétimo Céu;50;0;28;17;0;50
4973;Menino Deus;Teresópolis;100;50;31;17;50;50
4974;Menino Deus;Tristeza;250;0;132;68;0;250
4975;Menino Deus;Três Figueiras;100;0;30;20;50;50
4976;Menino Deus;Vila Assunção;100;0;52;29;0;100
4977;Menino Deus;Vila Conceição;100;0;22;13;50;50
4978;Menino Deus;Vila Ipiranga;350;100;153;50;100;250
4979;Menino Deus;Vila Jardim;100;50;0;0;100;0
4980;Menino Deus;Vila João Pessoa;100;100;0;0;100;0
4981;Menino Deus;Vila Nova;150;100;35;7;100;50
4982;Moinhos de Vento;Aberta dos Morros;50;0;32;9;0;50
4983;Moinhos de Vento;Agronomia;0;0;0;0;0;0
4984;Moinhos de Vento;Anchieta;50;0;0;0;50;0
4985;Moinhos de Vento;Arquipélago;100;0;50;16;0;100
4986;Moinhos de Vento;Auxiliadora;850;150;181;101;600;250
4987;Moinhos de Vento;Azenha;500;0;167;98;150;350
4988;Moinhos de Vento;Bela Vista;500;200;134;106;200;300
4989;Moinhos de Vento;Belém Novo;200;50;76;41;50;150
4990;Moinhos de Vento;Belém Velho;50;0;0;0;50;0
4991;Moinhos de Vento;Boa Vista;300;0;143;66;50;250
4992;Moinhos de Vento;Boa Vista do Sul;100;50;0;0;100;0
4993;Moinhos de Vento;Bom Fim;1400;250;477;295;450;950
4994;Moinhos de Vento;Bom Jesus;250;0;100;62;50;200
4995;Moinhos de Vento;Camaquã;50;0;31;9;0;50
4996;Moinhos de Vento;Campo Novo;50;0;32;8;0;50
4997;Moinhos de Vento;Cascata;50;0;0;0;50;0
4998;Moinhos de Vento;Cavalhada;200;100;52;26;100;100
4999;Moinhos de Vento;Cel. Aparício Borges;100;0;56;30;0;100
5000;Moinhos de Vento;Centro Histórico;2400;150;1036;545;300;2100
5001;Moinhos de Vento;Chapéu do Sol;50;0;24;13;0;50
5002;Moinhos de Vento;Chácara das Pedras;100;50;26;23;50;50
5003;Moinhos de Vento;Cidade Baixa;450;150;51;29;350;100
5004;Moinhos de Vento;Costa e Silva;50;0;0;0;50;0
5005;Moinhos de Vento;Cristal;200;0;84;42;50;150
5006;Moinhos de Vento;Cristo Redentor;50;0;30;15;0;50
5007;Moinhos de Vento;Espírito Santo;100;0;18;23;50;50
5008;Moinhos de Vento;Extrema;0;0;0;0;0;0
5009;Moinhos de Vento;Farrapos;200;0;110;58;0;200
5010;Moinhos de Vento;Farroupilha;400;50;144;95;100;300
5011;Moinhos de Vento;Floresta;1950;50;869;474;350;1600
5012;Moinhos de Vento;Glória;100;0;0;0;100;0
5013;Moinhos de Vento;Guarujá;50;0;28;9;0;50
5014;Moinhos de Vento;Higienópolis;100;0;53;33;0;100
5015;Moinhos de Vento;Humaitá;100;0;65;13;0;100
5016;Moinhos de Vento;Hípica;100;0;0;0;100;0
5017;Moinhos de Vento;Independência;950;150;348;253;250;700
5018;Moinhos de Vento;Ipanema;0;0;0;0;0;0
5019;Moinhos de Vento;Jardim Botânico;200;0;73;54;50;150
5020;Moinhos de Vento;Jardim Carvalho;100;0;59;31;0;100
5021;Moinhos de Vento;Jardim Europa;50;0;29;18;0;50
5022;Moinhos de Vento;Jardim Floresta;100;100;0;0;100;0
5023;Moinhos de Vento;Jardim Isabel;0;0;0;0;0;0
5024;Moinhos de Vento;Jardim Itú;150;50;58;28;50;100
5025;Moinhos de Vento;Jardim Leopoldina;50;50;0;0;50;0
5026;Moinhos de Vento;Jardim Lindóia;100;0;45;42;0;100
5027;Moinhos de Vento;Jardim Sabará;200;0;83;44;50;150
5028;Moinhos de Vento;Jardim São Pedro;0;0;0;0;0;0
5029;Moinhos de Vento;Jardim do Salso;100;0;50;48;0;100
5030;Moinhos de Vento;Lageado;50;0;0;0;50;0
5031;Moinhos de Vento;Lami;0;0;0;0;0;0
5032;Moinhos de Vento;Lomba do Pinheiro;100;0;59;10;0;100
5033;Moinhos de Vento;Medianeira;50;0;30;11;0;50
5034;Moinhos de Vento;Menino Deus;400;100;137;77;150;250
5035;Moinhos de Vento;Moinhos de Vento;5300;400;1908;1672;1100;4200
5036;Moinhos de Vento;Mont'Serrat;550;100;146;94;250;300
5037;Moinhos de Vento;Morro Santana;50;0;33;9;0;50
5038;Moinhos de Vento;Mário Quintana;200;50;84;34;50;150
5039;Moinhos de Vento;Navegantes;100;50;20;18;50;50
5040;Moinhos de Vento;Nonoai;100;0;57;17;0;100
5041;Moinhos de Vento;Parque Santa Fé;50;0;22;27;0;50
5042;Moinhos de Vento;Partenon;300;150;75;37;150;150
5043;Moinhos de Vento;Passo D'Areia;500;0;215;101;200;300
5044;Moinhos de Vento;Passo das Pedras;0;0;0;0;0;0
5045;Moinhos de Vento;Pedra Redonda;0;0;0;0;0;0
5046;Moinhos de Vento;Petrópolis;400;50;116;63;200;200
5047;Moinhos de Vento;Pitinga;50;0;27;11;0;50
5048;Moinhos de Vento;Ponta Grossa;0;0;0;0;0;0
5049;Moinhos de Vento;Praia de Belas;0;0;0;0;0;0
5050;Moinhos de Vento;Restinga;50;50;0;0;50;0
5051;Moinhos de Vento;Rio Branco;2700;400;966;631;1100;1600
5052;Moinhos de Vento;Rubem Berta;100;0;48;36;0;100
5053;Moinhos de Vento;Santa Cecília;400;50;187;73;150;250
5054;Moinhos de Vento;Santa Maria Goretti;150;100;0;0;150;0
5055;Moinhos de Vento;Santa Rosa de Lima;150;50;53;14;50;100
5056;Moinhos de Vento;Santa Tereza;350;50;140;69;100;250
5057;Moinhos de Vento;Santana;400;100;139;72;150;250
5058;Moinhos de Vento;Santo Antônio;200;0;122;51;50;150
5059;Moinhos de Vento;Sarandi;450;100;194;103;100;350
5060;Moinhos de Vento;Serraria;50;0;23;20;0;50
5061;Moinhos de Vento;São Caetano;50;50;0;0;50;0
5062;Moinhos de Vento;São Geraldo;600;150;188;113;250;350
5063;Moinhos de Vento;São José;150;0;38;49;50;100
5064;Moinhos de Vento;São João;750;100;307;185;150;600
5065;Moinhos de Vento;São Sebastião;50;0;24;15;0;50
5066;Moinhos de Vento;Sétimo Céu;0;0;0;0;0;0
5067;Moinhos de Vento;Teresópolis;50;0;31;18;0;50
5068;Moinhos de Vento;Tristeza;0;0;0;0;0;0
5069;Moinhos de Vento;Três Figueiras;450;50;199;147;50;400
5070;Moinhos de Vento;Vila Assunção;50;0;30;11;0;50
5071;Moinhos de Vento;Vila Conceição;0;0;0;0;0;0
5072;Moinhos de Vento;Vila Ipiranga;100;0;46;43;0;100
5073;Moinhos de Vento;Vila Jardim;150;50;43;26;50;100
5074;Moinhos de Vento;Vila João Pessoa;0;0;0;0;0;0
5075;Moinhos de Vento;Vila Nova;100;0;50;27;0;100
5076;Mont'Serrat;Aberta dos Morros;0;0;0;0;0;0
5077;Mont'Serrat;Agronomia;100;0;28;11;50;50
5078;Mont'Serrat;Anchieta;100;0;58;19;0;100
5079;Mont'Serrat;Arquipélago;100;50;34;14;50;50
5080;Mont'Serrat;Auxiliadora;2800;150;1469;665;400;2400
5081;Mont'Serrat;Azenha;250;0;133;62;0;250
5082;Mont'Serrat;Bela Vista;1800;300;770;337;500;1300
5083;Mont'Serrat;Belém Novo;0;0;0;0;0;0
5084;Mont'Serrat;Belém Velho;100;50;0;0;100;0
5085;Mont'Serrat;Boa Vista;850;150;392;164;150;700
5086;Mont'Serrat;Boa Vista do Sul;0;0;0;0;0;0
5087;Mont'Serrat;Bom Fim;50;0;32;9;0;50
5088;Mont'Serrat;Bom Jesus;200;50;79;23;50;150
5089;Mont'Serrat;Camaquã;50;0;27;17;0;50
5090;Mont'Serrat;Campo Novo;0;0;0;0;0;0
5091;Mont'Serrat;Cascata;150;0;90;27;0;150
5092;Mont'Serrat;Cavalhada;250;50;112;49;50;200
5093;Mont'Serrat;Cel. Aparício Borges;100;0;31;4;50;50
5094;Mont'Serrat;Centro Histórico;450;100;117;82;200;250
5095;Mont'Serrat;Chapéu do Sol;0;0;0;0;0;0
5096;Mont'Serrat;Chácara das Pedras;100;0;51;30;0;100
5097;Mont'Serrat;Cidade Baixa;300;50;102;54;100;200
5098;Mont'Serrat;Costa e Silva;100;0;54;16;0;100
5099;Mont'Serrat;Cristal;300;50;89;28;150;150
5100;Mont'Serrat;Cristo Redentor;350;0;230;66;0;350
5101;Mont'Serrat;Espírito Santo;0;0;0;0;0;0
5102;Mont'Serrat;Extrema;50;50;0;0;50;0
5103;Mont'Serrat;Farrapos;100;0;27;12;50;50
5104;Mont'Serrat;Farroupilha;50;0;36;7;0;50
5105;Mont'Serrat;Floresta;300;50;90;42;150;150
5106;Mont'Serrat;Glória;0;0;0;0;0;0
5107;Mont'Serrat;Guarujá;0;0;0;0;0;0
5108;Mont'Serrat;Higienópolis;1015;50;475;201;215;800
5109;Mont'Serrat;Humaitá;0;0;0;0;0;0
5110;Mont'Serrat;Hípica;50;0;25;13;0;50
5111;Mont'Serrat;Independência;250;50;109;61;50;200
5112;Mont'Serrat;Ipanema;0;0;0;0;0;0
5113;Mont'Serrat;Jardim Botânico;450;100;190;76;100;350
5114;Mont'Serrat;Jardim Carvalho;200;150;33;4;150;50
5115;Mont'Serrat;Jardim Europa;50;0;34;12;0;50
5116;Mont'Serrat;Jardim Floresta;250;50;97;38;100;150
5117;Mont'Serrat;Jardim Isabel;0;0;0;0;0;0
5118;Mont'Serrat;Jardim Itú;50;0;0;0;50;0
5119;Mont'Serrat;Jardim Leopoldina;200;100;59;19;100;100
5120;Mont'Serrat;Jardim Lindóia;50;0;30;14;0;50
5121;Mont'Serrat;Jardim Sabará;50;50;0;0;50;0
5122;Mont'Serrat;Jardim São Pedro;200;0;61;34;100;100
5123;Mont'Serrat;Jardim do Salso;0;0;0;0;0;0
5124;Mont'Serrat;Lageado;0;0;0;0;0;0
5125;Mont'Serrat;Lami;50;50;0;0;50;0
5126;Mont'Serrat;Lomba do Pinheiro;200;0;105;35;0;200
5127;Mont'Serrat;Medianeira;150;0;97;32;0;150
5128;Mont'Serrat;Menino Deus;400;150;62;31;300;100
5129;Mont'Serrat;Moinhos de Vento;550;100;146;94;250;300
5130;Mont'Serrat;Mont'Serrat;6000;1900;1198;438;4000;2000
5131;Mont'Serrat;Morro Santana;150;50;31;9;100;50
5132;Mont'Serrat;Mário Quintana;300;50;54;13;200;100
5133;Mont'Serrat;Navegantes;200;0;120;34;0;200
5134;Mont'Serrat;Nonoai;50;50;0;0;50;0
5135;Mont'Serrat;Parque Santa Fé;0;0;0;0;0;0
5136;Mont'Serrat;Partenon;300;100;81;31;150;150
5137;Mont'Serrat;Passo D'Areia;950;150;186;198;450;500
5138;Mont'Serrat;Passo das Pedras;100;0;54;28;0;100
5139;Mont'Serrat;Pedra Redonda;50;0;30;11;0;50
5140;Mont'Serrat;Petrópolis;2150;800;213;93;1800;350
5141;Mont'Serrat;Pitinga;0;0;0;0;0;0
5142;Mont'Serrat;Ponta Grossa;100;0;75;25;0;100
5143;Mont'Serrat;Praia de Belas;100;100;0;0;100;0
5144;Mont'Serrat;Restinga;50;50;0;0;50;0
5145;Mont'Serrat;Rio Branco;400;50;150;81;150;250
5146;Mont'Serrat;Rubem Berta;300;50;98;60;100;200
5147;Mont'Serrat;Santa Cecília;100;0;52;24;0;100
5148;Mont'Serrat;Santa Maria Goretti;150;0;101;8;0;150
5149;Mont'Serrat;Santa Rosa de Lima;250;50;87;32;100;150
5150;Mont'Serrat;Santa Tereza;150;50;29;9;100;50
5151;Mont'Serrat;Santana;400;100;80;36;250;150
5152;Mont'Serrat;Santo Antônio;0;0;0;0;0;0
5153;Mont'Serrat;Sarandi;100;50;0;0;100;0
5154;Mont'Serrat;Serraria;0;0;0;0;0;0
5155;Mont'Serrat;São Caetano;0;0;0;0;0;0
5156;Mont'Serrat;São Geraldo;0;0;0;0;0;0
5157;Mont'Serrat;São José;50;50;0;0;50;0
5158;Mont'Serrat;São João;1100;100;471;219;300;800
5159;Mont'Serrat;São Sebastião;150;0;51;23;50;100
5160;Mont'Serrat;Sétimo Céu;0;0;0;0;0;0
5161;Mont'Serrat;Teresópolis;50;0;25;12;0;50
5162;Mont'Serrat;Tristeza;0;0;0;0;0;0
5163;Mont'Serrat;Três Figueiras;1800;150;890;348;300;1500
5164;Mont'Serrat;Vila Assunção;0;0;0;0;0;0
5165;Mont'Serrat;Vila Conceição;0;0;0;0;0;0
5166;Mont'Serrat;Vila Ipiranga;200;0;31;16;150;50
5167;Mont'Serrat;Vila Jardim;100;0;55;32;0;100
5168;Mont'Serrat;Vila João Pessoa;200;50;89;33;50;150
5169;Mont'Serrat;Vila Nova;100;50;0;0;100;0
5170;Morro Santana;Aberta dos Morros;100;50;27;12;50;50
5171;Morro Santana;Agronomia;550;0;338;89;0;550
5172;Morro Santana;Anchieta;50;0;28;5;0;50
5173;Morro Santana;Arquipélago;50;0;31;8;0;50
5174;Morro Santana;Auxiliadora;200;0;109;48;0;200
5175;Morro Santana;Azenha;150;50;57;19;50;100
5176;Morro Santana;Bela Vista;50;0;33;8;0;50
5177;Morro Santana;Belém Novo;150;0;30;10;100;50
5178;Morro Santana;Belém Velho;100;50;0;0;100;0
5179;Morro Santana;Boa Vista;150;0;96;29;0;150
5180;Morro Santana;Boa Vista do Sul;150;50;31;12;100;50
5181;Morro Santana;Bom Fim;0;0;0;0;0;0
5182;Morro Santana;Bom Jesus;1350;150;698;179;300;1050
5183;Morro Santana;Camaquã;50;0;0;0;50;0
5184;Morro Santana;Campo Novo;100;0;57;18;0;100
5185;Morro Santana;Cascata;200;50;88;22;50;150
5186;Morro Santana;Cavalhada;250;50;122;42;50;200
5187;Morro Santana;Cel. Aparício Borges;150;100;30;12;100;50
5188;Morro Santana;Centro Histórico;150;50;53;21;50;100
5189;Morro Santana;Chapéu do Sol;50;0;36;3;0;50
5190;Morro Santana;Chácara das Pedras;200;0;84;36;50;150
5191;Morro Santana;Cidade Baixa;100;0;55;15;0;100
5192;Morro Santana;Costa e Silva;300;0;125;36;100;200
5193;Morro Santana;Cristal;150;50;55;20;50;100
5194;Morro Santana;Cristo Redentor;300;100;83;34;150;150
5195;Morro Santana;Espírito Santo;0;0;0;0;0;0
5196;Morro Santana;Extrema;250;50;121;39;50;200
5197;Morro Santana;Farrapos;0;0;0;0;0;0
5198;Morro Santana;Farroupilha;50;50;0;0;50;0
5199;Morro Santana;Floresta;50;0;29;13;0;50
5200;Morro Santana;Glória;0;0;0;0;0;0
5201;Morro Santana;Guarujá;100;0;64;23;0;100
5202;Morro Santana;Higienópolis;200;100;55;20;100;100
5203;Morro Santana;Humaitá;50;50;0;0;50;0
5204;Morro Santana;Hípica;150;0;63;17;50;100
5205;Morro Santana;Independência;0;0;0;0;0;0
5206;Morro Santana;Ipanema;0;0;0;0;0;0
5207;Morro Santana;Jardim Botânico;100;50;30;14;50;50
5208;Morro Santana;Jardim Carvalho;800;250;315;88;350;450
5209;Morro Santana;Jardim Europa;200;0;112;36;0;200
5210;Morro Santana;Jardim Floresta;100;50;0;0;100;0
5211;Morro Santana;Jardim Isabel;150;0;91;25;0;150
5212;Morro Santana;Jardim Itú;550;50;231;75;200;350
5213;Morro Santana;Jardim Leopoldina;800;100;264;88;350;450
5214;Morro Santana;Jardim Lindóia;100;0;61;26;0;100
5215;Morro Santana;Jardim Sabará;1050;100;509;197;150;900
5216;Morro Santana;Jardim São Pedro;150;50;63;17;50;100
5217;Morro Santana;Jardim do Salso;50;0;0;0;50;0
5218;Morro Santana;Lageado;100;0;28;9;50;50
5219;Morro Santana;Lami;50;0;0;0;50;0
5220;Morro Santana;Lomba do Pinheiro;1150;50;564;142;200;950
5221;Morro Santana;Medianeira;0;0;0;0;0;0
5222;Morro Santana;Menino Deus;250;100;64;25;150;100
5223;Morro Santana;Moinhos de Vento;50;0;33;9;0;50
5224;Morro Santana;Mont'Serrat;150;50;31;9;100;50
5225;Morro Santana;Morro Santana;11300;2400;4740;1310;4200;7100
5226;Morro Santana;Mário Quintana;2250;650;786;139;1300;950
5227;Morro Santana;Navegantes;50;0;25;12;0;50
5228;Morro Santana;Nonoai;0;0;0;0;0;0
5229;Morro Santana;Parque Santa Fé;800;50;325;115;250;550
5230;Morro Santana;Partenon;250;50;35;5;200;50
5231;Morro Santana;Passo D'Areia;200;50;68;41;50;150
5232;Morro Santana;Passo das Pedras;2500;100;1225;391;450;2050
5233;Morro Santana;Pedra Redonda;0;0;0;0;0;0
5234;Morro Santana;Petrópolis;50;50;0;0;50;0
5235;Morro Santana;Pitinga;150;50;64;13;50;100
5236;Morro Santana;Ponta Grossa;200;50;99;30;100;100
5237;Morro Santana;Praia de Belas;50;0;50;0;50;0
5238;Morro Santana;Restinga;100;0;49;16;0;100
5239;Morro Santana;Rio Branco;100;0;53;18;0;100
5240;Morro Santana;Rubem Berta;1450;200;605;431;300;1150
5241;Morro Santana;Santa Cecília;100;0;51;28;0;100
5242;Morro Santana;Santa Maria Goretti;200;0;105;43;0;200
5243;Morro Santana;Santa Rosa de Lima;250;50;69;17;150;100
5244;Morro Santana;Santa Tereza;250;50;51;15;150;100
5245;Morro Santana;Santana;50;0;0;0;50;0
5246;Morro Santana;Santo Antônio;100;0;59;17;0;100
5247;Morro Santana;Sarandi;450;0;263;105;50;400
5248;Morro Santana;Serraria;50;0;32;2;0;50
5249;Morro Santana;São Caetano;150;50;60;14;50;100
5250;Morro Santana;São Geraldo;50;0;34;5;0;50
5251;Morro Santana;São José;150;0;55;16;50;100
5252;Morro Santana;São João;100;0;30;9;50;50
5253;Morro Santana;São Sebastião;150;50;0;0;150;0
5254;Morro Santana;Sétimo Céu;50;0;0;0;50;0
5255;Morro Santana;Teresópolis;50;0;30;11;0;50
5256;Morro Santana;Tristeza;50;50;0;0;50;0
5257;Morro Santana;Três Figueiras;50;0;50;0;50;0
5258;Morro Santana;Vila Assunção;50;0;30;9;0;50
5259;Morro Santana;Vila Conceição;50;0;26;7;0;50
5260;Morro Santana;Vila Ipiranga;500;100;103;39;300;200
5261;Morro Santana;Vila Jardim;100;50;30;7;50;50
5262;Morro Santana;Vila João Pessoa;150;0;56;20;50;100
5263;Morro Santana;Vila Nova;50;0;36;8;0;50
5264;Mário Quintana;Aberta dos Morros;50;50;0;0;50;0
5265;Mário Quintana;Agronomia;250;50;92;14;100;150
5266;Mário Quintana;Anchieta;50;0;36;4;0;50
5267;Mário Quintana;Arquipélago;150;0;96;18;0;150
5268;Mário Quintana;Auxiliadora;50;50;0;0;50;0
5269;Mário Quintana;Azenha;100;0;60;10;0;100
5270;Mário Quintana;Bela Vista;50;0;34;5;0;50
5271;Mário Quintana;Belém Novo;0;0;0;0;0;0
5272;Mário Quintana;Belém Velho;350;50;171;31;50;300
5273;Mário Quintana;Boa Vista;150;100;34;3;100;50
5274;Mário Quintana;Boa Vista do Sul;150;0;93;15;0;150
5275;Mário Quintana;Bom Fim;50;50;0;0;50;0
5276;Mário Quintana;Bom Jesus;450;0;247;49;50;400
5277;Mário Quintana;Camaquã;50;0;0;0;50;0
5278;Mário Quintana;Campo Novo;50;0;29;9;0;50
5279;Mário Quintana;Cascata;250;0;114;22;50;200
5280;Mário Quintana;Cavalhada;50;0;28;8;0;50
5281;Mário Quintana;Cel. Aparício Borges;50;0;30;7;0;50
5282;Mário Quintana;Centro Histórico;300;100;50;18;200;100
5283;Mário Quintana;Chapéu do Sol;50;0;38;5;0;50
5284;Mário Quintana;Chácara das Pedras;300;50;63;9;200;100
5285;Mário Quintana;Cidade Baixa;200;0;124;32;0;200
5286;Mário Quintana;Costa e Silva;550;200;150;32;300;250
5287;Mário Quintana;Cristal;250;0;116;16;50;200
5288;Mário Quintana;Cristo Redentor;200;0;108;24;0;200
5289;Mário Quintana;Espírito Santo;100;0;67;15;0;100
5290;Mário Quintana;Extrema;100;0;63;15;0;100
5291;Mário Quintana;Farrapos;200;0;131;23;0;200
5292;Mário Quintana;Farroupilha;0;0;0;0;0;0
5293;Mário Quintana;Floresta;100;0;62;11;0;100
5294;Mário Quintana;Glória;150;0;82;25;0;150
5295;Mário Quintana;Guarujá;50;50;0;0;50;0
5296;Mário Quintana;Higienópolis;0;0;0;0;0;0
5297;Mário Quintana;Humaitá;100;50;26;4;50;50
5298;Mário Quintana;Hípica;0;0;0;0;0;0
5299;Mário Quintana;Independência;50;0;28;5;0;50
5300;Mário Quintana;Ipanema;100;50;30;8;50;50
5301;Mário Quintana;Jardim Botânico;100;50;0;0;100;0
5302;Mário Quintana;Jardim Carvalho;150;100;28;6;100;50
5303;Mário Quintana;Jardim Europa;300;0;156;32;50;250
5304;Mário Quintana;Jardim Floresta;250;50;94;14;100;150
5305;Mário Quintana;Jardim Isabel;50;0;33;4;0;50
5306;Mário Quintana;Jardim Itú;500;50;189;53;200;300
5307;Mário Quintana;Jardim Leopoldina;1900;400;756;175;700;1200
5308;Mário Quintana;Jardim Lindóia;300;150;63;6;200;100
5309;Mário Quintana;Jardim Sabará;1250;150;541;116;350;900
5310;Mário Quintana;Jardim São Pedro;250;0;110;23;50;200
5311;Mário Quintana;Jardim do Salso;0;0;0;0;0;0
5312;Mário Quintana;Lageado;150;100;32;8;100;50
5313;Mário Quintana;Lami;100;50;0;0;100;0
5314;Mário Quintana;Lomba do Pinheiro;950;100;365;80;350;600
5315;Mário Quintana;Medianeira;0;0;0;0;0;0
5316;Mário Quintana;Menino Deus;200;50;79;28;50;150
5317;Mário Quintana;Moinhos de Vento;200;50;84;34;50;150
5318;Mário Quintana;Mont'Serrat;300;50;54;13;200;100
5319;Mário Quintana;Morro Santana;2250;650;786;139;1300;950
5320;Mário Quintana;Mário Quintana;24600;3800;10200;1816;8100;16500
5321;Mário Quintana;Navegantes;0;0;0;0;0;0
5322;Mário Quintana;Nonoai;100;50;27;12;50;50
5323;Mário Quintana;Parque Santa Fé;1450;150;652;123;450;1000
5324;Mário Quintana;Partenon;100;50;26;13;50;50
5325;Mário Quintana;Passo D'Areia;100;0;62;9;0;100
5326;Mário Quintana;Passo das Pedras;750;200;229;40;450;300
5327;Mário Quintana;Pedra Redonda;50;50;0;0;50;0
5328;Mário Quintana;Petrópolis;150;0;95;31;0;150
5329;Mário Quintana;Pitinga;0;0;0;0;0;0
5330;Mário Quintana;Ponta Grossa;100;0;60;14;0;100
5331;Mário Quintana;Praia de Belas;50;50;0;0;50;0
5332;Mário Quintana;Restinga;150;50;57;13;50;100
5333;Mário Quintana;Rio Branco;200;50;62;8;100;100
5334;Mário Quintana;Rubem Berta;6250;550;2696;1133;1350;4900
5335;Mário Quintana;Santa Cecília;100;0;66;19;0;100
5336;Mário Quintana;Santa Maria Goretti;250;100;82;12;100;150
5337;Mário Quintana;Santa Rosa de Lima;550;150;223;48;250;300
5338;Mário Quintana;Santa Tereza;250;50;115;25;50;200
5339;Mário Quintana;Santana;200;0;92;23;50;150
5340;Mário Quintana;Santo Antônio;100;0;61;10;0;100
5341;Mário Quintana;Sarandi;350;50;125;36;150;200
5342;Mário Quintana;Serraria;50;0;34;6;0;50
5343;Mário Quintana;São Caetano;0;0;0;0;0;0
5344;Mário Quintana;São Geraldo;250;50;88;21;100;150
5345;Mário Quintana;São José;200;0;108;33;0;200
5346;Mário Quintana;São João;50;0;31;7;0;50
5347;Mário Quintana;São Sebastião;100;0;65;13;0;100
5348;Mário Quintana;Sétimo Céu;0;0;0;0;0;0
5349;Mário Quintana;Teresópolis;150;0;21;15;100;50
5350;Mário Quintana;Tristeza;50;0;33;4;0;50
5351;Mário Quintana;Três Figueiras;250;100;58;14;150;100
5352;Mário Quintana;Vila Assunção;100;0;59;22;0;100
5353;Mário Quintana;Vila Conceição;200;0;119;34;0;200
5354;Mário Quintana;Vila Ipiranga;350;50;117;33;150;200
5355;Mário Quintana;Vila Jardim;250;0;154;17;100;150
5356;Mário Quintana;Vila João Pessoa;150;0;91;25;0;150
5357;Mário Quintana;Vila Nova;150;50;63;21;50;100
5358;Navegantes;Aberta dos Morros;0;0;0;0;0;0
5359;Navegantes;Agronomia;0;0;0;0;0;0
5360;Navegantes;Anchieta;0;0;0;0;0;0
5361;Navegantes;Arquipélago;50;0;30;8;0;50
5362;Navegantes;Auxiliadora;50;0;0;0;50;0
5363;Navegantes;Azenha;100;0;46;29;0;100
5364;Navegantes;Bela Vista;100;50;21;11;50;50
5365;Navegantes;Belém Novo;0;0;0;0;0;0
5366;Navegantes;Belém Velho;0;0;0;0;0;0
5367;Navegantes;Boa Vista;100;0;67;18;0;100
5368;Navegantes;Boa Vista do Sul;0;0;0;0;0;0
5369;Navegantes;Bom Fim;200;0;28;15;150;50
5370;Navegantes;Bom Jesus;200;50;55;25;100;100
5371;Navegantes;Camaquã;50;0;27;11;0;50
5372;Navegantes;Campo Novo;50;0;27;16;0;50
5373;Navegantes;Cascata;0;0;0;0;0;0
5374;Navegantes;Cavalhada;100;0;69;21;0;100
5375;Navegantes;Cel. Aparício Borges;0;0;0;0;0;0
5376;Navegantes;Centro Histórico;250;0;146;56;0;250
5377;Navegantes;Chapéu do Sol;0;0;0;0;0;0
5378;Navegantes;Chácara das Pedras;50;0;50;0;50;0
5379;Navegantes;Cidade Baixa;50;0;0;0;50;0
5380;Navegantes;Costa e Silva;50;0;24;13;0;50
5381;Navegantes;Cristal;50;0;26;10;0;50
5382;Navegantes;Cristo Redentor;50;0;22;15;0;50
5383;Navegantes;Espírito Santo;0;0;0;0;0;0
5384;Navegantes;Extrema;50;0;25;10;0;50
5385;Navegantes;Farrapos;2400;300;1079;253;650;1750
5386;Navegantes;Farroupilha;50;0;27;14;0;50
5387;Navegantes;Floresta;450;100;132;57;200;250
5388;Navegantes;Glória;50;50;0;0;50;0
5389;Navegantes;Guarujá;0;0;0;0;0;0
5390;Navegantes;Higienópolis;100;0;64;19;0;100
5391;Navegantes;Humaitá;1402;600;264;75;952;450
5392;Navegantes;Hípica;0;0;0;0;0;0
5393;Navegantes;Independência;50;0;0;0;50;0
5394;Navegantes;Ipanema;50;0;28;11;0;50
5395;Navegantes;Jardim Botânico;0;0;0;0;0;0
5396;Navegantes;Jardim Carvalho;150;50;22;17;100;50
5397;Navegantes;Jardim Europa;0;0;0;0;0;0
5398;Navegantes;Jardim Floresta;50;50;0;0;50;0
5399;Navegantes;Jardim Isabel;0;0;0;0;0;0
5400;Navegantes;Jardim Itú;0;0;0;0;0;0
5401;Navegantes;Jardim Leopoldina;0;0;0;0;0;0
5402;Navegantes;Jardim Lindóia;50;50;0;0;50;0
5403;Navegantes;Jardim Sabará;50;0;0;0;50;0
5404;Navegantes;Jardim São Pedro;50;0;27;12;0;50
5405;Navegantes;Jardim do Salso;0;0;0;0;0;0
5406;Navegantes;Lageado;50;0;0;0;50;0
5407;Navegantes;Lami;0;0;0;0;0;0
5408;Navegantes;Lomba do Pinheiro;150;0;32;3;100;50
5409;Navegantes;Medianeira;100;100;0;0;100;0
5410;Navegantes;Menino Deus;0;0;0;0;0;0
5411;Navegantes;Moinhos de Vento;100;50;20;18;50;50
5412;Navegantes;Mont'Serrat;200;0;120;34;0;200
5413;Navegantes;Morro Santana;50;0;25;12;0;50
5414;Navegantes;Mário Quintana;0;0;0;0;0;0
5415;Navegantes;Navegantes;3300;400;1452;668;700;2600
5416;Navegantes;Nonoai;50;0;36;9;0;50
5417;Navegantes;Parque Santa Fé;0;0;0;0;0;0
5418;Navegantes;Partenon;100;100;0;0;100;0
5419;Navegantes;Passo D'Areia;150;0;52;52;0;150
5420;Navegantes;Passo das Pedras;100;100;0;0;100;0
5421;Navegantes;Pedra Redonda;0;0;0;0;0;0
5422;Navegantes;Petrópolis;250;0;117;50;50;200
5423;Navegantes;Pitinga;50;50;0;0;50;0
5424;Navegantes;Ponta Grossa;50;0;33;6;0;50
5425;Navegantes;Praia de Belas;100;50;25;10;50;50
5426;Navegantes;Restinga;100;50;27;12;50;50
5427;Navegantes;Rio Branco;100;0;25;19;50;50
5428;Navegantes;Rubem Berta;50;50;0;0;50;0
5429;Navegantes;Santa Cecília;50;0;0;0;50;0
5430;Navegantes;Santa Maria Goretti;50;0;43;0;0;50
5431;Navegantes;Santa Rosa de Lima;100;0;33;8;50;50
5432;Navegantes;Santa Tereza;50;0;29;5;0;50
5433;Navegantes;Santana;100;50;25;14;50;50
5434;Navegantes;Santo Antônio;100;0;56;28;0;100
5435;Navegantes;Sarandi;200;100;78;16;150;50
5436;Navegantes;Serraria;0;0;0;0;0;0
5437;Navegantes;São Caetano;0;0;0;0;0;0
5438;Navegantes;São Geraldo;1750;50;875;395;200;1550
5439;Navegantes;São José;0;0;0;0;0;0
5440;Navegantes;São João;400;150;103;60;200;200
5441;Navegantes;São Sebastião;0;0;0;0;0;0
5442;Navegantes;Sétimo Céu;0;0;0;0;0;0
5443;Navegantes;Teresópolis;50;0;27;13;0;50
5444;Navegantes;Tristeza;50;0;22;17;0;50
5445;Navegantes;Três Figueiras;50;0;38;7;0;50
5446;Navegantes;Vila Assunção;0;0;0;0;0;0
5447;Navegantes;Vila Conceição;0;0;0;0;0;0
5448;Navegantes;Vila Ipiranga;150;0;66;20;50;100
5449;Navegantes;Vila Jardim;50;0;0;0;50;0
5450;Navegantes;Vila João Pessoa;50;0;29;12;0;50
5451;Navegantes;Vila Nova;100;0;31;12;50;50
5452;Nonoai;Aberta dos Morros;100;50;0;0;100;0
5453;Nonoai;Agronomia;50;0;31;10;0;50
5454;Nonoai;Anchieta;100;0;64;28;0;100
5455;Nonoai;Arquipélago;250;0;143;44;0;250
5456;Nonoai;Auxiliadora;150;0;59;21;50;100
5457;Nonoai;Azenha;350;50;144;44;100;250
5458;Nonoai;Bela Vista;100;0;30;14;50;50
5459;Nonoai;Belém Novo;0;0;0;0;0;0
5460;Nonoai;Belém Velho;400;50;192;58;100;300
5461;Nonoai;Boa Vista;50;0;25;10;0;50
5462;Nonoai;Boa Vista do Sul;100;0;30;11;50;50
5463;Nonoai;Bom Fim;200;50;26;9;150;50
5464;Nonoai;Bom Jesus;300;100;139;43;100;200
5465;Nonoai;Camaquã;1850;250;816;281;500;1350
5466;Nonoai;Campo Novo;250;0;123;38;50;200
5467;Nonoai;Cascata;300;0;168;24;100;200
5468;Nonoai;Cavalhada;1850;50;1040;378;100;1750
5469;Nonoai;Cel. Aparício Borges;150;0;79;25;0;150
5470;Nonoai;Centro Histórico;150;0;40;31;50;100
5471;Nonoai;Chapéu do Sol;200;150;35;7;150;50
5472;Nonoai;Chácara das Pedras;100;50;0;0;100;0
5473;Nonoai;Cidade Baixa;150;50;27;11;100;50
5474;Nonoai;Costa e Silva;100;100;0;0;100;0
5475;Nonoai;Cristal;3150;950;803;257;1850;1300
5476;Nonoai;Cristo Redentor;350;50;144;33;200;150
5477;Nonoai;Espírito Santo;100;50;33;14;50;50
5478;Nonoai;Extrema;50;0;25;14;0;50
5479;Nonoai;Farrapos;50;0;29;12;0;50
5480;Nonoai;Farroupilha;150;50;57;17;50;100
5481;Nonoai;Floresta;200;0;58;26;100;100
5482;Nonoai;Glória;1200;200;494;160;450;750
5483;Nonoai;Guarujá;50;0;23;22;0;50
5484;Nonoai;Higienópolis;0;0;0;0;0;0
5485;Nonoai;Humaitá;50;50;0;0;50;0
5486;Nonoai;Hípica;250;0;159;50;0;250
5487;Nonoai;Independência;150;50;57;24;50;100
5488;Nonoai;Ipanema;300;0;179;61;0;300
5489;Nonoai;Jardim Botânico;200;50;83;36;50;150
5490;Nonoai;Jardim Carvalho;150;0;81;38;0;150
5491;Nonoai;Jardim Europa;50;50;0;0;50;0
5492;Nonoai;Jardim Floresta;50;0;31;9;0;50
5493;Nonoai;Jardim Isabel;250;0;83;39;100;150
5494;Nonoai;Jardim Itú;200;100;66;20;100;100
5495;Nonoai;Jardim Leopoldina;0;0;0;0;0;0
5496;Nonoai;Jardim Lindóia;250;100;88;30;100;150
5497;Nonoai;Jardim Sabará;200;50;75;18;150;50
5498;Nonoai;Jardim São Pedro;0;0;0;0;0;0
5499;Nonoai;Jardim do Salso;200;50;89;27;50;150
5500;Nonoai;Lageado;100;0;74;19;0;100
5501;Nonoai;Lami;100;50;0;0;100;0
5502;Nonoai;Lomba do Pinheiro;250;0;155;30;0;250
5503;Nonoai;Medianeira;550;100;256;121;100;450
5504;Nonoai;Menino Deus;400;50;161;66;100;300
5505;Nonoai;Moinhos de Vento;100;0;57;17;0;100
5506;Nonoai;Mont'Serrat;50;50;0;0;50;0
5507;Nonoai;Morro Santana;0;0;0;0;0;0
5508;Nonoai;Mário Quintana;100;50;27;12;50;50
5509;Nonoai;Navegantes;50;0;36;9;0;50
5510;Nonoai;Nonoai;15856;5600;2756;846;11956;3900
5511;Nonoai;Parque Santa Fé;150;0;99;19;0;150
5512;Nonoai;Partenon;800;150;354;133;200;600
5513;Nonoai;Passo D'Areia;200;50;69;17;100;100
5514;Nonoai;Passo das Pedras;200;50;30;9;150;50
5515;Nonoai;Pedra Redonda;150;50;85;11;100;50
5516;Nonoai;Petrópolis;350;50;131;62;100;250
5517;Nonoai;Pitinga;0;0;0;0;0;0
5518;Nonoai;Ponta Grossa;50;50;0;0;50;0
5519;Nonoai;Praia de Belas;100;0;62;23;0;100
5520;Nonoai;Restinga;200;0;120;26;0;200
5521;Nonoai;Rio Branco;100;0;57;19;0;100
5522;Nonoai;Rubem Berta;200;50;87;38;50;150
5523;Nonoai;Santa Cecília;200;50;84;41;50;150
5524;Nonoai;Santa Maria Goretti;0;0;0;0;0;0
5525;Nonoai;Santa Rosa de Lima;200;0;54;22;100;100
5526;Nonoai;Santa Tereza;6300;550;3158;964;1050;5250
5527;Nonoai;Santana;350;200;51;17;250;100
5528;Nonoai;Santo Antônio;150;0;92;30;0;150
5529;Nonoai;Sarandi;550;150;102;62;350;200
5530;Nonoai;Serraria;200;50;81;10;150;50
5531;Nonoai;São Caetano;150;0;85;25;0;150
5532;Nonoai;São Geraldo;0;0;0;0;0;0
5533;Nonoai;São José;350;50;214;42;100;250
5534;Nonoai;São João;50;0;27;9;0;50
5535;Nonoai;São Sebastião;50;0;33;12;0;50
5536;Nonoai;Sétimo Céu;450;50;210;55;100;350
5537;Nonoai;Teresópolis;7700;400;3966;1546;1000;6700
5538;Nonoai;Tristeza;900;350;261;91;550;350
5539;Nonoai;Três Figueiras;150;0;37;8;100;50
5540;Nonoai;Vila Assunção;300;100;102;46;100;200
5541;Nonoai;Vila Conceição;100;0;60;17;0;100
5542;Nonoai;Vila Ipiranga;350;50;150;51;100;250
5543;Nonoai;Vila Jardim;250;100;67;18;150;100
5544;Nonoai;Vila João Pessoa;100;0;64;23;0;100
5545;Nonoai;Vila Nova;1050;50;509;166;200;850
5546;Parque Santa Fé;Aberta dos Morros;0;0;0;0;0;0
5547;Parque Santa Fé;Agronomia;50;50;0;0;50;0
5548;Parque Santa Fé;Anchieta;50;0;36;7;0;50
5549;Parque Santa Fé;Arquipélago;100;0;58;13;0;100
5550;Parque Santa Fé;Auxiliadora;100;0;23;19;50;50
5551;Parque Santa Fé;Azenha;0;0;0;0;0;0
5552;Parque Santa Fé;Bela Vista;100;50;29;15;50;50
5553;Parque Santa Fé;Belém Novo;50;0;33;11;0;50
5554;Parque Santa Fé;Belém Velho;50;0;33;13;0;50
5555;Parque Santa Fé;Boa Vista;0;0;0;0;0;0
5556;Parque Santa Fé;Boa Vista do Sul;0;0;0;0;0;0
5557;Parque Santa Fé;Bom Fim;100;0;21;17;50;50
5558;Parque Santa Fé;Bom Jesus;50;0;0;0;50;0
5559;Parque Santa Fé;Camaquã;0;0;0;0;0;0
5560;Parque Santa Fé;Campo Novo;0;0;0;0;0;0
5561;Parque Santa Fé;Cascata;300;50;131;23;100;200
5562;Parque Santa Fé;Cavalhada;100;0;57;22;0;100
5563;Parque Santa Fé;Cel. Aparício Borges;50;0;29;8;0;50
5564;Parque Santa Fé;Centro Histórico;50;0;0;0;50;0
5565;Parque Santa Fé;Chapéu do Sol;100;50;24;12;50;50
5566;Parque Santa Fé;Chácara das Pedras;0;0;0;0;0;0
5567;Parque Santa Fé;Cidade Baixa;50;0;0;0;50;0
5568;Parque Santa Fé;Costa e Silva;2600;700;796;141;1600;1000
5569;Parque Santa Fé;Cristal;50;50;0;0;50;0
5570;Parque Santa Fé;Cristo Redentor;150;0;87;38;0;150
5571;Parque Santa Fé;Espírito Santo;0;0;0;0;0;0
5572;Parque Santa Fé;Extrema;50;50;0;0;50;0
5573;Parque Santa Fé;Farrapos;50;0;0;0;50;0
5574;Parque Santa Fé;Farroupilha;50;0;33;11;0;50
5575;Parque Santa Fé;Floresta;0;0;0;0;0;0
5576;Parque Santa Fé;Glória;0;0;0;0;0;0
5577;Parque Santa Fé;Guarujá;50;50;0;0;50;0
5578;Parque Santa Fé;Higienópolis;100;0;0;0;100;0
5579;Parque Santa Fé;Humaitá;0;0;0;0;0;0
5580;Parque Santa Fé;Hípica;100;0;62;16;0;100
5581;Parque Santa Fé;Independência;100;0;27;13;50;50
5582;Parque Santa Fé;Ipanema;0;0;0;0;0;0
5583;Parque Santa Fé;Jardim Botânico;100;50;33;9;50;50
5584;Parque Santa Fé;Jardim Carvalho;100;50;31;12;50;50
5585;Parque Santa Fé;Jardim Europa;0;0;0;0;0;0
5586;Parque Santa Fé;Jardim Floresta;0;0;0;0;0;0
5587;Parque Santa Fé;Jardim Isabel;0;0;0;0;0;0
5588;Parque Santa Fé;Jardim Itú;350;100;148;56;100;250
5589;Parque Santa Fé;Jardim Leopoldina;1900;500;487;111;1300;600
5590;Parque Santa Fé;Jardim Lindóia;50;0;26;18;0;50
5591;Parque Santa Fé;Jardim Sabará;150;50;61;26;50;100
5592;Parque Santa Fé;Jardim São Pedro;0;0;0;0;0;0
5593;Parque Santa Fé;Jardim do Salso;0;0;0;0;0;0
5594;Parque Santa Fé;Lageado;0;0;0;0;0;0
5595;Parque Santa Fé;Lami;50;0;0;0;50;0
5596;Parque Santa Fé;Lomba do Pinheiro;250;50;57;18;150;100
5597;Parque Santa Fé;Medianeira;50;50;0;0;50;0
5598;Parque Santa Fé;Menino Deus;50;0;24;21;0;50
5599;Parque Santa Fé;Moinhos de Vento;50;0;22;27;0;50
5600;Parque Santa Fé;Mont'Serrat;0;0;0;0;0;0
5601;Parque Santa Fé;Morro Santana;800;50;325;115;250;550
5602;Parque Santa Fé;Mário Quintana;1450;150;652;123;450;1000
5603;Parque Santa Fé;Navegantes;0;0;0;0;0;0
5604;Parque Santa Fé;Nonoai;150;0;99;19;0;150
5605;Parque Santa Fé;Parque Santa Fé;1100;100;400;102;500;600
5606;Parque Santa Fé;Partenon;100;50;37;6;50;50
5607;Parque Santa Fé;Passo D'Areia;300;0;112;86;0;300
5608;Parque Santa Fé;Passo das Pedras;750;0;392;119;100;650
5609;Parque Santa Fé;Pedra Redonda;0;0;0;0;0;0
5610;Parque Santa Fé;Petrópolis;100;0;0;0;100;0
5611;Parque Santa Fé;Pitinga;150;0;95;29;0;150
5612;Parque Santa Fé;Ponta Grossa;0;0;0;0;0;0
5613;Parque Santa Fé;Praia de Belas;50;0;0;0;50;0
5614;Parque Santa Fé;Restinga;350;50;107;34;150;200
5615;Parque Santa Fé;Rio Branco;50;0;28;17;0;50
5616;Parque Santa Fé;Rubem Berta;2450;500;926;544;850;1600
5617;Parque Santa Fé;Santa Cecília;0;0;0;0;0;0
5618;Parque Santa Fé;Santa Maria Goretti;50;0;37;9;0;50
5619;Parque Santa Fé;Santa Rosa de Lima;7100;450;3764;1084;750;6350
5620;Parque Santa Fé;Santa Tereza;250;0;127;55;0;250
5621;Parque Santa Fé;Santana;150;50;21;15;100;50
5622;Parque Santa Fé;Santo Antônio;0;0;0;0;0;0
5623;Parque Santa Fé;Sarandi;1150;100;451;215;400;750
5624;Parque Santa Fé;Serraria;0;0;0;0;0;0
5625;Parque Santa Fé;São Caetano;0;0;0;0;0;0
5626;Parque Santa Fé;São Geraldo;0;0;0;0;0;0
5627;Parque Santa Fé;São José;200;150;27;11;150;50
5628;Parque Santa Fé;São João;0;0;0;0;0;0
5629;Parque Santa Fé;São Sebastião;250;50;101;26;100;150
5630;Parque Santa Fé;Sétimo Céu;0;0;0;0;0;0
5631;Parque Santa Fé;Teresópolis;50;0;33;7;0;50
5632;Parque Santa Fé;Tristeza;0;0;0;0;0;0
5633;Parque Santa Fé;Três Figueiras;150;0;85;33;0;150
5634;Parque Santa Fé;Vila Assunção;0;0;0;0;0;0
5635;Parque Santa Fé;Vila Conceição;0;0;0;0;0;0
5636;Parque Santa Fé;Vila Ipiranga;50;0;25;11;0;50
5637;Parque Santa Fé;Vila Jardim;100;0;64;27;0;100
5638;Parque Santa Fé;Vila João Pessoa;50;0;24;14;0;50
5639;Parque Santa Fé;Vila Nova;150;50;27;10;100;50
5640;Partenon;Aberta dos Morros;250;100;56;22;150;100
5641;Partenon;Agronomia;400;100;158;45;150;250
5642;Partenon;Anchieta;200;0;113;24;100;100
5643;Partenon;Arquipélago;150;50;35;10;100;50
5644;Partenon;Auxiliadora;150;50;0;0;150;0
5645;Partenon;Azenha;2450;500;822;308;1150;1300
5646;Partenon;Bela Vista;650;50;293;105;150;500
5647;Partenon;Belém Novo;500;100;223;70;150;350
5648;Partenon;Belém Velho;200;100;51;28;100;100
5649;Partenon;Boa Vista;150;0;93;22;50;100
5650;Partenon;Boa Vista do Sul;450;0;222;88;50;400
5651;Partenon;Bom Fim;350;50;132;43;100;250
5652;Partenon;Bom Jesus;1100;550;107;28;900;200
5653;Partenon;Camaquã;350;100;91;25;200;150
5654;Partenon;Campo Novo;200;0;115;45;0;200
5655;Partenon;Cascata;650;100;271;102;200;450
5656;Partenon;Cavalhada;800;150;372;128;150;650
5657;Partenon;Cel. Aparício Borges;1550;100;820;241;150;1400
5658;Partenon;Centro Histórico;450;0;222;95;50;400
5659;Partenon;Chapéu do Sol;100;0;26;17;50;50
5660;Partenon;Chácara das Pedras;200;0;121;47;0;200
5661;Partenon;Cidade Baixa;850;100;358;150;200;650
5662;Partenon;Costa e Silva;50;50;0;0;50;0
5663;Partenon;Cristal;300;100;98;40;100;200
5664;Partenon;Cristo Redentor;350;100;118;49;150;200
5665;Partenon;Espírito Santo;250;50;90;33;100;150
5666;Partenon;Extrema;350;0;193;70;0;350
5667;Partenon;Farrapos;100;50;25;9;50;50
5668;Partenon;Farroupilha;450;100;154;32;200;250
5669;Partenon;Floresta;200;0;106;36;0;200
5670;Partenon;Glória;13750;4450;2662;824;10000;3750
5671;Partenon;Guarujá;250;50;113;48;50;200
5672;Partenon;Higienópolis;50;0;35;12;0;50
5673;Partenon;Humaitá;200;50;58;27;100;100
5674;Partenon;Hípica;300;0;145;49;50;250
5675;Partenon;Independência;500;50;239;87;50;450
5676;Partenon;Ipanema;100;0;60;17;0;100
5677;Partenon;Jardim Botânico;1500;100;752;252;200;1300
5678;Partenon;Jardim Carvalho;1950;1000;95;36;1800;150
5679;Partenon;Jardim Europa;50;0;0;0;50;0
5680;Partenon;Jardim Floresta;100;0;52;25;0;100
5681;Partenon;Jardim Isabel;100;0;54;21;0;100
5682;Partenon;Jardim Itú;500;100;163;70;200;300
5683;Partenon;Jardim Leopoldina;250;0;109;52;50;200
5684;Partenon;Jardim Lindóia;400;50;163;18;300;100
5685;Partenon;Jardim Sabará;150;0;103;28;50;100
5686;Partenon;Jardim São Pedro;200;0;115;40;0;200
5687;Partenon;Jardim do Salso;1500;750;179;60;1250;250
5688;Partenon;Lageado;200;50;58;16;100;100
5689;Partenon;Lami;350;100;107;50;150;200
5690;Partenon;Lomba do Pinheiro;250;50;57;13;150;100
5691;Partenon;Medianeira;4350;500;2056;797;800;3550
5692;Partenon;Menino Deus;600;100;249;111;150;450
5693;Partenon;Moinhos de Vento;300;150;75;37;150;150
5694;Partenon;Mont'Serrat;300;100;81;31;150;150
5695;Partenon;Morro Santana;300;50;51;15;200;100
5696;Partenon;Mário Quintana;100;50;26;13;50;50
5697;Partenon;Navegantes;100;100;0;0;100;0
5698;Partenon;Nonoai;800;150;354;133;200;600
5699;Partenon;Parque Santa Fé;100;50;37;6;50;50
5700;Partenon;Partenon;5900;0;3394;1310;100;5800
5701;Partenon;Passo D'Areia;300;50;127;72;50;250
5702;Partenon;Passo das Pedras;200;0;82;12;150;50
5703;Partenon;Pedra Redonda;150;0;89;31;0;150
5704;Partenon;Petrópolis;800;150;312;135;250;550
5705;Partenon;Pitinga;50;0;23;15;0;50
5706;Partenon;Ponta Grossa;250;50;117;53;50;200
5707;Partenon;Praia de Belas;250;0;115;42;50;200
5708;Partenon;Restinga;450;0;166;58;150;300
5709;Partenon;Rio Branco;350;0;176;69;50;300
5710;Partenon;Rubem Berta;250;0;142;73;0;250
5711;Partenon;Santa Cecília;1450;250;679;244;300;1150
5712;Partenon;Santa Maria Goretti;250;0;86;26;100;150
5713;Partenon;Santa Rosa de Lima;450;50;243;87;50;400
5714;Partenon;Santa Tereza;1000;150;412;133;250;750
5715;Partenon;Santana;1350;150;625;175;550;800
5716;Partenon;Santo Antônio;5650;300;2704;1153;750;4900
5717;Partenon;Sarandi;400;50;153;54;150;250
5718;Partenon;Serraria;300;50;89;37;150;150
5719;Partenon;São Caetano;450;50;200;71;100;350
5720;Partenon;São Geraldo;250;0;138;50;0;250
5721;Partenon;São José;500;50;251;81;100;400
5722;Partenon;São João;250;100;60;24;150;100
5723;Partenon;São Sebastião;250;100;54;20;150;100
5724;Partenon;Sétimo Céu;0;0;0;0;0;0
5725;Partenon;Teresópolis;850;150;285;99;350;500
5726;Partenon;Tristeza;100;0;44;23;0;100
5727;Partenon;Três Figueiras;150;0;100;30;0;150
5728;Partenon;Vila Assunção;100;0;28;12;50;50
5729;Partenon;Vila Conceição;100;0;75;8;0;100
5730;Partenon;Vila Ipiranga;150;0;92;36;0;150
5731;Partenon;Vila Jardim;450;100;212;47;250;200
5732;Partenon;Vila João Pessoa;2100;500;760;310;750;1350
5733;Partenon;Vila Nova;350;50;135;57;100;250
5734;Passo D'Areia;Aberta dos Morros;100;0;33;43;0;100
5735;Passo D'Areia;Agronomia;100;0;16;13;50;50
5736;Passo D'Areia;Anchieta;0;0;0;0;0;0
5737;Passo D'Areia;Arquipélago;250;0;53;53;100;150
5738;Passo D'Areia;Auxiliadora;450;50;152;100;150;300
5739;Passo D'Areia;Azenha;150;50;26;17;100;50
5740;Passo D'Areia;Bela Vista;500;200;70;75;300;200
5741;Passo D'Areia;Belém Novo;250;50;99;32;150;100
5742;Passo D'Areia;Belém Velho;0;0;0;0;0;0
5743;Passo D'Areia;Boa Vista;1950;100;773;544;200;1750
5744;Passo D'Areia;Boa Vista do Sul;50;0;19;15;0;50
5745;Passo D'Areia;Bom Fim;0;0;0;0;0;0
5746;Passo D'Areia;Bom Jesus;400;100;141;102;100;300
5747;Passo D'Areia;Camaquã;150;0;19;19;100;50
5748;Passo D'Areia;Campo Novo;50;0;25;7;0;50
5749;Passo D'Areia;Cascata;50;50;0;0;50;0
5750;Passo D'Areia;Cavalhada;250;50;98;37;150;100
5751;Passo D'Areia;Cel. Aparício Borges;50;0;50;0;50;0
5752;Passo D'Areia;Centro Histórico;450;50;200;77;50;400
5753;Passo D'Areia;Chapéu do Sol;50;0;24;17;0;50
5754;Passo D'Areia;Chácara das Pedras;800;300;100;105;550;250
5755;Passo D'Areia;Cidade Baixa;150;0;50;24;50;100
5756;Passo D'Areia;Costa e Silva;150;0;80;29;0;150
5757;Passo D'Areia;Cristal;200;100;50;19;100;100
5758;Passo D'Areia;Cristo Redentor;1300;400;326;211;600;700
5759;Passo D'Areia;Espírito Santo;100;0;49;26;0;100
5760;Passo D'Areia;Extrema;0;0;0;0;0;0
5761;Passo D'Areia;Farrapos;250;100;61;18;150;100
5762;Passo D'Areia;Farroupilha;100;0;34;34;0;100
5763;Passo D'Areia;Floresta;500;150;152;105;200;300
5764;Passo D'Areia;Glória;150;100;23;18;100;50
5765;Passo D'Areia;Guarujá;0;0;0;0;0;0
5766;Passo D'Areia;Higienópolis;3900;400;1364;1106;750;3150
5767;Passo D'Areia;Humaitá;150;0;56;18;50;100
5768;Passo D'Areia;Hípica;0;0;0;0;0;0
5769;Passo D'Areia;Independência;250;0;91;80;50;200
5770;Passo D'Areia;Ipanema;0;0;0;0;0;0
5771;Passo D'Areia;Jardim Botânico;100;0;13;18;50;50
5772;Passo D'Areia;Jardim Carvalho;100;0;58;21;0;100
5773;Passo D'Areia;Jardim Europa;700;150;243;146;300;400
5774;Passo D'Areia;Jardim Floresta;400;50;70;75;200;200
5775;Passo D'Areia;Jardim Isabel;0;0;0;0;0;0
5776;Passo D'Areia;Jardim Itú;400;100;184;63;100;300
5777;Passo D'Areia;Jardim Leopoldina;150;50;0;0;150;0
5778;Passo D'Areia;Jardim Lindóia;550;0;234;139;100;450
5779;Passo D'Areia;Jardim Sabará;250;100;55;61;100;150
5780;Passo D'Areia;Jardim São Pedro;1843;400;359;329;943;900
5781;Passo D'Areia;Jardim do Salso;150;0;58;53;0;150
5782;Passo D'Areia;Lageado;50;0;0;0;50;0
5783;Passo D'Areia;Lami;100;0;31;41;0;100
5784;Passo D'Areia;Lomba do Pinheiro;50;0;0;0;50;0
5785;Passo D'Areia;Medianeira;250;50;79;56;50;200
5786;Passo D'Areia;Menino Deus;500;0;197;130;100;400
5787;Passo D'Areia;Moinhos de Vento;500;0;215;101;200;300
5788;Passo D'Areia;Mont'Serrat;950;150;186;198;450;500
5789;Passo D'Areia;Morro Santana;200;50;68;41;50;150
5790;Passo D'Areia;Mário Quintana;100;0;62;9;0;100
5791;Passo D'Areia;Navegantes;150;0;52;52;0;150
5792;Passo D'Areia;Nonoai;200;50;69;17;100;100
5793;Passo D'Areia;Parque Santa Fé;300;0;112;86;0;300
5794;Passo D'Areia;Partenon;300;50;127;72;50;250
5795;Passo D'Areia;Passo D'Areia;6900;300;1878;2128;1600;5300
5796;Passo D'Areia;Passo das Pedras;300;0;100;92;50;250
5797;Passo D'Areia;Pedra Redonda;150;50;44;34;50;100
5798;Passo D'Areia;Petrópolis;600;200;228;88;300;300
5799;Passo D'Areia;Pitinga;50;0;19;14;0;50
5800;Passo D'Areia;Ponta Grossa;0;0;0;0;0;0
5801;Passo D'Areia;Praia de Belas;50;50;0;0;50;0
5802;Passo D'Areia;Restinga;250;0;45;27;150;100
5803;Passo D'Areia;Rio Branco;350;50;103;70;150;200
5804;Passo D'Areia;Rubem Berta;200;0;44;37;100;100
5805;Passo D'Areia;Santa Cecília;300;0;119;47;100;200
5806;Passo D'Areia;Santa Maria Goretti;1600;150;495;463;300;1300
5807;Passo D'Areia;Santa Rosa de Lima;850;100;386;121;200;650
5808;Passo D'Areia;Santa Tereza;450;250;0;0;450;0
5809;Passo D'Areia;Santana;200;50;50;27;100;100
5810;Passo D'Areia;Santo Antônio;300;0;123;123;0;300
5811;Passo D'Areia;Sarandi;550;100;154;113;200;350
5812;Passo D'Areia;Serraria;50;0;0;0;50;0
5813;Passo D'Areia;São Caetano;100;50;0;0;100;0
5814;Passo D'Areia;São Geraldo;250;150;51;31;150;100
5815;Passo D'Areia;São José;150;50;39;36;50;100
5816;Passo D'Areia;São João;200;50;46;32;100;100
5817;Passo D'Areia;São Sebastião;164;0;80;24;64;100
5818;Passo D'Areia;Sétimo Céu;50;50;0;0;50;0
5819;Passo D'Areia;Teresópolis;100;0;53;35;0;100
5820;Passo D'Areia;Tristeza;0;0;0;0;0;0
5821;Passo D'Areia;Três Figueiras;600;100;257;136;150;450
5822;Passo D'Areia;Vila Assunção;50;0;16;22;0;50
5823;Passo D'Areia;Vila Conceição;50;0;25;17;0;50
5824;Passo D'Areia;Vila Ipiranga;1250;350;285;199;650;600
5825;Passo D'Areia;Vila Jardim;200;50;57;50;50;150
5826;Passo D'Areia;Vila João Pessoa;50;0;37;6;0;50
5827;Passo D'Areia;Vila Nova;200;0;74;47;50;150
5828;Passo das Pedras;Aberta dos Morros;50;0;50;0;50;0
5829;Passo das Pedras;Agronomia;150;0;29;9;100;50
5830;Passo das Pedras;Anchieta;0;0;0;0;0;0
5831;Passo das Pedras;Arquipélago;0;0;0;0;0;0
5832;Passo das Pedras;Auxiliadora;100;50;29;9;50;50
5833;Passo das Pedras;Azenha;250;0;98;54;50;200
5834;Passo das Pedras;Bela Vista;50;50;0;0;50;0
5835;Passo das Pedras;Belém Novo;0;0;0;0;0;0
5836;Passo das Pedras;Belém Velho;150;50;63;11;50;100
5837;Passo das Pedras;Boa Vista;200;100;38;6;150;50
5838;Passo das Pedras;Boa Vista do Sul;150;100;28;6;100;50
5839;Passo das Pedras;Bom Fim;100;50;32;18;50;50
5840;Passo das Pedras;Bom Jesus;450;200;112;45;250;200
5841;Passo das Pedras;Camaquã;150;50;0;0;150;0
5842;Passo das Pedras;Campo Novo;100;50;31;9;50;50
5843;Passo das Pedras;Cascata;0;0;0;0;0;0
5844;Passo das Pedras;Cavalhada;150;0;94;25;0;150
5845;Passo das Pedras;Cel. Aparício Borges;150;0;56;21;50;100
5846;Passo das Pedras;Centro Histórico;200;50;60;20;100;100
5847;Passo das Pedras;Chapéu do Sol;50;0;30;12;0;50
5848;Passo das Pedras;Chácara das Pedras;150;0;87;26;0;150
5849;Passo das Pedras;Cidade Baixa;150;0;87;29;0;150
5850;Passo das Pedras;Costa e Silva;2400;600;1073;276;800;1600
5851;Passo das Pedras;Cristal;250;100;88;30;100;150
5852;Passo das Pedras;Cristo Redentor;300;150;54;18;200;100
5853;Passo das Pedras;Espírito Santo;50;0;28;5;0;50
5854;Passo das Pedras;Extrema;50;50;0;0;50;0
5855;Passo das Pedras;Farrapos;50;0;0;0;50;0
5856;Passo das Pedras;Farroupilha;0;0;0;0;0;0
5857;Passo das Pedras;Floresta;100;0;52;19;0;100
5858;Passo das Pedras;Glória;50;0;31;12;0;50
5859;Passo das Pedras;Guarujá;50;0;33;5;0;50
5860;Passo das Pedras;Higienópolis;0;0;0;0;0;0
5861;Passo das Pedras;Humaitá;50;50;0;0;50;0
5862;Passo das Pedras;Hípica;50;0;37;3;0;50
5863;Passo das Pedras;Independência;50;0;34;9;0;50
5864;Passo das Pedras;Ipanema;100;0;71;16;0;100
5865;Passo das Pedras;Jardim Botânico;50;50;0;0;50;0
5866;Passo das Pedras;Jardim Carvalho;250;100;58;26;150;100
5867;Passo das Pedras;Jardim Europa;50;0;0;0;50;0
5868;Passo das Pedras;Jardim Floresta;150;0;52;19;50;100
5869;Passo das Pedras;Jardim Isabel;0;0;0;0;0;0
5870;Passo das Pedras;Jardim Itú;4250;700;1734;600;1400;2850
5871;Passo das Pedras;Jardim Leopoldina;1450;400;635;173;500;950
5872;Passo das Pedras;Jardim Lindóia;450;0;261;86;100;350
5873;Passo das Pedras;Jardim Sabará;550;50;254;107;100;450
5874;Passo das Pedras;Jardim São Pedro;150;50;63;21;50;100
5875;Passo das Pedras;Jardim do Salso;100;0;29;5;50;50
5876;Passo das Pedras;Lageado;50;0;29;6;0;50
5877;Passo das Pedras;Lami;100;0;56;22;0;100
5878;Passo das Pedras;Lomba do Pinheiro;150;50;59;16;50;100
5879;Passo das Pedras;Medianeira;150;0;51;22;50;100
5880;Passo das Pedras;Menino Deus;100;50;30;5;50;50
5881;Passo das Pedras;Moinhos de Vento;0;0;0;0;0;0
5882;Passo das Pedras;Mont'Serrat;100;0;54;28;0;100
5883;Passo das Pedras;Morro Santana;2500;100;1225;391;450;2050
5884;Passo das Pedras;Mário Quintana;750;200;229;40;450;300
5885;Passo das Pedras;Navegantes;100;100;0;0;100;0
5886;Passo das Pedras;Nonoai;200;50;30;9;150;50
5887;Passo das Pedras;Parque Santa Fé;750;0;392;119;100;650
5888;Passo das Pedras;Partenon;200;0;82;12;150;50
5889;Passo das Pedras;Passo D'Areia;300;0;100;92;50;250
5890;Passo das Pedras;Passo das Pedras;9900;500;5256;1586;900;9000
5891;Passo das Pedras;Pedra Redonda;0;0;0;0;0;0
5892;Passo das Pedras;Petrópolis;150;50;23;13;100;50
5893;Passo das Pedras;Pitinga;100;50;25;9;50;50
5894;Passo das Pedras;Ponta Grossa;100;50;28;7;50;50
5895;Passo das Pedras;Praia de Belas;50;0;29;14;0;50
5896;Passo das Pedras;Restinga;100;50;35;10;50;50
5897;Passo das Pedras;Rio Branco;0;0;0;0;0;0
5898;Passo das Pedras;Rubem Berta;1400;300;522;384;350;1050
5899;Passo das Pedras;Santa Cecília;0;0;0;0;0;0
5900;Passo das Pedras;Santa Maria Goretti;100;100;0;0;100;0
5901;Passo das Pedras;Santa Rosa de Lima;1600;200;749;179;350;1250
5902;Passo das Pedras;Santa Tereza;250;0;147;49;0;250
5903;Passo das Pedras;Santana;150;0;50;21;50;100
5904;Passo das Pedras;Santo Antônio;0;0;0;0;0;0
5905;Passo das Pedras;Sarandi;650;150;149;98;350;300
5906;Passo das Pedras;Serraria;0;0;0;0;0;0
5907;Passo das Pedras;São Caetano;0;0;0;0;0;0
5908;Passo das Pedras;São Geraldo;0;0;0;0;0;0
5909;Passo das Pedras;São José;100;0;26;9;50;50
5910;Passo das Pedras;São João;100;0;79;12;50;50
5911;Passo das Pedras;São Sebastião;750;150;269;75;350;400
5912;Passo das Pedras;Sétimo Céu;0;0;0;0;0;0
5913;Passo das Pedras;Teresópolis;250;0;154;48;0;250
5914;Passo das Pedras;Tristeza;0;0;0;0;0;0
5915;Passo das Pedras;Três Figueiras;0;0;0;0;0;0
5916;Passo das Pedras;Vila Assunção;0;0;0;0;0;0
5917;Passo das Pedras;Vila Conceição;50;50;0;0;50;0
5918;Passo das Pedras;Vila Ipiranga;400;150;118;35;200;200
5919;Passo das Pedras;Vila Jardim;250;0;140;59;0;250
5920;Passo das Pedras;Vila João Pessoa;50;0;28;11;0;50
5921;Passo das Pedras;Vila Nova;350;50;143;57;100;250
5922;Pedra Redonda;Aberta dos Morros;50;0;33;7;0;50
5923;Pedra Redonda;Agronomia;0;0;0;0;0;0
5924;Pedra Redonda;Anchieta;0;0;0;0;0;0
5925;Pedra Redonda;Arquipélago;0;0;0;0;0;0
5926;Pedra Redonda;Auxiliadora;0;0;0;0;0;0
5927;Pedra Redonda;Azenha;50;0;26;10;0;50
5928;Pedra Redonda;Bela Vista;0;0;0;0;0;0
5929;Pedra Redonda;Belém Novo;0;0;0;0;0;0
5930;Pedra Redonda;Belém Velho;0;0;0;0;0;0
5931;Pedra Redonda;Boa Vista;0;0;0;0;0;0
5932;Pedra Redonda;Boa Vista do Sul;0;0;0;0;0;0
5933;Pedra Redonda;Bom Fim;50;0;0;0;50;0
5934;Pedra Redonda;Bom Jesus;200;0;110;46;0;200
5935;Pedra Redonda;Camaquã;200;50;60;22;100;100
5936;Pedra Redonda;Campo Novo;100;0;59;16;0;100
5937;Pedra Redonda;Cascata;0;0;0;0;0;0
5938;Pedra Redonda;Cavalhada;3021;500;987;363;1321;1700
5939;Pedra Redonda;Cel. Aparício Borges;0;0;0;0;0;0
5940;Pedra Redonda;Centro Histórico;0;0;0;0;0;0
5941;Pedra Redonda;Chapéu do Sol;50;50;0;0;50;0
5942;Pedra Redonda;Chácara das Pedras;0;0;0;0;0;0
5943;Pedra Redonda;Cidade Baixa;50;50;0;0;50;0
5944;Pedra Redonda;Costa e Silva;0;0;0;0;0;0
5945;Pedra Redonda;Cristal;350;0;204;66;0;350
5946;Pedra Redonda;Cristo Redentor;0;0;0;0;0;0
5947;Pedra Redonda;Espírito Santo;150;0;81;35;0;150
5948;Pedra Redonda;Extrema;0;0;0;0;0;0
5949;Pedra Redonda;Farrapos;100;0;66;18;0;100
5950;Pedra Redonda;Farroupilha;50;0;22;17;0;50
5951;Pedra Redonda;Floresta;0;0;0;0;0;0
5952;Pedra Redonda;Glória;0;0;0;0;0;0
5953;Pedra Redonda;Guarujá;50;50;0;0;50;0
5954;Pedra Redonda;Higienópolis;0;0;0;0;0;0
5955;Pedra Redonda;Humaitá;0;0;0;0;0;0
5956;Pedra Redonda;Hípica;150;0;83;19;0;150
5957;Pedra Redonda;Independência;0;0;0;0;0;0
5958;Pedra Redonda;Ipanema;400;50;143;33;250;150
5959;Pedra Redonda;Jardim Botânico;50;50;0;0;50;0
5960;Pedra Redonda;Jardim Carvalho;0;0;0;0;0;0
5961;Pedra Redonda;Jardim Europa;0;0;0;0;0;0
5962;Pedra Redonda;Jardim Floresta;0;0;0;0;0;0
5963;Pedra Redonda;Jardim Isabel;500;50;224;87;150;350
5964;Pedra Redonda;Jardim Itú;0;0;0;0;0;0
5965;Pedra Redonda;Jardim Leopoldina;0;0;0;0;0;0
5966;Pedra Redonda;Jardim Lindóia;0;0;0;0;0;0
5967;Pedra Redonda;Jardim Sabará;50;0;28;11;0;50
5968;Pedra Redonda;Jardim São Pedro;50;0;33;11;0;50
5969;Pedra Redonda;Jardim do Salso;50;0;30;6;0;50
5970;Pedra Redonda;Lageado;0;0;0;0;0;0
5971;Pedra Redonda;Lami;0;0;0;0;0;0
5972;Pedra Redonda;Lomba do Pinheiro;150;50;60;15;50;100
5973;Pedra Redonda;Medianeira;0;0;0;0;0;0
5974;Pedra Redonda;Menino Deus;50;0;25;16;0;50
5975;Pedra Redonda;Moinhos de Vento;0;0;0;0;0;0
5976;Pedra Redonda;Mont'Serrat;50;0;30;11;0;50
5977;Pedra Redonda;Morro Santana;0;0;0;0;0;0
5978;Pedra Redonda;Mário Quintana;50;50;0;0;50;0
5979;Pedra Redonda;Navegantes;0;0;0;0;0;0
5980;Pedra Redonda;Nonoai;150;50;85;11;100;50
5981;Pedra Redonda;Parque Santa Fé;0;0;0;0;0;0
5982;Pedra Redonda;Partenon;150;0;89;31;0;150
5983;Pedra Redonda;Passo D'Areia;150;50;44;34;50;100
5984;Pedra Redonda;Passo das Pedras;0;0;0;0;0;0
5985;Pedra Redonda;Pedra Redonda;0;0;0;0;0;0
5986;Pedra Redonda;Petrópolis;50;0;26;14;0;50
5987;Pedra Redonda;Pitinga;0;0;0;0;0;0
5988;Pedra Redonda;Ponta Grossa;100;0;65;16;0;100
5989;Pedra Redonda;Praia de Belas;0;0;0;0;0;0
5990;Pedra Redonda;Restinga;250;0;83;21;100;150
5991;Pedra Redonda;Rio Branco;150;0;95;38;0;150
5992;Pedra Redonda;Rubem Berta;100;50;19;20;50;50
5993;Pedra Redonda;Santa Cecília;0;0;0;0;0;0
5994;Pedra Redonda;Santa Maria Goretti;50;0;36;0;0;50
5995;Pedra Redonda;Santa Rosa de Lima;150;50;27;9;100;50
5996;Pedra Redonda;Santa Tereza;150;100;24;13;100;50
5997;Pedra Redonda;Santana;50;50;0;0;50;0
5998;Pedra Redonda;Santo Antônio;0;0;0;0;0;0
5999;Pedra Redonda;Sarandi;50;0;28;13;0;50
6000;Pedra Redonda;Serraria;150;50;50;18;50;100
6001;Pedra Redonda;São Caetano;0;0;0;0;0;0
6002;Pedra Redonda;São Geraldo;0;0;0;0;0;0
6003;Pedra Redonda;São José;50;50;0;0;50;0
6004;Pedra Redonda;São João;100;0;25;21;50;50
6005;Pedra Redonda;São Sebastião;0;0;0;0;0;0
6006;Pedra Redonda;Sétimo Céu;100;0;67;14;0;100
6007;Pedra Redonda;Teresópolis;0;0;0;0;0;0
6008;Pedra Redonda;Tristeza;1000;100;452;211;250;750
6009;Pedra Redonda;Três Figueiras;0;0;0;0;0;0
6010;Pedra Redonda;Vila Assunção;50;0;34;14;0;50
6011;Pedra Redonda;Vila Conceição;141;50;28;19;91;50
6012;Pedra Redonda;Vila Ipiranga;0;0;0;0;0;0
6013;Pedra Redonda;Vila Jardim;50;0;22;13;0;50
6014;Pedra Redonda;Vila João Pessoa;50;0;0;0;50;0
6015;Pedra Redonda;Vila Nova;100;0;58;19;0;100
6016;Petrópolis;Aberta dos Morros;100;50;29;17;50;50
6017;Petrópolis;Agronomia;300;0;182;83;50;250
6018;Petrópolis;Anchieta;150;0;72;22;50;100
6019;Petrópolis;Arquipélago;250;50;112;22;150;100
6020;Petrópolis;Auxiliadora;1000;250;293;121;600;400
6021;Petrópolis;Azenha;400;0;188;75;100;300
6022;Petrópolis;Bela Vista;1850;100;830;302;550;1300
6023;Petrópolis;Belém Novo;200;0;91;43;50;150
6024;Petrópolis;Belém Velho;450;200;136;44;300;150
6025;Petrópolis;Boa Vista;650;50;254;125;200;450
6026;Petrópolis;Boa Vista do Sul;300;50;133;50;100;200
6027;Petrópolis;Bom Fim;500;50;168;95;150;350
6028;Petrópolis;Bom Jesus;200;100;27;7;150;50
6029;Petrópolis;Camaquã;400;50;116;52;200;200
6030;Petrópolis;Campo Novo;50;0;31;17;0;50
6031;Petrópolis;Cascata;250;50;67;24;150;100
6032;Petrópolis;Cavalhada;100;0;52;30;0;100
6033;Petrópolis;Cel. Aparício Borges;400;0;221;106;0;400
6034;Petrópolis;Centro Histórico;350;50;67;28;250;100
6035;Petrópolis;Chapéu do Sol;100;0;62;24;0;100
6036;Petrópolis;Chácara das Pedras;900;100;337;136;400;500
6037;Petrópolis;Cidade Baixa;300;100;101;38;150;150
6038;Petrópolis;Costa e Silva;300;50;140;54;50;250
6039;Petrópolis;Cristal;150;0;80;33;0;150
6040;Petrópolis;Cristo Redentor;500;50;189;89;150;350
6041;Petrópolis;Espírito Santo;250;0;136;64;0;250
6042;Petrópolis;Extrema;150;0;56;32;50;100
6043;Petrópolis;Farrapos;100;0;60;25;0;100
6044;Petrópolis;Farroupilha;50;0;27;8;0;50
6045;Petrópolis;Floresta;350;50;119;56;150;200
6046;Petrópolis;Glória;200;50;48;23;100;100
6047;Petrópolis;Guarujá;150;50;32;13;100;50
6048;Petrópolis;Higienópolis;500;100;177;71;200;300
6049;Petrópolis;Humaitá;150;50;25;16;100;50
6050;Petrópolis;Hípica;50;0;0;0;50;0
6051;Petrópolis;Independência;200;50;90;46;50;150
6052;Petrópolis;Ipanema;200;0;111;49;0;200
6053;Petrópolis;Jardim Botânico;2850;650;577;176;2200;650
6054;Petrópolis;Jardim Carvalho;600;100;254;87;200;400
6055;Petrópolis;Jardim Europa;500;0;181;103;200;300
6056;Petrópolis;Jardim Floresta;400;100;119;81;150;250
6057;Petrópolis;Jardim Isabel;200;50;85;44;50;150
6058;Petrópolis;Jardim Itú;400;0;171;84;100;300
6059;Petrópolis;Jardim Leopoldina;100;0;57;25;0;100
6060;Petrópolis;Jardim Lindóia;350;50;136;72;100;250
6061;Petrópolis;Jardim Sabará;350;50;144;61;100;250
6062;Petrópolis;Jardim São Pedro;200;50;30;4;150;50
6063;Petrópolis;Jardim do Salso;1500;400;189;63;1250;250
6064;Petrópolis;Lageado;150;0;90;44;0;150
6065;Petrópolis;Lami;150;0;84;32;0;150
6066;Petrópolis;Lomba do Pinheiro;750;150;341;134;200;550
6067;Petrópolis;Medianeira;400;100;180;72;100;300
6068;Petrópolis;Menino Deus;400;50;145;80;100;300
6069;Petrópolis;Moinhos de Vento;400;50;116;63;200;200
6070;Petrópolis;Mont'Serrat;2150;800;213;93;1800;350
6071;Petrópolis;Morro Santana;50;50;0;0;50;0
6072;Petrópolis;Mário Quintana;150;0;95;31;0;150
6073;Petrópolis;Navegantes;250;0;117;50;50;200
6074;Petrópolis;Nonoai;350;50;131;62;100;250
6075;Petrópolis;Parque Santa Fé;100;0;0;0;100;0
6076;Petrópolis;Partenon;800;150;312;135;250;550
6077;Petrópolis;Passo D'Areia;600;200;228;88;300;300
6078;Petrópolis;Passo das Pedras;150;50;23;13;100;50
6079;Petrópolis;Pedra Redonda;50;0;26;14;0;50
6080;Petrópolis;Petrópolis;6600;2300;494;170;5900;700
6081;Petrópolis;Pitinga;150;0;81;45;0;150
6082;Petrópolis;Ponta Grossa;800;150;210;121;400;400
6083;Petrópolis;Praia de Belas;300;50;76;33;150;150
6084;Petrópolis;Restinga;300;50;121;41;100;200
6085;Petrópolis;Rio Branco;2850;150;1289;625;600;2250
6086;Petrópolis;Rubem Berta;100;50;26;14;50;50
6087;Petrópolis;Santa Cecília;700;50;328;158;100;600
6088;Petrópolis;Santa Maria Goretti;450;0;206;90;100;350
6089;Petrópolis;Santa Rosa de Lima;200;0;82;27;50;150
6090;Petrópolis;Santa Tereza;700;50;281;128;200;500
6091;Petrópolis;Santana;800;50;251;144;300;500
6092;Petrópolis;Santo Antônio;500;0;254;115;50;450
6093;Petrópolis;Sarandi;250;50;97;55;50;200
6094;Petrópolis;Serraria;50;0;24;21;0;50
6095;Petrópolis;São Caetano;50;50;0;0;50;0
6096;Petrópolis;São Geraldo;200;0;82;43;50;150
6097;Petrópolis;São José;600;150;217;105;200;400
6098;Petrópolis;São João;300;50;81;42;150;150
6099;Petrópolis;São Sebastião;150;0;59;27;50;100
6100;Petrópolis;Sétimo Céu;150;50;68;23;50;100
6101;Petrópolis;Teresópolis;450;200;94;38;300;150
6102;Petrópolis;Tristeza;100;0;61;23;0;100
6103;Petrópolis;Três Figueiras;10400;1600;4190;1854;3600;6800
6104;Petrópolis;Vila Assunção;100;50;0;0;100;0
6105;Petrópolis;Vila Conceição;200;0;118;59;0;200
6106;Petrópolis;Vila Ipiranga;350;100;93;40;200;150
6107;Petrópolis;Vila Jardim;850;200;305;117;400;450
6108;Petrópolis;Vila João Pessoa;500;50;226;111;100;400
6109;Petrópolis;Vila Nova;400;50;171;61;100;300
6110;Pitinga;Aberta dos Morros;0;0;0;0;0;0
6111;Pitinga;Agronomia;0;0;0;0;0;0
6112;Pitinga;Anchieta;0;0;0;0;0;0
6113;Pitinga;Arquipélago;50;50;0;0;50;0
6114;Pitinga;Auxiliadora;0;0;0;0;0;0
6115;Pitinga;Azenha;50;0;31;11;0;50
6116;Pitinga;Bela Vista;0;0;0;0;0;0
6117;Pitinga;Belém Novo;50;0;0;0;50;0
6118;Pitinga;Belém Velho;50;0;33;6;0;50
6119;Pitinga;Boa Vista;50;0;25;15;0;50
6120;Pitinga;Boa Vista do Sul;100;0;65;20;0;100
6121;Pitinga;Bom Fim;50;0;30;12;0;50
6122;Pitinga;Bom Jesus;0;0;0;0;0;0
6123;Pitinga;Camaquã;50;0;50;0;50;0
6124;Pitinga;Campo Novo;100;0;58;20;0;100
6125;Pitinga;Cascata;200;0;78;20;50;150
6126;Pitinga;Cavalhada;0;0;0;0;0;0
6127;Pitinga;Cel. Aparício Borges;100;0;61;16;0;100
6128;Pitinga;Centro Histórico;50;0;32;12;0;50
6129;Pitinga;Chapéu do Sol;0;0;0;0;0;0
6130;Pitinga;Chácara das Pedras;0;0;0;0;0;0
6131;Pitinga;Cidade Baixa;150;50;23;12;100;50
6132;Pitinga;Costa e Silva;0;0;0;0;0;0
6133;Pitinga;Cristal;100;50;32;6;50;50
6134;Pitinga;Cristo Redentor;0;0;0;0;0;0
6135;Pitinga;Espírito Santo;50;0;31;7;0;50
6136;Pitinga;Extrema;100;0;57;17;0;100
6137;Pitinga;Farrapos;0;0;0;0;0;0
6138;Pitinga;Farroupilha;0;0;0;0;0;0
6139;Pitinga;Floresta;0;0;0;0;0;0
6140;Pitinga;Glória;150;50;61;17;50;100
6141;Pitinga;Guarujá;0;0;0;0;0;0
6142;Pitinga;Higienópolis;100;0;67;24;0;100
6143;Pitinga;Humaitá;50;0;28;9;0;50
6144;Pitinga;Hípica;350;50;163;41;100;250
6145;Pitinga;Independência;0;0;0;0;0;0
6146;Pitinga;Ipanema;0;0;0;0;0;0
6147;Pitinga;Jardim Botânico;100;50;26;12;50;50
6148;Pitinga;Jardim Carvalho;200;50;62;8;100;100
6149;Pitinga;Jardim Europa;0;0;0;0;0;0
6150;Pitinga;Jardim Floresta;0;0;0;0;0;0
6151;Pitinga;Jardim Isabel;0;0;0;0;0;0
6152;Pitinga;Jardim Itú;150;0;95;24;0;150
6153;Pitinga;Jardim Leopoldina;0;0;0;0;0;0
6154;Pitinga;Jardim Lindóia;0;0;0;0;0;0
6155;Pitinga;Jardim Sabará;100;50;30;10;50;50
6156;Pitinga;Jardim São Pedro;0;0;0;0;0;0
6157;Pitinga;Jardim do Salso;0;0;0;0;0;0
6158;Pitinga;Lageado;150;50;64;15;50;100
6159;Pitinga;Lami;150;0;87;18;0;150
6160;Pitinga;Lomba do Pinheiro;1750;200;826;198;350;1400
6161;Pitinga;Medianeira;100;50;28;10;50;50
6162;Pitinga;Menino Deus;50;0;23;15;0;50
6163;Pitinga;Moinhos de Vento;50;0;27;11;0;50
6164;Pitinga;Mont'Serrat;0;0;0;0;0;0
6165;Pitinga;Morro Santana;150;50;64;13;50;100
6166;Pitinga;Mário Quintana;0;0;0;0;0;0
6167;Pitinga;Navegantes;50;50;0;0;50;0
6168;Pitinga;Nonoai;0;0;0;0;0;0
6169;Pitinga;Parque Santa Fé;150;0;95;29;0;150
6170;Pitinga;Partenon;50;0;23;15;0;50
6171;Pitinga;Passo D'Areia;50;0;19;14;0;50
6172;Pitinga;Passo das Pedras;100;50;25;9;50;50
6173;Pitinga;Pedra Redonda;0;0;0;0;0;0
6174;Pitinga;Petrópolis;150;0;81;45;0;150
6175;Pitinga;Pitinga;1000;300;398;74;500;500
6176;Pitinga;Ponta Grossa;50;0;0;0;50;0
6177;Pitinga;Praia de Belas;0;0;0;0;0;0
6178;Pitinga;Restinga;1900;150;967;248;300;1600
6179;Pitinga;Rio Branco;0;0;0;0;0;0
6180;Pitinga;Rubem Berta;50;0;35;5;0;50
6181;Pitinga;Santa Cecília;0;0;0;0;0;0
6182;Pitinga;Santa Maria Goretti;50;0;35;1;0;50
6183;Pitinga;Santa Rosa de Lima;50;50;0;0;50;0
6184;Pitinga;Santa Tereza;300;50;120;33;100;200
6185;Pitinga;Santana;0;0;0;0;0;0
6186;Pitinga;Santo Antônio;200;0;131;26;50;150
6187;Pitinga;Sarandi;250;50;103;24;150;100
6188;Pitinga;Serraria;50;0;27;9;0;50
6189;Pitinga;São Caetano;0;0;0;0;0;0
6190;Pitinga;São Geraldo;0;0;0;0;0;0
6191;Pitinga;São José;200;0;83;22;50;150
6192;Pitinga;São João;0;0;0;0;0;0
6193;Pitinga;São Sebastião;50;0;29;6;0;50
6194;Pitinga;Sétimo Céu;0;0;0;0;0;0
6195;Pitinga;Teresópolis;50;0;31;4;0;50
6196;Pitinga;Tristeza;50;50;0;0;50;0
6197;Pitinga;Três Figueiras;0;0;0;0;0;0
6198;Pitinga;Vila Assunção;0;0;0;0;0;0
6199;Pitinga;Vila Conceição;0;0;0;0;0;0
6200;Pitinga;Vila Ipiranga;100;100;0;0;100;0
6201;Pitinga;Vila Jardim;0;0;0;0;0;0
6202;Pitinga;Vila João Pessoa;100;0;56;16;0;100
6203;Pitinga;Vila Nova;50;0;34;9;0;50
6204;Ponta Grossa;Aberta dos Morros;300;0;135;34;50;250
6205;Ponta Grossa;Agronomia;0;0;0;0;0;0
6206;Ponta Grossa;Anchieta;0;0;0;0;0;0
6207;Ponta Grossa;Arquipélago;50;0;24;9;0;50
6208;Ponta Grossa;Auxiliadora;0;0;0;0;0;0
6209;Ponta Grossa;Azenha;100;50;25;14;50;50
6210;Ponta Grossa;Bela Vista;0;0;0;0;0;0
6211;Ponta Grossa;Belém Novo;500;150;176;53;200;300
6212;Ponta Grossa;Belém Velho;100;50;26;11;50;50
6213;Ponta Grossa;Boa Vista;50;0;26;8;0;50
6214;Ponta Grossa;Boa Vista do Sul;100;100;0;0;100;0
6215;Ponta Grossa;Bom Fim;50;0;26;8;0;50
6216;Ponta Grossa;Bom Jesus;100;0;61;21;0;100
6217;Ponta Grossa;Camaquã;150;0;54;24;50;100
6218;Ponta Grossa;Campo Novo;200;50;108;14;100;100
6219;Ponta Grossa;Cascata;150;50;62;18;50;100
6220;Ponta Grossa;Cavalhada;200;100;35;9;150;50
6221;Ponta Grossa;Cel. Aparício Borges;100;0;62;14;0;100
6222;Ponta Grossa;Centro Histórico;150;50;23;12;100;50
6223;Ponta Grossa;Chapéu do Sol;200;0;121;23;0;200
6224;Ponta Grossa;Chácara das Pedras;50;0;28;13;0;50
6225;Ponta Grossa;Cidade Baixa;100;0;34;12;50;50
6226;Ponta Grossa;Costa e Silva;150;0;66;18;50;100
6227;Ponta Grossa;Cristal;50;0;34;7;0;50
6228;Ponta Grossa;Cristo Redentor;50;50;0;0;50;0
6229;Ponta Grossa;Espírito Santo;500;50;248;69;100;400
6230;Ponta Grossa;Extrema;50;0;0;0;50;0
6231;Ponta Grossa;Farrapos;100;0;66;13;0;100
6232;Ponta Grossa;Farroupilha;0;0;0;0;0;0
6233;Ponta Grossa;Floresta;150;0;57;15;50;100
6234;Ponta Grossa;Glória;200;50;83;30;50;150
6235;Ponta Grossa;Guarujá;850;150;324;96;300;550
6236;Ponta Grossa;Higienópolis;100;0;33;17;50;50
6237;Ponta Grossa;Humaitá;100;0;58;17;0;100
6238;Ponta Grossa;Hípica;800;150;329;84;300;500
6239;Ponta Grossa;Independência;0;0;0;0;0;0
6240;Ponta Grossa;Ipanema;700;50;382;110;150;550
6241;Ponta Grossa;Jardim Botânico;100;0;0;0;100;0
6242;Ponta Grossa;Jardim Carvalho;300;50;158;33;50;250
6243;Ponta Grossa;Jardim Europa;0;0;0;0;0;0
6244;Ponta Grossa;Jardim Floresta;0;0;0;0;0;0
6245;Ponta Grossa;Jardim Isabel;0;0;0;0;0;0
6246;Ponta Grossa;Jardim Itú;100;0;65;17;0;100
6247;Ponta Grossa;Jardim Leopoldina;50;0;37;6;0;50
6248;Ponta Grossa;Jardim Lindóia;100;0;62;24;0;100
6249;Ponta Grossa;Jardim Sabará;0;0;0;0;0;0
6250;Ponta Grossa;Jardim São Pedro;0;0;0;0;0;0
6251;Ponta Grossa;Jardim do Salso;50;0;34;3;0;50
6252;Ponta Grossa;Lageado;0;0;0;0;0;0
6253;Ponta Grossa;Lami;0;0;0;0;0;0
6254;Ponta Grossa;Lomba do Pinheiro;200;50;52;15;100;100
6255;Ponta Grossa;Medianeira;50;0;31;6;0;50
6256;Ponta Grossa;Menino Deus;50;0;24;11;0;50
6257;Ponta Grossa;Moinhos de Vento;0;0;0;0;0;0
6258;Ponta Grossa;Mont'Serrat;100;0;75;25;0;100
6259;Ponta Grossa;Morro Santana;200;50;99;30;100;100
6260;Ponta Grossa;Mário Quintana;100;0;60;14;0;100
6261;Ponta Grossa;Navegantes;50;0;33;6;0;50
6262;Ponta Grossa;Nonoai;50;50;0;0;50;0
6263;Ponta Grossa;Parque Santa Fé;0;0;0;0;0;0
6264;Ponta Grossa;Partenon;250;50;117;53;50;200
6265;Ponta Grossa;Passo D'Areia;0;0;0;0;0;0
6266;Ponta Grossa;Passo das Pedras;100;50;28;7;50;50
6267;Ponta Grossa;Pedra Redonda;100;0;65;16;0;100
6268;Ponta Grossa;Petrópolis;800;150;210;121;400;400
6269;Ponta Grossa;Pitinga;50;0;0;0;50;0
6270;Ponta Grossa;Ponta Grossa;2200;500;890;216;800;1400
6271;Ponta Grossa;Praia de Belas;0;0;0;0;0;0
6272;Ponta Grossa;Restinga;150;0;77;23;0;150
6273;Ponta Grossa;Rio Branco;100;0;27;13;50;50
6274;Ponta Grossa;Rubem Berta;100;0;49;10;0;100
6275;Ponta Grossa;Santa Cecília;0;0;0;0;0;0
6276;Ponta Grossa;Santa Maria Goretti;50;50;0;0;50;0
6277;Ponta Grossa;Santa Rosa de Lima;50;0;29;10;0;50
6278;Ponta Grossa;Santa Tereza;150;0;85;24;0;150
6279;Ponta Grossa;Santana;150;0;29;15;100;50
6280;Ponta Grossa;Santo Antônio;50;0;33;9;0;50
6281;Ponta Grossa;Sarandi;100;0;0;0;100;0
6282;Ponta Grossa;Serraria;1000;150;451;131;250;750
6283;Ponta Grossa;São Caetano;0;0;0;0;0;0
6284;Ponta Grossa;São Geraldo;50;0;24;14;0;50
6285;Ponta Grossa;São José;200;100;32;8;150;50
6286;Ponta Grossa;São João;150;50;58;29;50;100
6287;Ponta Grossa;São Sebastião;0;0;0;0;0;0
6288;Ponta Grossa;Sétimo Céu;50;0;30;9;0;50
6289;Ponta Grossa;Teresópolis;50;0;33;10;0;50
6290;Ponta Grossa;Tristeza;100;100;0;0;100;0
6291;Ponta Grossa;Três Figueiras;0;0;0;0;0;0
6292;Ponta Grossa;Vila Assunção;50;0;0;0;50;0
6293;Ponta Grossa;Vila Conceição;50;0;28;7;0;50
6294;Ponta Grossa;Vila Ipiranga;0;0;0;0;0;0
6295;Ponta Grossa;Vila Jardim;0;0;0;0;0;0
6296;Ponta Grossa;Vila João Pessoa;100;50;29;10;50;50
6297;Ponta Grossa;Vila Nova;200;50;59;15;100;100
6298;Praia de Belas;Aberta dos Morros;0;0;0;0;0;0
6299;Praia de Belas;Agronomia;0;0;0;0;0;0
6300;Praia de Belas;Anchieta;0;0;0;0;0;0
6301;Praia de Belas;Arquipélago;1450;250;579;154;450;1000
6302;Praia de Belas;Auxiliadora;0;0;0;0;0;0
6303;Praia de Belas;Azenha;500;0;244;106;50;450
6304;Praia de Belas;Bela Vista;50;0;0;0;50;0
6305;Praia de Belas;Belém Novo;0;0;0;0;0;0
6306;Praia de Belas;Belém Velho;50;0;29;11;0;50
6307;Praia de Belas;Boa Vista;0;0;0;0;0;0
6308;Praia de Belas;Boa Vista do Sul;0;0;0;0;0;0
6309;Praia de Belas;Bom Fim;350;0;127;71;100;250
6310;Praia de Belas;Bom Jesus;200;50;61;12;100;100
6311;Praia de Belas;Camaquã;100;0;54;26;0;100
6312;Praia de Belas;Campo Novo;50;0;27;10;0;50
6313;Praia de Belas;Cascata;0;0;0;0;0;0
6314;Praia de Belas;Cavalhada;100;50;23;12;50;50
6315;Praia de Belas;Cel. Aparício Borges;50;50;0;0;50;0
6316;Praia de Belas;Centro Histórico;1250;200;488;238;300;950
6317;Praia de Belas;Chapéu do Sol;0;0;0;0;0;0
6318;Praia de Belas;Chácara das Pedras;0;0;0;0;0;0
6319;Praia de Belas;Cidade Baixa;1192;50;501;219;292;900
6320;Praia de Belas;Costa e Silva;100;0;81;4;50;50
6321;Praia de Belas;Cristal;450;250;133;29;300;150
6322;Praia de Belas;Cristo Redentor;150;0;66;16;50;100
6323;Praia de Belas;Espírito Santo;0;0;0;0;0;0
6324;Praia de Belas;Extrema;0;0;0;0;0;0
6325;Praia de Belas;Farrapos;250;0;152;38;0;250
6326;Praia de Belas;Farroupilha;150;0;90;37;0;150
6327;Praia de Belas;Floresta;100;50;38;7;50;50
6328;Praia de Belas;Glória;100;100;0;0;100;0
6329;Praia de Belas;Guarujá;0;0;0;0;0;0
6330;Praia de Belas;Higienópolis;0;0;0;0;0;0
6331;Praia de Belas;Humaitá;50;0;29;10;0;50
6332;Praia de Belas;Hípica;0;0;0;0;0;0
6333;Praia de Belas;Independência;100;0;17;17;50;50
6334;Praia de Belas;Ipanema;150;50;61;16;50;100
6335;Praia de Belas;Jardim Botânico;250;0;136;71;0;250
6336;Praia de Belas;Jardim Carvalho;150;0;62;22;50;100
6337;Praia de Belas;Jardim Europa;0;0;0;0;0;0
6338;Praia de Belas;Jardim Floresta;0;0;0;0;0;0
6339;Praia de Belas;Jardim Isabel;50;0;29;11;0;50
6340;Praia de Belas;Jardim Itú;150;0;94;31;0;150
6341;Praia de Belas;Jardim Leopoldina;0;0;0;0;0;0
6342;Praia de Belas;Jardim Lindóia;0;0;0;0;0;0
6343;Praia de Belas;Jardim Sabará;50;0;0;0;50;0
6344;Praia de Belas;Jardim São Pedro;0;0;0;0;0;0
6345;Praia de Belas;Jardim do Salso;0;0;0;0;0;0
6346;Praia de Belas;Lageado;0;0;0;0;0;0
6347;Praia de Belas;Lami;0;0;0;0;0;0
6348;Praia de Belas;Lomba do Pinheiro;100;0;70;13;0;100
6349;Praia de Belas;Medianeira;200;50;59;25;100;100
6350;Praia de Belas;Menino Deus;2850;200;1309;620;500;2350
6351;Praia de Belas;Moinhos de Vento;0;0;0;0;0;0
6352;Praia de Belas;Mont'Serrat;100;100;0;0;100;0
6353;Praia de Belas;Morro Santana;50;0;50;0;50;0
6354;Praia de Belas;Mário Quintana;50;50;0;0;50;0
6355;Praia de Belas;Navegantes;100;50;25;10;50;50
6356;Praia de Belas;Nonoai;100;0;62;23;0;100
6357;Praia de Belas;Parque Santa Fé;50;0;0;0;50;0
6358;Praia de Belas;Partenon;250;0;115;42;50;200
6359;Praia de Belas;Passo D'Areia;50;50;0;0;50;0
6360;Praia de Belas;Passo das Pedras;50;0;29;14;0;50
6361;Praia de Belas;Pedra Redonda;0;0;0;0;0;0
6362;Praia de Belas;Petrópolis;300;50;76;33;150;150
6363;Praia de Belas;Pitinga;0;0;0;0;0;0
6364;Praia de Belas;Ponta Grossa;0;0;0;0;0;0
6365;Praia de Belas;Praia de Belas;200;100;50;22;100;100
6366;Praia de Belas;Restinga;0;0;0;0;0;0
6367;Praia de Belas;Rio Branco;150;0;33;12;100;50
6368;Praia de Belas;Rubem Berta;50;0;25;13;0;50
6369;Praia de Belas;Santa Cecília;50;0;0;0;50;0
6370;Praia de Belas;Santa Maria Goretti;0;0;0;0;0;0
6371;Praia de Belas;Santa Rosa de Lima;100;50;26;8;50;50
6372;Praia de Belas;Santa Tereza;950;350;208;64;600;350
6373;Praia de Belas;Santana;450;0;218;106;100;350
6374;Praia de Belas;Santo Antônio;150;50;57;27;50;100
6375;Praia de Belas;Sarandi;50;0;24;13;0;50
6376;Praia de Belas;Serraria;0;0;0;0;0;0
6377;Praia de Belas;São Caetano;0;0;0;0;0;0
6378;Praia de Belas;São Geraldo;150;0;31;8;100;50
6379;Praia de Belas;São José;0;0;0;0;0;0
6380;Praia de Belas;São João;50;0;0;0;50;0
6381;Praia de Belas;São Sebastião;100;100;0;0;100;0
6382;Praia de Belas;Sétimo Céu;0;0;0;0;0;0
6383;Praia de Belas;Teresópolis;150;0;86;21;0;150
6384;Praia de Belas;Tristeza;100;50;37;11;50;50
6385;Praia de Belas;Três Figueiras;50;0;33;7;0;50
6386;Praia de Belas;Vila Assunção;100;50;24;13;50;50
6387;Praia de Belas;Vila Conceição;0;0;0;0;0;0
6388;Praia de Belas;Vila Ipiranga;200;50;55;18;100;100
6389;Praia de Belas;Vila Jardim;100;0;30;6;50;50
6390;Praia de Belas;Vila João Pessoa;100;0;31;9;50;50
6391;Praia de Belas;Vila Nova;50;0;0;0;50;0
6392;Restinga;Aberta dos Morros;2250;800;610;168;1150;1100
6393;Restinga;Agronomia;200;50;84;23;50;150
6394;Restinga;Anchieta;50;50;0;0;50;0
6395;Restinga;Arquipélago;300;50;121;32;100;200
6396;Restinga;Auxiliadora;100;0;30;6;50;50
6397;Restinga;Azenha;50;0;26;12;0;50
6398;Restinga;Bela Vista;50;0;0;0;50;0
6399;Restinga;Belém Novo;550;200;147;39;300;250
6400;Restinga;Belém Velho;1550;200;679;144;450;1100
6401;Restinga;Boa Vista;100;50;29;13;50;50
6402;Restinga;Boa Vista do Sul;100;0;59;19;0;100
6403;Restinga;Bom Fim;100;0;33;5;50;50
6404;Restinga;Bom Jesus;150;50;64;14;50;100
6405;Restinga;Camaquã;300;50;143;33;50;250
6406;Restinga;Campo Novo;950;350;227;55;600;350
6407;Restinga;Cascata;550;200;145;41;300;250
6408;Restinga;Cavalhada;400;50;149;39;150;250
6409;Restinga;Cel. Aparício Borges;200;50;81;29;50;150
6410;Restinga;Centro Histórico;300;50;142;36;150;150
6411;Restinga;Chapéu do Sol;3850;150;2046;542;300;3550
6412;Restinga;Chácara das Pedras;100;50;25;8;50;50
6413;Restinga;Cidade Baixa;100;0;0;0;100;0
6414;Restinga;Costa e Silva;200;100;62;9;100;100
6415;Restinga;Cristal;50;0;30;7;0;50
6416;Restinga;Cristo Redentor;300;50;143;73;50;250
6417;Restinga;Espírito Santo;850;250;166;51;550;300
6418;Restinga;Extrema;200;0;123;25;0;200
6419;Restinga;Farrapos;300;50;144;38;50;250
6420;Restinga;Farroupilha;100;0;57;20;0;100
6421;Restinga;Floresta;100;0;68;23;0;100
6422;Restinga;Glória;500;50;244;74;50;450
6423;Restinga;Guarujá;1000;200;428;119;250;750
6424;Restinga;Higienópolis;50;0;0;0;50;0
6425;Restinga;Humaitá;400;50;154;40;150;250
6426;Restinga;Hípica;1450;300;530;140;550;900
6427;Restinga;Independência;50;0;50;0;50;0
6428;Restinga;Ipanema;700;100;277;61;250;450
6429;Restinga;Jardim Botânico;500;50;173;55;200;300
6430;Restinga;Jardim Carvalho;250;0;107;41;50;200
6431;Restinga;Jardim Europa;100;0;29;6;50;50
6432;Restinga;Jardim Floresta;250;0;106;31;50;200
6433;Restinga;Jardim Isabel;50;50;0;0;50;0
6434;Restinga;Jardim Itú;200;50;59;20;100;100
6435;Restinga;Jardim Leopoldina;200;0;114;24;0;200
6436;Restinga;Jardim Lindóia;100;50;29;7;50;50
6437;Restinga;Jardim Sabará;100;50;26;9;50;50
6438;Restinga;Jardim São Pedro;50;0;29;10;0;50
6439;Restinga;Jardim do Salso;150;0;92;21;0;150
6440;Restinga;Lageado;1200;150;474;102;500;700
6441;Restinga;Lami;200;0;75;35;50;150
6442;Restinga;Lomba do Pinheiro;1300;250;501;129;450;850
6443;Restinga;Medianeira;50;0;28;7;0;50
6444;Restinga;Menino Deus;300;100;81;36;150;150
6445;Restinga;Moinhos de Vento;50;50;0;0;50;0
6446;Restinga;Mont'Serrat;50;50;0;0;50;0
6447;Restinga;Morro Santana;100;0;49;16;0;100
6448;Restinga;Mário Quintana;150;50;57;13;50;100
6449;Restinga;Navegantes;100;50;27;12;50;50
6450;Restinga;Nonoai;200;0;120;26;0;200
6451;Restinga;Parque Santa Fé;350;50;107;34;150;200
6452;Restinga;Partenon;450;0;166;58;150;300
6453;Restinga;Passo D'Areia;250;0;45;27;150;100
6454;Restinga;Passo das Pedras;100;50;35;10;50;50
6455;Restinga;Pedra Redonda;250;0;83;21;100;150
6456;Restinga;Petrópolis;300;50;121;41;100;200
6457;Restinga;Pitinga;1900;150;967;248;300;1600
6458;Restinga;Ponta Grossa;150;0;77;23;0;150
6459;Restinga;Praia de Belas;0;0;0;0;0;0
6460;Restinga;Restinga;22900;600;12658;3408;1000;21900
6461;Restinga;Rio Branco;50;0;0;0;50;0
6462;Restinga;Rubem Berta;300;50;133;67;50;250
6463;Restinga;Santa Cecília;100;0;61;17;0;100
6464;Restinga;Santa Maria Goretti;100;0;24;6;50;50
6465;Restinga;Santa Rosa de Lima;350;50;143;20;150;200
6466;Restinga;Santa Tereza;100;50;25;11;50;50
6467;Restinga;Santana;200;50;76;6;150;50
6468;Restinga;Santo Antônio;50;50;0;0;50;0
6469;Restinga;Sarandi;100;50;26;11;50;50
6470;Restinga;Serraria;500;100;222;69;100;400
6471;Restinga;São Caetano;100;50;37;5;50;50
6472;Restinga;São Geraldo;0;0;0;0;0;0
6473;Restinga;São José;400;50;169;41;100;300
6474;Restinga;São João;50;0;32;2;0;50
6475;Restinga;São Sebastião;0;0;0;0;0;0
6476;Restinga;Sétimo Céu;250;50;82;23;100;150
6477;Restinga;Teresópolis;550;50;304;82;50;500
6478;Restinga;Tristeza;150;0;52;29;50;100
6479;Restinga;Três Figueiras;0;0;0;0;0;0
6480;Restinga;Vila Assunção;50;0;31;8;0;50
6481;Restinga;Vila Conceição;50;0;27;8;0;50
6482;Restinga;Vila Ipiranga;200;0;77;37;50;150
6483;Restinga;Vila Jardim;250;100;22;15;200;50
6484;Restinga;Vila João Pessoa;250;50;83;26;100;150
6485;Restinga;Vila Nova;1400;300;328;80;900;500
6486;Rio Branco;Aberta dos Morros;150;0;26;13;100;50
6487;Rio Branco;Agronomia;250;0;79;31;100;150
6488;Rio Branco;Anchieta;50;0;20;11;0;50
6489;Rio Branco;Arquipélago;50;0;26;9;0;50
6490;Rio Branco;Auxiliadora;550;150;53;34;450;100
6491;Rio Branco;Azenha;550;50;214;69;250;300
6492;Rio Branco;Bela Vista;4350;900;944;415;2850;1500
6493;Rio Branco;Belém Novo;50;0;24;23;0;50
6494;Rio Branco;Belém Velho;50;0;25;9;0;50
6495;Rio Branco;Boa Vista;400;0;179;108;50;350
6496;Rio Branco;Boa Vista do Sul;150;0;28;11;100;50
6497;Rio Branco;Bom Fim;2750;150;1146;658;450;2300
6498;Rio Branco;Bom Jesus;400;0;168;76;100;300
6499;Rio Branco;Camaquã;50;0;27;8;0;50
6500;Rio Branco;Campo Novo;50;0;30;14;0;50
6501;Rio Branco;Cascata;50;0;20;13;0;50
6502;Rio Branco;Cavalhada;0;0;0;0;0;0
6503;Rio Branco;Cel. Aparício Borges;100;50;28;5;50;50
6504;Rio Branco;Centro Histórico;1450;50;613;313;250;1200
6505;Rio Branco;Chapéu do Sol;250;100;85;45;100;150
6506;Rio Branco;Chácara das Pedras;250;50;87;46;100;150
6507;Rio Branco;Cidade Baixa;550;50;276;102;150;400
6508;Rio Branco;Costa e Silva;50;0;28;11;0;50
6509;Rio Branco;Cristal;150;0;28;8;100;50
6510;Rio Branco;Cristo Redentor;150;0;87;36;0;150
6511;Rio Branco;Espírito Santo;100;0;47;38;0;100
6512;Rio Branco;Extrema;50;0;28;11;0;50
6513;Rio Branco;Farrapos;50;0;29;4;0;50
6514;Rio Branco;Farroupilha;400;100;104;58;200;200
6515;Rio Branco;Floresta;850;100;305;145;300;550
6516;Rio Branco;Glória;250;200;0;0;250;0
6517;Rio Branco;Guarujá;50;0;33;16;0;50
6518;Rio Branco;Higienópolis;150;0;102;23;50;100
6519;Rio Branco;Humaitá;50;0;28;21;0;50
6520;Rio Branco;Hípica;100;50;25;8;50;50
6521;Rio Branco;Independência;1400;250;427;265;500;900
6522;Rio Branco;Ipanema;50;0;23;12;0;50
6523;Rio Branco;Jardim Botânico;500;50;249;84;200;300
6524;Rio Branco;Jardim Carvalho;150;0;105;24;50;100
6525;Rio Branco;Jardim Europa;250;50;85;46;100;150
6526;Rio Branco;Jardim Floresta;150;0;75;40;0;150
6527;Rio Branco;Jardim Isabel;0;0;0;0;0;0
6528;Rio Branco;Jardim Itú;200;50;28;22;150;50
6529;Rio Branco;Jardim Leopoldina;100;0;65;15;0;100
6530;Rio Branco;Jardim Lindóia;150;0;55;30;50;100
6531;Rio Branco;Jardim Sabará;100;50;33;14;50;50
6532;Rio Branco;Jardim São Pedro;300;100;111;51;100;200
6533;Rio Branco;Jardim do Salso;200;0;102;59;0;200
6534;Rio Branco;Lageado;0;0;0;0;0;0
6535;Rio Branco;Lami;0;0;0;0;0;0
6536;Rio Branco;Lomba do Pinheiro;150;0;59;16;50;100
6537;Rio Branco;Medianeira;250;0;129;68;0;250
6538;Rio Branco;Menino Deus;950;100;222;152;500;450
6539;Rio Branco;Moinhos de Vento;2700;400;966;631;1100;1600
6540;Rio Branco;Mont'Serrat;400;50;150;81;150;250
6541;Rio Branco;Morro Santana;100;0;53;18;0;100
6542;Rio Branco;Mário Quintana;200;50;62;8;100;100
6543;Rio Branco;Navegantes;100;0;25;19;50;50
6544;Rio Branco;Nonoai;100;0;57;19;0;100
6545;Rio Branco;Parque Santa Fé;50;0;28;17;0;50
6546;Rio Branco;Partenon;350;0;176;69;50;300
6547;Rio Branco;Passo D'Areia;350;50;103;70;150;200
6548;Rio Branco;Passo das Pedras;0;0;0;0;0;0
6549;Rio Branco;Pedra Redonda;150;0;95;38;0;150
6550;Rio Branco;Petrópolis;2850;150;1289;625;600;2250
6551;Rio Branco;Pitinga;0;0;0;0;0;0
6552;Rio Branco;Ponta Grossa;100;0;27;13;50;50
6553;Rio Branco;Praia de Belas;150;0;33;12;100;50
6554;Rio Branco;Restinga;50;0;0;0;50;0
6555;Rio Branco;Rio Branco;1100;100;536;258;200;900
6556;Rio Branco;Rubem Berta;150;50;25;18;100;50
6557;Rio Branco;Santa Cecília;2000;100;1009;504;250;1750
6558;Rio Branco;Santa Maria Goretti;150;50;57;31;50;100
6559;Rio Branco;Santa Rosa de Lima;100;0;63;16;0;100
6560;Rio Branco;Santa Tereza;500;50;252;98;50;450
6561;Rio Branco;Santana;350;100;148;64;100;250
6562;Rio Branco;Santo Antônio;600;150;107;52;400;200
6563;Rio Branco;Sarandi;350;0;166;91;50;300
6564;Rio Branco;Serraria;0;0;0;0;0;0
6565;Rio Branco;São Caetano;50;0;25;14;0;50
6566;Rio Branco;São Geraldo;200;0;75;39;50;150
6567;Rio Branco;São José;100;50;38;5;50;50
6568;Rio Branco;São João;350;50;128;78;100;250
6569;Rio Branco;São Sebastião;0;0;0;0;0;0
6570;Rio Branco;Sétimo Céu;100;0;51;32;0;100
6571;Rio Branco;Teresópolis;150;50;68;26;50;100
6572;Rio Branco;Tristeza;50;0;0;0;50;0
6573;Rio Branco;Três Figueiras;50;0;24;14;0;50
6574;Rio Branco;Vila Assunção;100;0;51;30;0;100
6575;Rio Branco;Vila Conceição;100;0;45;30;0;100
6576;Rio Branco;Vila Ipiranga;400;50;160;91;100;300
6577;Rio Branco;Vila Jardim;250;50;97;43;100;150
6578;Rio Branco;Vila João Pessoa;150;0;31;9;100;50
6579;Rio Branco;Vila Nova;100;50;34;9;50;50
6580;Rubem Berta;Aberta dos Morros;0;0;0;0;0;0
6581;Rubem Berta;Agronomia;50;0;19;26;0;50
6582;Rubem Berta;Anchieta;50;0;19;22;0;50
6583;Rubem Berta;Arquipélago;0;0;0;0;0;0
6584;Rubem Berta;Auxiliadora;50;50;0;0;50;0
6585;Rubem Berta;Azenha;400;100;149;66;200;200
6586;Rubem Berta;Bela Vista;100;0;23;16;50;50
6587;Rubem Berta;Belém Novo;50;0;22;25;0;50
6588;Rubem Berta;Belém Velho;150;0;74;32;0;150
6589;Rubem Berta;Boa Vista;100;0;23;18;50;50
6590;Rubem Berta;Boa Vista do Sul;200;0;104;68;0;200
6591;Rubem Berta;Bom Fim;300;50;69;62;150;150
6592;Rubem Berta;Bom Jesus;100;50;25;20;50;50
6593;Rubem Berta;Camaquã;50;50;0;0;50;0
6594;Rubem Berta;Campo Novo;150;0;50;41;50;100
6595;Rubem Berta;Cascata;100;50;31;6;50;50
6596;Rubem Berta;Cavalhada;100;0;43;36;0;100
6597;Rubem Berta;Cel. Aparício Borges;0;0;0;0;0;0
6598;Rubem Berta;Centro Histórico;0;0;0;0;0;0
6599;Rubem Berta;Chapéu do Sol;100;0;51;41;0;100
6600;Rubem Berta;Chácara das Pedras;0;0;0;0;0;0
6601;Rubem Berta;Cidade Baixa;200;0;44;39;100;100
6602;Rubem Berta;Costa e Silva;2750;650;910;463;1200;1550
6603;Rubem Berta;Cristal;250;50;85;35;100;150
6604;Rubem Berta;Cristo Redentor;200;100;44;44;100;100
6605;Rubem Berta;Espírito Santo;0;0;0;0;0;0
6606;Rubem Berta;Extrema;0;0;0;0;0;0
6607;Rubem Berta;Farrapos;50;0;34;4;0;50
6608;Rubem Berta;Farroupilha;100;0;0;0;100;0
6609;Rubem Berta;Floresta;350;0;177;83;100;250
6610;Rubem Berta;Glória;50;50;0;0;50;0
6611;Rubem Berta;Guarujá;0;0;0;0;0;0
6612;Rubem Berta;Higienópolis;50;50;0;0;50;0
6613;Rubem Berta;Humaitá;100;0;57;20;0;100
6614;Rubem Berta;Hípica;200;50;17;21;150;50
6615;Rubem Berta;Independência;50;0;31;16;0;50
6616;Rubem Berta;Ipanema;0;0;0;0;0;0
6617;Rubem Berta;Jardim Botânico;100;50;0;0;100;0
6618;Rubem Berta;Jardim Carvalho;300;0;121;84;50;250
6619;Rubem Berta;Jardim Europa;100;50;23;21;50;50
6620;Rubem Berta;Jardim Floresta;100;50;29;18;50;50
6621;Rubem Berta;Jardim Isabel;0;0;0;0;0;0
6622;Rubem Berta;Jardim Itú;850;350;185;145;450;400
6623;Rubem Berta;Jardim Leopoldina;3150;1000;727;410;1850;1300
6624;Rubem Berta;Jardim Lindóia;300;100;22;21;250;50
6625;Rubem Berta;Jardim Sabará;650;150;151;115;350;300
6626;Rubem Berta;Jardim São Pedro;150;50;40;43;50;100
6627;Rubem Berta;Jardim do Salso;50;0;27;13;0;50
6628;Rubem Berta;Lageado;250;250;0;0;250;0
6629;Rubem Berta;Lami;250;100;80;57;100;150
6630;Rubem Berta;Lomba do Pinheiro;200;0;106;36;0;200
6631;Rubem Berta;Medianeira;50;0;30;18;0;50
6632;Rubem Berta;Menino Deus;300;50;84;38;150;150
6633;Rubem Berta;Moinhos de Vento;100;0;48;36;0;100
6634;Rubem Berta;Mont'Serrat;300;50;98;60;100;200
6635;Rubem Berta;Morro Santana;1450;200;605;431;300;1150
6636;Rubem Berta;Mário Quintana;6250;550;2696;1133;1350;4900
6637;Rubem Berta;Navegantes;50;50;0;0;50;0
6638;Rubem Berta;Nonoai;200;50;87;38;50;150
6639;Rubem Berta;Parque Santa Fé;2450;500;926;544;850;1600
6640;Rubem Berta;Partenon;250;0;142;73;0;250
6641;Rubem Berta;Passo D'Areia;200;0;44;37;100;100
6642;Rubem Berta;Passo das Pedras;1400;300;522;384;350;1050
6643;Rubem Berta;Pedra Redonda;100;50;19;20;50;50
6644;Rubem Berta;Petrópolis;100;50;26;14;50;50
6645;Rubem Berta;Pitinga;50;0;35;5;0;50
6646;Rubem Berta;Ponta Grossa;100;0;49;10;0;100
6647;Rubem Berta;Praia de Belas;50;0;25;13;0;50
6648;Rubem Berta;Restinga;300;50;133;67;50;250
6649;Rubem Berta;Rio Branco;150;50;25;18;100;50
6650;Rubem Berta;Rubem Berta;23700;2900;9518;7262;4900;18800
6651;Rubem Berta;Santa Cecília;0;0;0;0;0;0
6652;Rubem Berta;Santa Maria Goretti;450;0;235;143;0;450
6653;Rubem Berta;Santa Rosa de Lima;4600;1600;794;234;3550;1050
6654;Rubem Berta;Santa Tereza;400;150;78;46;250;150
6655;Rubem Berta;Santana;150;50;49;33;50;100
6656;Rubem Berta;Santo Antônio;250;0;121;51;50;200
6657;Rubem Berta;Sarandi;900;50;354;262;150;750
6658;Rubem Berta;Serraria;100;0;22;15;50;50
6659;Rubem Berta;São Caetano;0;0;0;0;0;0
6660;Rubem Berta;São Geraldo;50;0;33;15;0;50
6661;Rubem Berta;São José;200;50;110;26;100;100
6662;Rubem Berta;São João;50;0;28;10;0;50
6663;Rubem Berta;São Sebastião;300;100;86;42;150;150
6664;Rubem Berta;Sétimo Céu;50;0;21;23;0;50
6665;Rubem Berta;Teresópolis;150;0;88;36;0;150
6666;Rubem Berta;Tristeza;100;0;44;34;0;100
6667;Rubem Berta;Três Figueiras;300;50;74;41;150;150
6668;Rubem Berta;Vila Assunção;50;50;0;0;50;0
6669;Rubem Berta;Vila Conceição;50;0;25;18;0;50
6670;Rubem Berta;Vila Ipiranga;350;50;116;100;100;250
6671;Rubem Berta;Vila Jardim;50;50;0;0;50;0
6672;Rubem Berta;Vila João Pessoa;50;0;25;19;0;50
6673;Rubem Berta;Vila Nova;250;0;76;38;100;150
6674;Santa Cecília;Aberta dos Morros;0;0;0;0;0;0
6675;Santa Cecília;Agronomia;0;0;0;0;0;0
6676;Santa Cecília;Anchieta;50;0;30;15;0;50
6677;Santa Cecília;Arquipélago;50;50;0;0;50;0
6678;Santa Cecília;Auxiliadora;50;0;25;12;0;50
6679;Santa Cecília;Azenha;400;50;118;52;200;200
6680;Santa Cecília;Bela Vista;1600;50;893;365;100;1500
6681;Santa Cecília;Belém Novo;50;0;23;16;0;50
6682;Santa Cecília;Belém Velho;250;50;111;51;50;200
6683;Santa Cecília;Boa Vista;300;0;137;71;50;250
6684;Santa Cecília;Boa Vista do Sul;50;50;0;0;50;0
6685;Santa Cecília;Bom Fim;600;100;95;58;400;200
6686;Santa Cecília;Bom Jesus;150;100;27;7;100;50
6687;Santa Cecília;Camaquã;150;50;57;19;50;100
6688;Santa Cecília;Campo Novo;100;0;54;27;0;100
6689;Santa Cecília;Cascata;350;50;177;57;50;300
6690;Santa Cecília;Cavalhada;150;0;60;24;50;100
6691;Santa Cecília;Cel. Aparício Borges;300;0;166;52;0;300
6692;Santa Cecília;Centro Histórico;450;50;24;18;400;50
6693;Santa Cecília;Chapéu do Sol;0;0;0;0;0;0
6694;Santa Cecília;Chácara das Pedras;100;0;25;14;50;50
6695;Santa Cecília;Cidade Baixa;150;0;94;29;0;150
6696;Santa Cecília;Costa e Silva;0;0;0;0;0;0
6697;Santa Cecília;Cristal;300;50;86;28;150;150
6698;Santa Cecília;Cristo Redentor;50;0;0;0;50;0
6699;Santa Cecília;Espírito Santo;0;0;0;0;0;0
6700;Santa Cecília;Extrema;0;0;0;0;0;0
6701;Santa Cecília;Farrapos;150;50;30;10;100;50
6702;Santa Cecília;Farroupilha;400;50;178;90;100;300
6703;Santa Cecília;Floresta;150;50;30;14;100;50
6704;Santa Cecília;Glória;150;50;48;27;50;100
6705;Santa Cecília;Guarujá;50;0;36;5;0;50
6706;Santa Cecília;Higienópolis;50;0;29;20;0;50
6707;Santa Cecília;Humaitá;100;0;63;19;0;100
6708;Santa Cecília;Hípica;200;0;62;25;100;100
6709;Santa Cecília;Independência;500;150;70;38;350;150
6710;Santa Cecília;Ipanema;0;0;0;0;0;0
6711;Santa Cecília;Jardim Botânico;450;100;107;58;250;200
6712;Santa Cecília;Jardim Carvalho;300;50;139;53;50;250
6713;Santa Cecília;Jardim Europa;100;0;0;0;100;0
6714;Santa Cecília;Jardim Floresta;100;0;51;35;0;100
6715;Santa Cecília;Jardim Isabel;0;0;0;0;0;0
6716;Santa Cecília;Jardim Itú;50;0;29;15;0;50
6717;Santa Cecília;Jardim Leopoldina;0;0;0;0;0;0
6718;Santa Cecília;Jardim Lindóia;100;0;74;13;50;50
6719;Santa Cecília;Jardim Sabará;50;0;23;17;0;50
6720;Santa Cecília;Jardim São Pedro;0;0;0;0;0;0
6721;Santa Cecília;Jardim do Salso;50;0;30;17;0;50
6722;Santa Cecília;Lageado;100;0;55;27;0;100
6723;Santa Cecília;Lami;50;0;0;0;50;0
6724;Santa Cecília;Lomba do Pinheiro;50;0;26;9;0;50
6725;Santa Cecília;Medianeira;300;100;106;52;100;200
6726;Santa Cecília;Menino Deus;750;50;259;156;250;500
6727;Santa Cecília;Moinhos de Vento;400;50;187;73;150;250
6728;Santa Cecília;Mont'Serrat;100;0;52;24;0;100
6729;Santa Cecília;Morro Santana;100;0;51;28;0;100
6730;Santa Cecília;Mário Quintana;100;0;66;19;0;100
6731;Santa Cecília;Navegantes;50;0;0;0;50;0
6732;Santa Cecília;Nonoai;200;50;84;41;50;150
6733;Santa Cecília;Parque Santa Fé;0;0;0;0;0;0
6734;Santa Cecília;Partenon;1450;250;679;244;300;1150
6735;Santa Cecília;Passo D'Areia;300;0;119;47;100;200
6736;Santa Cecília;Passo das Pedras;0;0;0;0;0;0
6737;Santa Cecília;Pedra Redonda;0;0;0;0;0;0
6738;Santa Cecília;Petrópolis;700;50;328;158;100;600
6739;Santa Cecília;Pitinga;0;0;0;0;0;0
6740;Santa Cecília;Ponta Grossa;0;0;0;0;0;0
6741;Santa Cecília;Praia de Belas;50;0;0;0;50;0
6742;Santa Cecília;Restinga;100;0;61;17;0;100
6743;Santa Cecília;Rio Branco;2000;100;1009;504;250;1750
6744;Santa Cecília;Rubem Berta;0;0;0;0;0;0
6745;Santa Cecília;Santa Cecília;2488;1400;134;56;2288;200
6746;Santa Cecília;Santa Maria Goretti;50;0;18;18;0;50
6747;Santa Cecília;Santa Rosa de Lima;200;50;40;5;150;50
6748;Santa Cecília;Santa Tereza;550;150;189;23;400;150
6749;Santa Cecília;Santana;550;150;121;53;350;200
6750;Santa Cecília;Santo Antônio;500;100;232;94;100;400
6751;Santa Cecília;Sarandi;100;0;31;15;50;50
6752;Santa Cecília;Serraria;0;0;0;0;0;0
6753;Santa Cecília;São Caetano;0;0;0;0;0;0
6754;Santa Cecília;São Geraldo;150;50;26;20;100;50
6755;Santa Cecília;São José;0;0;0;0;0;0
6756;Santa Cecília;São João;100;0;30;10;50;50
6757;Santa Cecília;São Sebastião;0;0;0;0;0;0
6758;Santa Cecília;Sétimo Céu;0;0;0;0;0;0
6759;Santa Cecília;Teresópolis;100;0;30;14;50;50
6760;Santa Cecília;Tristeza;0;0;0;0;0;0
6761;Santa Cecília;Três Figueiras;0;0;0;0;0;0
6762;Santa Cecília;Vila Assunção;0;0;0;0;0;0
6763;Santa Cecília;Vila Conceição;0;0;0;0;0;0
6764;Santa Cecília;Vila Ipiranga;350;100;112;49;150;200
6765;Santa Cecília;Vila Jardim;50;0;33;11;0;50
6766;Santa Cecília;Vila João Pessoa;100;0;60;23;0;100
6767;Santa Cecília;Vila Nova;100;50;23;8;50;50
6768;Santa Maria Goretti;Aberta dos Morros;100;50;39;2;50;50
6769;Santa Maria Goretti;Agronomia;50;0;37;2;0;50
6770;Santa Maria Goretti;Anchieta;450;200;91;10;300;150
6771;Santa Maria Goretti;Arquipélago;50;0;31;1;0;50
6772;Santa Maria Goretti;Auxiliadora;100;0;65;2;0;100
6773;Santa Maria Goretti;Azenha;200;50;60;15;100;100
6774;Santa Maria Goretti;Bela Vista;150;0;67;3;50;100
6775;Santa Maria Goretti;Belém Novo;0;0;0;0;0;0
6776;Santa Maria Goretti;Belém Velho;0;0;0;0;0;0
6777;Santa Maria Goretti;Boa Vista;750;0;395;92;200;550
6778;Santa Maria Goretti;Boa Vista do Sul;0;0;0;0;0;0
6779;Santa Maria Goretti;Bom Fim;50;0;21;16;0;50
6780;Santa Maria Goretti;Bom Jesus;150;0;55;18;50;100
6781;Santa Maria Goretti;Camaquã;0;0;0;0;0;0
6782;Santa Maria Goretti;Campo Novo;100;0;82;5;50;50
6783;Santa Maria Goretti;Cascata;50;0;37;2;0;50
6784;Santa Maria Goretti;Cavalhada;0;0;0;0;0;0
6785;Santa Maria Goretti;Cel. Aparício Borges;100;0;71;7;0;100
6786;Santa Maria Goretti;Centro Histórico;200;100;49;31;100;100
6787;Santa Maria Goretti;Chapéu do Sol;0;0;0;0;0;0
6788;Santa Maria Goretti;Chácara das Pedras;0;0;0;0;0;0
6789;Santa Maria Goretti;Cidade Baixa;100;0;56;24;0;100
6790;Santa Maria Goretti;Costa e Silva;50;0;39;7;0;50
6791;Santa Maria Goretti;Cristal;0;0;0;0;0;0
6792;Santa Maria Goretti;Cristo Redentor;1700;100;889;333;200;1500
6793;Santa Maria Goretti;Espírito Santo;0;0;0;0;0;0
6794;Santa Maria Goretti;Extrema;0;0;0;0;0;0
6795;Santa Maria Goretti;Farrapos;1000;400;134;19;800;200
6796;Santa Maria Goretti;Farroupilha;50;0;38;2;0;50
6797;Santa Maria Goretti;Floresta;150;50;29;12;100;50
6798;Santa Maria Goretti;Glória;50;0;27;9;0;50
6799;Santa Maria Goretti;Guarujá;100;0;63;16;0;100
6800;Santa Maria Goretti;Higienópolis;1050;300;328;100;500;550
6801;Santa Maria Goretti;Humaitá;350;150;37;8;300;50
6802;Santa Maria Goretti;Hípica;0;0;0;0;0;0
6803;Santa Maria Goretti;Independência;100;0;34;3;50;50
6804;Santa Maria Goretti;Ipanema;0;0;0;0;0;0
6805;Santa Maria Goretti;Jardim Botânico;150;50;56;19;50;100
6806;Santa Maria Goretti;Jardim Carvalho;100;0;0;0;100;0
6807;Santa Maria Goretti;Jardim Europa;100;0;73;14;0;100
6808;Santa Maria Goretti;Jardim Floresta;100;50;27;12;50;50
6809;Santa Maria Goretti;Jardim Isabel;0;0;0;0;0;0
6810;Santa Maria Goretti;Jardim Itú;400;0;237;84;0;400
6811;Santa Maria Goretti;Jardim Leopoldina;0;0;0;0;0;0
6812;Santa Maria Goretti;Jardim Lindóia;100;0;69;5;0;100
6813;Santa Maria Goretti;Jardim Sabará;200;50;68;19;100;100
6814;Santa Maria Goretti;Jardim São Pedro;1500;100;751;366;150;1350
6815;Santa Maria Goretti;Jardim do Salso;50;0;0;0;50;0
6816;Santa Maria Goretti;Lageado;0;0;0;0;0;0
6817;Santa Maria Goretti;Lami;0;0;0;0;0;0
6818;Santa Maria Goretti;Lomba do Pinheiro;0;0;0;0;0;0
6819;Santa Maria Goretti;Medianeira;0;0;0;0;0;0
6820;Santa Maria Goretti;Menino Deus;300;0;44;29;200;100
6821;Santa Maria Goretti;Moinhos de Vento;150;100;0;0;150;0
6822;Santa Maria Goretti;Mont'Serrat;150;0;101;8;0;150
6823;Santa Maria Goretti;Morro Santana;200;0;105;43;0;200
6824;Santa Maria Goretti;Mário Quintana;250;100;82;12;100;150
6825;Santa Maria Goretti;Navegantes;50;0;43;0;0;50
6826;Santa Maria Goretti;Nonoai;0;0;0;0;0;0
6827;Santa Maria Goretti;Parque Santa Fé;50;0;37;9;0;50
6828;Santa Maria Goretti;Partenon;250;0;86;26;100;150
6829;Santa Maria Goretti;Passo D'Areia;1600;150;495;463;300;1300
6830;Santa Maria Goretti;Passo das Pedras;100;100;0;0;100;0
6831;Santa Maria Goretti;Pedra Redonda;50;0;36;0;0;50
6832;Santa Maria Goretti;Petrópolis;450;0;206;90;100;350
6833;Santa Maria Goretti;Pitinga;50;0;35;1;0;50
6834;Santa Maria Goretti;Ponta Grossa;50;50;0;0;50;0
6835;Santa Maria Goretti;Praia de Belas;0;0;0;0;0;0
6836;Santa Maria Goretti;Restinga;100;0;24;6;50;50
6837;Santa Maria Goretti;Rio Branco;150;50;57;31;50;100
6838;Santa Maria Goretti;Rubem Berta;450;0;235;143;0;450
6839;Santa Maria Goretti;Santa Cecília;50;0;18;18;0;50
6840;Santa Maria Goretti;Santa Maria Goretti;1914;800;214;14;1614;300
6841;Santa Maria Goretti;Santa Rosa de Lima;300;100;125;31;100;200
6842;Santa Maria Goretti;Santa Tereza;100;50;25;11;50;50
6843;Santa Maria Goretti;Santana;250;0;62;18;150;100
6844;Santa Maria Goretti;Santo Antônio;0;0;0;0;0;0
6845;Santa Maria Goretti;Sarandi;250;0;113;53;50;200
6846;Santa Maria Goretti;Serraria;0;0;0;0;0;0
6847;Santa Maria Goretti;São Caetano;0;0;0;0;0;0
6848;Santa Maria Goretti;São Geraldo;50;50;0;0;50;0
6849;Santa Maria Goretti;São José;0;0;0;0;0;0
6850;Santa Maria Goretti;São João;500;150;52;27;400;100
6851;Santa Maria Goretti;São Sebastião;150;0;33;14;100;50
6852;Santa Maria Goretti;Sétimo Céu;0;0;0;0;0;0
6853;Santa Maria Goretti;Teresópolis;100;100;0;0;100;0
6854;Santa Maria Goretti;Tristeza;0;0;0;0;0;0
6855;Santa Maria Goretti;Três Figueiras;50;0;27;14;0;50
6856;Santa Maria Goretti;Vila Assunção;0;0;0;0;0;0
6857;Santa Maria Goretti;Vila Conceição;0;0;0;0;0;0
6858;Santa Maria Goretti;Vila Ipiranga;300;100;84;35;150;150
6859;Santa Maria Goretti;Vila Jardim;50;0;30;18;0;50
6860;Santa Maria Goretti;Vila João Pessoa;100;50;26;10;50;50
6861;Santa Maria Goretti;Vila Nova;150;50;53;16;50;100
6862;Santa Rosa de Lima;Aberta dos Morros;200;0;115;45;0;200
6863;Santa Rosa de Lima;Agronomia;200;0;124;37;0;200
6864;Santa Rosa de Lima;Anchieta;50;0;0;0;50;0
6865;Santa Rosa de Lima;Arquipélago;100;0;37;4;50;50
6866;Santa Rosa de Lima;Auxiliadora;100;0;59;16;0;100
6867;Santa Rosa de Lima;Azenha;150;0;90;40;0;150
6868;Santa Rosa de Lima;Bela Vista;100;0;0;0;100;0
6869;Santa Rosa de Lima;Belém Novo;250;100;28;10;200;50
6870;Santa Rosa de Lima;Belém Velho;350;50;144;50;100;250
6871;Santa Rosa de Lima;Boa Vista;200;50;77;37;50;150
6872;Santa Rosa de Lima;Boa Vista do Sul;200;50;88;23;50;150
6873;Santa Rosa de Lima;Bom Fim;0;0;0;0;0;0
6874;Santa Rosa de Lima;Bom Jesus;350;150;142;27;200;150
6875;Santa Rosa de Lima;Camaquã;150;0;53;18;50;100
6876;Santa Rosa de Lima;Campo Novo;50;0;0;0;50;0
6877;Santa Rosa de Lima;Cascata;150;50;84;3;100;50
6878;Santa Rosa de Lima;Cavalhada;250;0;139;46;0;250
6879;Santa Rosa de Lima;Cel. Aparício Borges;0;0;0;0;0;0
6880;Santa Rosa de Lima;Centro Histórico;50;0;27;12;0;50
6881;Santa Rosa de Lima;Chapéu do Sol;150;0;86;26;0;150
6882;Santa Rosa de Lima;Chácara das Pedras;150;50;66;17;50;100
6883;Santa Rosa de Lima;Cidade Baixa;0;0;0;0;0;0
6884;Santa Rosa de Lima;Costa e Silva;1700;400;611;152;800;900
6885;Santa Rosa de Lima;Cristal;0;0;0;0;0;0
6886;Santa Rosa de Lima;Cristo Redentor;250;0;140;37;100;150
6887;Santa Rosa de Lima;Espírito Santo;50;0;35;8;0;50
6888;Santa Rosa de Lima;Extrema;50;50;0;0;50;0
6889;Santa Rosa de Lima;Farrapos;100;0;49;17;0;100
6890;Santa Rosa de Lima;Farroupilha;100;50;23;13;50;50
6891;Santa Rosa de Lima;Floresta;0;0;0;0;0;0
6892;Santa Rosa de Lima;Glória;200;50;61;20;100;100
6893;Santa Rosa de Lima;Guarujá;50;50;0;0;50;0
6894;Santa Rosa de Lima;Higienópolis;50;0;25;5;0;50
6895;Santa Rosa de Lima;Humaitá;100;0;41;6;50;50
6896;Santa Rosa de Lima;Hípica;0;0;0;0;0;0
6897;Santa Rosa de Lima;Independência;50;0;0;0;50;0
6898;Santa Rosa de Lima;Ipanema;100;0;33;13;50;50
6899;Santa Rosa de Lima;Jardim Botânico;150;50;31;7;100;50
6900;Santa Rosa de Lima;Jardim Carvalho;150;0;84;30;0;150
6901;Santa Rosa de Lima;Jardim Europa;100;0;58;17;0;100
6902;Santa Rosa de Lima;Jardim Floresta;200;0;97;22;50;150
6903;Santa Rosa de Lima;Jardim Isabel;150;100;30;11;100;50
6904;Santa Rosa de Lima;Jardim Itú;500;100;232;73;100;400
6905;Santa Rosa de Lima;Jardim Leopoldina;2286;700;555;177;1386;900
6906;Santa Rosa de Lima;Jardim Lindóia;1200;100;656;196;150;1050
6907;Santa Rosa de Lima;Jardim Sabará;350;100;62;22;250;100
6908;Santa Rosa de Lima;Jardim São Pedro;150;50;0;0;150;0
6909;Santa Rosa de Lima;Jardim do Salso;0;0;0;0;0;0
6910;Santa Rosa de Lima;Lageado;100;0;31;8;50;50
6911;Santa Rosa de Lima;Lami;100;0;79;9;50;50
6912;Santa Rosa de Lima;Lomba do Pinheiro;100;50;0;0;100;0
6913;Santa Rosa de Lima;Medianeira;50;0;28;11;0;50
6914;Santa Rosa de Lima;Menino Deus;300;150;58;32;200;100
6915;Santa Rosa de Lima;Moinhos de Vento;150;50;53;14;50;100
6916;Santa Rosa de Lima;Mont'Serrat;250;50;87;32;100;150
6917;Santa Rosa de Lima;Morro Santana;250;50;69;17;150;100
6918;Santa Rosa de Lima;Mário Quintana;550;150;223;48;250;300
6919;Santa Rosa de Lima;Navegantes;100;0;33;8;50;50
6920;Santa Rosa de Lima;Nonoai;200;0;54;22;100;100
6921;Santa Rosa de Lima;Parque Santa Fé;7100;450;3764;1084;750;6350
6922;Santa Rosa de Lima;Partenon;450;50;243;87;50;400
6923;Santa Rosa de Lima;Passo D'Areia;850;100;386;121;200;650
6924;Santa Rosa de Lima;Passo das Pedras;1600;200;749;179;350;1250
6925;Santa Rosa de Lima;Pedra Redonda;150;50;27;9;100;50
6926;Santa Rosa de Lima;Petrópolis;200;0;82;27;50;150
6927;Santa Rosa de Lima;Pitinga;50;50;0;0;50;0
6928;Santa Rosa de Lima;Ponta Grossa;50;0;29;10;0;50
6929;Santa Rosa de Lima;Praia de Belas;100;50;26;8;50;50
6930;Santa Rosa de Lima;Restinga;350;50;143;20;150;200
6931;Santa Rosa de Lima;Rio Branco;100;0;63;16;0;100
6932;Santa Rosa de Lima;Rubem Berta;4600;1600;794;234;3550;1050
6933;Santa Rosa de Lima;Santa Cecília;200;50;40;5;150;50
6934;Santa Rosa de Lima;Santa Maria Goretti;300;100;125;31;100;200
6935;Santa Rosa de Lima;Santa Rosa de Lima;5200;800;2110;560;1600;3600
6936;Santa Rosa de Lima;Santa Tereza;300;50;100;30;150;150
6937;Santa Rosa de Lima;Santana;150;50;35;5;100;50
6938;Santa Rosa de Lima;Santo Antônio;200;0;81;25;50;150
6939;Santa Rosa de Lima;Sarandi;9050;750;3837;1751;2100;6950
6940;Santa Rosa de Lima;Serraria;350;0;110;33;150;200
6941;Santa Rosa de Lima;São Caetano;50;50;0;0;50;0
6942;Santa Rosa de Lima;São Geraldo;100;50;27;15;50;50
6943;Santa Rosa de Lima;São José;150;0;26;8;100;50
6944;Santa Rosa de Lima;São João;150;0;98;21;0;150
6945;Santa Rosa de Lima;São Sebastião;650;0;358;75;150;500
6946;Santa Rosa de Lima;Sétimo Céu;150;0;88;29;0;150
6947;Santa Rosa de Lima;Teresópolis;100;100;0;0;100;0
6948;Santa Rosa de Lima;Tristeza;100;0;53;42;0;100
6949;Santa Rosa de Lima;Três Figueiras;150;0;64;11;50;100
6950;Santa Rosa de Lima;Vila Assunção;50;0;28;13;0;50
6951;Santa Rosa de Lima;Vila Conceição;0;0;0;0;0;0
6952;Santa Rosa de Lima;Vila Ipiranga;150;100;0;0;150;0
6953;Santa Rosa de Lima;Vila Jardim;200;0;60;18;100;100
6954;Santa Rosa de Lima;Vila João Pessoa;50;0;28;12;0;50
6955;Santa Rosa de Lima;Vila Nova;350;0;128;51;100;250
6956;Santa Tereza;Aberta dos Morros;250;50;83;37;100;150
6957;Santa Tereza;Agronomia;200;50;84;21;50;150
6958;Santa Tereza;Anchieta;200;0;103;34;0;200
6959;Santa Tereza;Arquipélago;550;50;217;84;150;400
6960;Santa Tereza;Auxiliadora;150;50;55;19;50;100
6961;Santa Tereza;Azenha;1350;100;461;153;550;800
6962;Santa Tereza;Bela Vista;300;50;132;53;50;250
6963;Santa Tereza;Belém Novo;50;0;0;0;50;0
6964;Santa Tereza;Belém Velho;200;0;86;32;50;150
6965;Santa Tereza;Boa Vista;300;50;161;44;50;250
6966;Santa Tereza;Boa Vista do Sul;300;50;159;40;100;200
6967;Santa Tereza;Bom Fim;300;0;101;51;100;200
6968;Santa Tereza;Bom Jesus;350;50;134;48;100;250
6969;Santa Tereza;Camaquã;500;100;240;65;150;350
6970;Santa Tereza;Campo Novo;200;50;54;19;100;100
6971;Santa Tereza;Cascata;300;0;98;15;200;100
6972;Santa Tereza;Cavalhada;1450;200;655;225;350;1100
6973;Santa Tereza;Cel. Aparício Borges;2200;0;1219;409;50;2150
6974;Santa Tereza;Centro Histórico;600;50;234;89;150;450
6975;Santa Tereza;Chapéu do Sol;100;50;0;0;100;0
6976;Santa Tereza;Chácara das Pedras;300;150;32;8;250;50
6977;Santa Tereza;Cidade Baixa;600;0;205;69;200;400
6978;Santa Tereza;Costa e Silva;200;50;34;10;150;50
6979;Santa Tereza;Cristal;4400;650;2015;624;1150;3250
6980;Santa Tereza;Cristo Redentor;200;50;55;19;100;100
6981;Santa Tereza;Espírito Santo;150;0;80;28;0;150
6982;Santa Tereza;Extrema;150;0;97;26;0;150
6983;Santa Tereza;Farrapos;150;0;58;21;50;100
6984;Santa Tereza;Farroupilha;300;0;175;57;0;300
6985;Santa Tereza;Floresta;200;0;120;32;0;200
6986;Santa Tereza;Glória;1000;300;258;77;550;450
6987;Santa Tereza;Guarujá;250;50;100;43;50;200
6988;Santa Tereza;Higienópolis;100;50;26;11;50;50
6989;Santa Tereza;Humaitá;100;0;59;16;0;100
6990;Santa Tereza;Hípica;200;50;86;19;50;150
6991;Santa Tereza;Independência;450;50;172;68;100;350
6992;Santa Tereza;Ipanema;300;0;145;42;50;250
6993;Santa Tereza;Jardim Botânico;300;0;83;27;150;150
6994;Santa Tereza;Jardim Carvalho;150;50;26;7;100;50
6995;Santa Tereza;Jardim Europa;200;0;119;30;0;200
6996;Santa Tereza;Jardim Floresta;100;50;24;8;50;50
6997;Santa Tereza;Jardim Isabel;200;50;89;27;50;150
6998;Santa Tereza;Jardim Itú;400;50;207;42;150;250
6999;Santa Tereza;Jardim Leopoldina;100;50;29;9;50;50
7000;Santa Tereza;Jardim Lindóia;250;0;142;31;100;150
7001;Santa Tereza;Jardim Sabará;150;50;60;19;50;100
7002;Santa Tereza;Jardim São Pedro;100;0;29;6;50;50
7003;Santa Tereza;Jardim do Salso;100;0;59;22;0;100
7004;Santa Tereza;Lageado;150;50;34;10;100;50
7005;Santa Tereza;Lami;50;0;0;0;50;0
7006;Santa Tereza;Lomba do Pinheiro;700;150;264;58;400;300
7007;Santa Tereza;Medianeira;4500;2200;591;199;3500;1000
7008;Santa Tereza;Menino Deus;1450;250;617;215;500;950
7009;Santa Tereza;Moinhos de Vento;350;50;140;69;100;250
7010;Santa Tereza;Mont'Serrat;150;50;29;9;100;50
7011;Santa Tereza;Morro Santana;250;50;51;15;150;100
7012;Santa Tereza;Mário Quintana;250;50;115;25;50;200
7013;Santa Tereza;Navegantes;50;0;29;5;0;50
7014;Santa Tereza;Nonoai;6300;550;3158;964;1050;5250
7015;Santa Tereza;Parque Santa Fé;250;0;127;55;0;250
7016;Santa Tereza;Partenon;1000;150;412;133;250;750
7017;Santa Tereza;Passo D'Areia;450;250;0;0;450;0
7018;Santa Tereza;Passo das Pedras;250;0;147;49;0;250
7019;Santa Tereza;Pedra Redonda;150;100;24;13;100;50
7020;Santa Tereza;Petrópolis;700;50;281;128;200;500
7021;Santa Tereza;Pitinga;300;50;120;33;100;200
7022;Santa Tereza;Ponta Grossa;150;0;85;24;0;150
7023;Santa Tereza;Praia de Belas;950;350;208;64;600;350
7024;Santa Tereza;Restinga;100;50;25;11;50;50
7025;Santa Tereza;Rio Branco;500;50;252;98;50;450
7026;Santa Tereza;Rubem Berta;400;150;78;46;250;150
7027;Santa Tereza;Santa Cecília;550;150;189;23;400;150
7028;Santa Tereza;Santa Maria Goretti;100;50;25;11;50;50
7029;Santa Tereza;Santa Rosa de Lima;300;50;100;30;150;150
7030;Santa Tereza;Santa Tereza;7500;400;3918;1210;700;6800
7031;Santa Tereza;Santana;800;50;374;129;150;650
7032;Santa Tereza;Santo Antônio;700;150;343;91;200;500
7033;Santa Tereza;Sarandi;750;150;341;158;150;600
7034;Santa Tereza;Serraria;150;50;48;12;50;100
7035;Santa Tereza;São Caetano;400;0;174;61;100;300
7036;Santa Tereza;São Geraldo;350;100;108;30;250;100
7037;Santa Tereza;São José;250;0;82;25;100;150
7038;Santa Tereza;São João;150;0;86;29;0;150
7039;Santa Tereza;São Sebastião;100;0;24;8;50;50
7040;Santa Tereza;Sétimo Céu;250;50;118;32;50;200
7041;Santa Tereza;Teresópolis;1000;100;376;132;350;650
7042;Santa Tereza;Tristeza;900;400;168;85;600;300
7043;Santa Tereza;Três Figueiras;150;0;100;20;0;150
7044;Santa Tereza;Vila Assunção;200;100;30;10;150;50
7045;Santa Tereza;Vila Conceição;150;0;26;15;100;50
7046;Santa Tereza;Vila Ipiranga;300;50;141;50;50;250
7047;Santa Tereza;Vila Jardim;50;0;33;12;0;50
7048;Santa Tereza;Vila João Pessoa;450;200;147;54;200;250
7049;Santa Tereza;Vila Nova;200;50;53;23;100;100
7050;Santana;Aberta dos Morros;100;0;34;4;50;50
7051;Santana;Agronomia;50;0;18;11;0;50
7052;Santana;Anchieta;0;0;0;0;0;0
7053;Santana;Arquipélago;0;0;0;0;0;0
7054;Santana;Auxiliadora;250;0;84;45;100;150
7055;Santana;Azenha;1000;200;373;180;300;700
7056;Santana;Bela Vista;600;100;196;80;250;350
7057;Santana;Belém Novo;150;0;89;26;0;150
7058;Santana;Belém Velho;50;0;29;9;0;50
7059;Santana;Boa Vista;150;50;49;24;50;100
7060;Santana;Boa Vista do Sul;0;0;0;0;0;0
7061;Santana;Bom Fim;1100;150;344;212;400;700
7062;Santana;Bom Jesus;100;0;23;13;50;50
7063;Santana;Camaquã;0;0;0;0;0;0
7064;Santana;Campo Novo;100;0;30;10;50;50
7065;Santana;Cascata;50;0;0;0;50;0
7066;Santana;Cavalhada;300;50;129;76;50;250
7067;Santana;Cel. Aparício Borges;150;50;79;8;100;50
7068;Santana;Centro Histórico;900;0;212;103;500;400
7069;Santana;Chapéu do Sol;150;0;52;34;50;100
7070;Santana;Chácara das Pedras;150;0;70;48;0;150
7071;Santana;Cidade Baixa;7150;400;3444;1831;650;6500
7072;Santana;Costa e Silva;200;50;92;30;50;150
7073;Santana;Cristal;100;0;46;26;0;100
7074;Santana;Cristo Redentor;150;50;52;38;50;100
7075;Santana;Espírito Santo;100;50;0;0;100;0
7076;Santana;Extrema;50;0;32;8;0;50
7077;Santana;Farrapos;200;0;138;31;0;200
7078;Santana;Farroupilha;4750;1100;1047;343;3450;1300
7079;Santana;Floresta;250;150;34;12;200;50
7080;Santana;Glória;350;50;122;79;100;250
7081;Santana;Guarujá;0;0;0;0;0;0
7082;Santana;Higienópolis;100;0;63;21;0;100
7083;Santana;Humaitá;100;0;52;11;0;100
7084;Santana;Hípica;100;0;41;33;0;100
7085;Santana;Independência;650;100;211;81;350;300
7086;Santana;Ipanema;400;0;175;104;50;350
7087;Santana;Jardim Botânico;200;0;80;38;50;150
7088;Santana;Jardim Carvalho;100;0;35;7;50;50
7089;Santana;Jardim Europa;100;0;51;31;0;100
7090;Santana;Jardim Floresta;50;0;28;19;0;50
7091;Santana;Jardim Isabel;0;0;0;0;0;0
7092;Santana;Jardim Itú;100;0;69;25;0;100
7093;Santana;Jardim Leopoldina;100;0;0;0;100;0
7094;Santana;Jardim Lindóia;50;0;27;15;0;50
7095;Santana;Jardim Sabará;50;0;26;10;0;50
7096;Santana;Jardim São Pedro;100;0;27;16;50;50
7097;Santana;Jardim do Salso;300;50;48;25;200;100
7098;Santana;Lageado;0;0;0;0;0;0
7099;Santana;Lami;100;0;26;19;50;50
7100;Santana;Lomba do Pinheiro;50;0;0;0;50;0
7101;Santana;Medianeira;650;100;249;101;350;300
7102;Santana;Menino Deus;1200;150;380;209;450;750
7103;Santana;Moinhos de Vento;400;100;139;72;150;250
7104;Santana;Mont'Serrat;400;100;80;36;250;150
7105;Santana;Morro Santana;50;0;0;0;50;0
7106;Santana;Mário Quintana;200;0;92;23;50;150
7107;Santana;Navegantes;100;50;25;14;50;50
7108;Santana;Nonoai;350;200;51;17;250;100
7109;Santana;Parque Santa Fé;150;50;21;15;100;50
7110;Santana;Partenon;1350;150;625;175;550;800
7111;Santana;Passo D'Areia;200;50;50;27;100;100
7112;Santana;Passo das Pedras;150;0;50;21;50;100
7113;Santana;Pedra Redonda;50;50;0;0;50;0
7114;Santana;Petrópolis;800;50;251;144;300;500
7115;Santana;Pitinga;0;0;0;0;0;0
7116;Santana;Ponta Grossa;150;0;29;15;100;50
7117;Santana;Praia de Belas;450;0;218;106;100;350
7118;Santana;Restinga;200;50;76;6;150;50
7119;Santana;Rio Branco;350;100;148;64;100;250
7120;Santana;Rubem Berta;150;50;49;33;50;100
7121;Santana;Santa Cecília;550;150;121;53;350;200
7122;Santana;Santa Maria Goretti;250;0;62;18;150;100
7123;Santana;Santa Rosa de Lima;150;50;35;5;100;50
7124;Santana;Santa Tereza;800;50;374;129;150;650
7125;Santana;Santana;2000;500;790;446;500;1500
7126;Santana;Santo Antônio;1050;100;483;179;300;750
7127;Santana;Sarandi;400;50;163;56;200;200
7128;Santana;Serraria;100;0;28;9;50;50
7129;Santana;São Caetano;0;0;0;0;0;0
7130;Santana;São Geraldo;250;50;29;11;200;50
7131;Santana;São José;250;50;130;44;100;150
7132;Santana;São João;150;50;60;32;50;100
7133;Santana;São Sebastião;100;0;53;25;0;100
7134;Santana;Sétimo Céu;50;0;0;0;50;0
7135;Santana;Teresópolis;350;150;22;12;300;50
7136;Santana;Tristeza;50;0;0;0;50;0
7137;Santana;Três Figueiras;150;100;31;16;100;50
7138;Santana;Vila Assunção;50;0;24;17;0;50
7139;Santana;Vila Conceição;0;0;0;0;0;0
7140;Santana;Vila Ipiranga;250;0;88;32;100;150
7141;Santana;Vila Jardim;200;0;124;56;0;200
7142;Santana;Vila João Pessoa;250;50;53;22;150;100
7143;Santana;Vila Nova;150;50;62;20;50;100
7144;Santo Antônio;Aberta dos Morros;0;0;0;0;0;0
7145;Santo Antônio;Agronomia;0;0;0;0;0;0
7146;Santo Antônio;Anchieta;50;0;28;12;0;50
7147;Santo Antônio;Arquipélago;200;50;63;26;100;100
7148;Santo Antônio;Auxiliadora;100;50;0;0;100;0
7149;Santo Antônio;Azenha;1300;250;404;108;750;550
7150;Santo Antônio;Bela Vista;400;0;141;65;150;250
7151;Santo Antônio;Belém Novo;50;0;29;11;0;50
7152;Santo Antônio;Belém Velho;50;0;30;13;0;50
7153;Santo Antônio;Boa Vista;0;0;0;0;0;0
7154;Santo Antônio;Boa Vista do Sul;0;0;0;0;0;0
7155;Santo Antônio;Bom Fim;50;0;0;0;50;0
7156;Santo Antônio;Bom Jesus;250;0;150;44;0;250
7157;Santo Antônio;Camaquã;50;50;0;0;50;0
7158;Santo Antônio;Campo Novo;100;0;31;6;50;50
7159;Santo Antônio;Cascata;100;0;54;14;0;100
7160;Santo Antônio;Cavalhada;300;0;57;18;200;100
7161;Santo Antônio;Cel. Aparício Borges;650;150;226;77;250;400
7162;Santo Antônio;Centro Histórico;650;0;268;136;100;550
7163;Santo Antônio;Chapéu do Sol;50;50;0;0;50;0
7164;Santo Antônio;Chácara das Pedras;50;0;0;0;50;0
7165;Santo Antônio;Cidade Baixa;400;50;150;61;150;250
7166;Santo Antônio;Costa e Silva;50;0;0;0;50;0
7167;Santo Antônio;Cristal;250;100;53;20;150;100
7168;Santo Antônio;Cristo Redentor;50;0;33;11;0;50
7169;Santo Antônio;Espírito Santo;50;0;24;12;0;50
7170;Santo Antônio;Extrema;0;0;0;0;0;0
7171;Santo Antônio;Farrapos;50;0;27;9;0;50
7172;Santo Antônio;Farroupilha;200;50;86;33;50;150
7173;Santo Antônio;Floresta;150;0;77;45;0;150
7174;Santo Antônio;Glória;550;100;233;91;150;400
7175;Santo Antônio;Guarujá;0;0;0;0;0;0
7176;Santo Antônio;Higienópolis;0;0;0;0;0;0
7177;Santo Antônio;Humaitá;0;0;0;0;0;0
7178;Santo Antônio;Hípica;150;0;78;39;0;150
7179;Santo Antônio;Independência;150;0;69;18;100;50
7180;Santo Antônio;Ipanema;200;0;93;34;50;150
7181;Santo Antônio;Jardim Botânico;500;50;186;63;250;250
7182;Santo Antônio;Jardim Carvalho;150;50;65;26;50;100
7183;Santo Antônio;Jardim Europa;0;0;0;0;0;0
7184;Santo Antônio;Jardim Floresta;50;0;0;0;50;0
7185;Santo Antônio;Jardim Isabel;100;0;68;13;0;100
7186;Santo Antônio;Jardim Itú;100;0;56;31;0;100
7187;Santo Antônio;Jardim Leopoldina;50;0;29;7;0;50
7188;Santo Antônio;Jardim Lindóia;0;0;0;0;0;0
7189;Santo Antônio;Jardim Sabará;100;0;53;16;0;100
7190;Santo Antônio;Jardim São Pedro;0;0;0;0;0;0
7191;Santo Antônio;Jardim do Salso;150;0;89;36;0;150
7192;Santo Antônio;Lageado;100;0;29;11;50;50
7193;Santo Antônio;Lami;200;50;59;27;100;100
7194;Santo Antônio;Lomba do Pinheiro;0;0;0;0;0;0
7195;Santo Antônio;Medianeira;1200;200;309;123;700;500
7196;Santo Antônio;Menino Deus;900;150;255;113;450;450
7197;Santo Antônio;Moinhos de Vento;200;0;122;51;50;150
7198;Santo Antônio;Mont'Serrat;0;0;0;0;0;0
7199;Santo Antônio;Morro Santana;100;0;59;17;0;100
7200;Santo Antônio;Mário Quintana;100;0;61;10;0;100
7201;Santo Antônio;Navegantes;100;0;56;28;0;100
7202;Santo Antônio;Nonoai;150;0;92;30;0;150
7203;Santo Antônio;Parque Santa Fé;0;0;0;0;0;0
7204;Santo Antônio;Partenon;5650;300;2704;1153;750;4900
7205;Santo Antônio;Passo D'Areia;300;0;123;123;0;300
7206;Santo Antônio;Passo das Pedras;0;0;0;0;0;0
7207;Santo Antônio;Pedra Redonda;0;0;0;0;0;0
7208;Santo Antônio;Petrópolis;500;0;254;115;50;450
7209;Santo Antônio;Pitinga;150;0;109;22;50;100
7210;Santo Antônio;Ponta Grossa;50;0;33;9;0;50
7211;Santo Antônio;Praia de Belas;150;50;57;27;50;100
7212;Santo Antônio;Restinga;50;50;0;0;50;0
7213;Santo Antônio;Rio Branco;600;150;107;52;400;200
7214;Santo Antônio;Rubem Berta;250;0;121;51;50;200
7215;Santo Antônio;Santa Cecília;500;100;232;94;100;400
7216;Santo Antônio;Santa Maria Goretti;0;0;0;0;0;0
7217;Santo Antônio;Santa Rosa de Lima;200;0;81;25;50;150
7218;Santo Antônio;Santa Tereza;700;150;343;91;200;500
7219;Santo Antônio;Santana;1050;100;483;179;300;750
7220;Santo Antônio;Santo Antônio;2100;600;620;264;1000;1100
7221;Santo Antônio;Sarandi;250;0;84;42;100;150
7222;Santo Antônio;Serraria;0;0;0;0;0;0
7223;Santo Antônio;São Caetano;100;0;23;12;50;50
7224;Santo Antônio;São Geraldo;100;0;72;14;50;50
7225;Santo Antônio;São José;100;0;29;14;50;50
7226;Santo Antônio;São João;50;0;22;13;0;50
7227;Santo Antônio;São Sebastião;50;50;0;0;50;0
7228;Santo Antônio;Sétimo Céu;50;0;0;0;50;0
7229;Santo Antônio;Teresópolis;250;100;86;40;100;150
7230;Santo Antônio;Tristeza;200;150;29;16;150;50
7231;Santo Antônio;Três Figueiras;133;50;29;9;83;50
7232;Santo Antônio;Vila Assunção;50;50;0;0;50;0
7233;Santo Antônio;Vila Conceição;50;50;0;0;50;0
7234;Santo Antônio;Vila Ipiranga;100;0;55;32;0;100
7235;Santo Antônio;Vila Jardim;150;0;50;35;50;100
7236;Santo Antônio;Vila João Pessoa;550;50;79;39;400;150
7237;Santo Antônio;Vila Nova;100;0;56;17;0;100
7238;Sarandi;Aberta dos Morros;50;0;22;16;0;50
7239;Sarandi;Agronomia;50;50;0;0;50;0
7240;Sarandi;Anchieta;1700;150;871;356;350;1350
7241;Sarandi;Arquipélago;200;50;62;20;100;100
7242;Sarandi;Auxiliadora;150;50;22;20;100;50
7243;Sarandi;Azenha;200;0;109;56;0;200
7244;Sarandi;Bela Vista;250;50;72;37;100;150
7245;Sarandi;Belém Novo;100;50;25;19;50;50
7246;Sarandi;Belém Velho;600;50;267;126;100;500
7247;Sarandi;Boa Vista;150;50;60;25;50;100
7248;Sarandi;Boa Vista do Sul;250;0;107;52;50;200
7249;Sarandi;Bom Fim;450;50;229;106;50;400
7250;Sarandi;Bom Jesus;250;0;121;38;50;200
7251;Sarandi;Camaquã;50;0;26;16;0;50
7252;Sarandi;Campo Novo;400;100;171;78;100;300
7253;Sarandi;Cascata;350;50;82;35;200;150
7254;Sarandi;Cavalhada;250;0;106;50;50;200
7255;Sarandi;Cel. Aparício Borges;400;100;58;20;300;100
7256;Sarandi;Centro Histórico;250;50;110;47;50;200
7257;Sarandi;Chapéu do Sol;100;0;55;28;0;100
7258;Sarandi;Chácara das Pedras;750;100;221;107;350;400
7259;Sarandi;Cidade Baixa;350;150;25;15;300;50
7260;Sarandi;Costa e Silva;1100;100;543;204;200;900
7261;Sarandi;Cristal;550;100;233;101;150;400
7262;Sarandi;Cristo Redentor;1000;150;409;208;300;700
7263;Sarandi;Espírito Santo;150;0;49;40;50;100
7264;Sarandi;Extrema;50;0;29;12;0;50
7265;Sarandi;Farrapos;450;50;193;102;100;350
7266;Sarandi;Farroupilha;300;0;134;43;150;150
7267;Sarandi;Floresta;400;0;196;65;150;250
7268;Sarandi;Glória;250;50;86;33;100;150
7269;Sarandi;Guarujá;200;50;52;27;100;100
7270;Sarandi;Higienópolis;750;0;342;180;100;650
7271;Sarandi;Humaitá;300;100;87;30;150;150
7272;Sarandi;Hípica;50;0;28;7;0;50
7273;Sarandi;Independência;300;150;58;25;200;100
7274;Sarandi;Ipanema;50;0;22;16;0;50
7275;Sarandi;Jardim Botânico;100;50;0;0;100;0
7276;Sarandi;Jardim Carvalho;250;50;95;36;100;150
7277;Sarandi;Jardim Europa;950;0;429;218;150;800
7278;Sarandi;Jardim Floresta;800;100;354;153;250;550
7279;Sarandi;Jardim Isabel;100;0;66;23;0;100
7280;Sarandi;Jardim Itú;450;0;175;83;150;300
7281;Sarandi;Jardim Leopoldina;400;0;170;67;100;300
7282;Sarandi;Jardim Lindóia;950;50;407;204;200;750
7283;Sarandi;Jardim Sabará;500;0;230;100;150;350
7284;Sarandi;Jardim São Pedro;800;0;367;157;200;600
7285;Sarandi;Jardim do Salso;300;0;82;33;150;150
7286;Sarandi;Lageado;0;0;0;0;0;0
7287;Sarandi;Lami;200;0;30;13;150;50
7288;Sarandi;Lomba do Pinheiro;100;50;30;12;50;50
7289;Sarandi;Medianeira;50;0;0;0;50;0
7290;Sarandi;Menino Deus;1050;150;461;222;200;850
7291;Sarandi;Moinhos de Vento;450;100;194;103;100;350
7292;Sarandi;Mont'Serrat;100;50;0;0;100;0
7293;Sarandi;Morro Santana;450;0;263;105;50;400
7294;Sarandi;Mário Quintana;350;50;125;36;150;200
7295;Sarandi;Navegantes;200;100;78;16;150;50
7296;Sarandi;Nonoai;550;150;102;62;350;200
7297;Sarandi;Parque Santa Fé;1150;100;451;215;400;750
7298;Sarandi;Partenon;400;50;153;54;150;250
7299;Sarandi;Passo D'Areia;550;100;154;113;200;350
7300;Sarandi;Passo das Pedras;650;150;149;98;350;300
7301;Sarandi;Pedra Redonda;50;0;28;13;0;50
7302;Sarandi;Petrópolis;250;50;97;55;50;200
7303;Sarandi;Pitinga;250;50;103;24;150;100
7304;Sarandi;Ponta Grossa;100;0;0;0;100;0
7305;Sarandi;Praia de Belas;50;0;24;13;0;50
7306;Sarandi;Restinga;100;50;26;11;50;50
7307;Sarandi;Rio Branco;350;0;166;91;50;300
7308;Sarandi;Rubem Berta;900;50;354;262;150;750
7309;Sarandi;Santa Cecília;100;0;31;15;50;50
7310;Sarandi;Santa Maria Goretti;250;0;113;53;50;200
7311;Sarandi;Santa Rosa de Lima;9050;750;3837;1751;2100;6950
7312;Sarandi;Santa Tereza;750;150;341;158;150;600
7313;Sarandi;Santana;400;50;163;56;200;200
7314;Sarandi;Santo Antônio;250;0;84;42;100;150
7315;Sarandi;Sarandi;11700;2600;2826;1240;7100;4600
7316;Sarandi;Serraria;300;150;85;41;150;150
7317;Sarandi;São Caetano;250;100;77;14;200;50
7318;Sarandi;São Geraldo;0;0;0;0;0;0
7319;Sarandi;São José;350;50;113;47;150;200
7320;Sarandi;São João;250;50;50;33;150;100
7321;Sarandi;São Sebastião;750;50;262;118;250;500
7322;Sarandi;Sétimo Céu;150;50;23;11;100;50
7323;Sarandi;Teresópolis;350;50;164;86;50;300
7324;Sarandi;Tristeza;250;0;138;62;0;250
7325;Sarandi;Três Figueiras;100;50;23;14;50;50
7326;Sarandi;Vila Assunção;100;0;59;28;0;100
7327;Sarandi;Vila Conceição;150;0;90;39;0;150
7328;Sarandi;Vila Ipiranga;550;50;259;110;100;450
7329;Sarandi;Vila Jardim;400;0;191;101;50;350
7330;Sarandi;Vila João Pessoa;50;0;25;13;0;50
7331;Sarandi;Vila Nova;450;50;202;80;100;350
7332;Serraria;Aberta dos Morros;900;250;152;61;600;300
7333;Serraria;Agronomia;0;0;0;0;0;0
7334;Serraria;Anchieta;100;0;48;23;0;100
7335;Serraria;Arquipélago;200;50;56;23;100;100
7336;Serraria;Auxiliadora;50;0;21;17;0;50
7337;Serraria;Azenha;50;0;0;0;50;0
7338;Serraria;Bela Vista;50;50;0;0;50;0
7339;Serraria;Belém Novo;200;0;110;51;0;200
7340;Serraria;Belém Velho;200;0;142;38;0;200
7341;Serraria;Boa Vista;0;0;0;0;0;0
7342;Serraria;Boa Vista do Sul;50;0;0;0;50;0
7343;Serraria;Bom Fim;50;0;21;11;0;50
7344;Serraria;Bom Jesus;150;0;92;26;0;150
7345;Serraria;Camaquã;0;0;0;0;0;0
7346;Serraria;Campo Novo;200;0;124;48;0;200
7347;Serraria;Cascata;150;0;101;21;0;150
7348;Serraria;Cavalhada;350;0;209;74;0;350
7349;Serraria;Cel. Aparício Borges;100;0;29;10;50;50
7350;Serraria;Centro Histórico;200;50;99;30;50;150
7351;Serraria;Chapéu do Sol;100;0;61;14;0;100
7352;Serraria;Chácara das Pedras;0;0;0;0;0;0
7353;Serraria;Cidade Baixa;100;50;0;0;100;0
7354;Serraria;Costa e Silva;0;0;0;0;0;0
7355;Serraria;Cristal;150;0;58;24;50;100
7356;Serraria;Cristo Redentor;0;0;0;0;0;0
7357;Serraria;Espírito Santo;1150;300;301;115;600;550
7358;Serraria;Extrema;0;0;0;0;0;0
7359;Serraria;Farrapos;50;0;34;9;0;50
7360;Serraria;Farroupilha;0;0;0;0;0;0
7361;Serraria;Floresta;50;50;0;0;50;0
7362;Serraria;Glória;50;0;22;17;0;50
7363;Serraria;Guarujá;1800;650;483;159;1050;750
7364;Serraria;Higienópolis;0;0;0;0;0;0
7365;Serraria;Humaitá;0;0;0;0;0;0
7366;Serraria;Hípica;600;50;319;84;100;500
7367;Serraria;Independência;0;0;0;0;0;0
7368;Serraria;Ipanema;750;50;357;107;150;600
7369;Serraria;Jardim Botânico;50;0;32;12;0;50
7370;Serraria;Jardim Carvalho;50;0;35;9;0;50
7371;Serraria;Jardim Europa;50;0;0;0;50;0
7372;Serraria;Jardim Floresta;0;0;0;0;0;0
7373;Serraria;Jardim Isabel;50;0;24;5;0;50
7374;Serraria;Jardim Itú;0;0;0;0;0;0
7375;Serraria;Jardim Leopoldina;50;0;0;0;50;0
7376;Serraria;Jardim Lindóia;100;0;0;0;100;0
7377;Serraria;Jardim Sabará;50;0;0;0;50;0
7378;Serraria;Jardim São Pedro;0;0;0;0;0;0
7379;Serraria;Jardim do Salso;0;0;0;0;0;0
7380;Serraria;Lageado;0;0;0;0;0;0
7381;Serraria;Lami;0;0;0;0;0;0
7382;Serraria;Lomba do Pinheiro;150;0;60;11;50;100
7383;Serraria;Medianeira;50;50;0;0;50;0
7384;Serraria;Menino Deus;200;0;115;49;0;200
7385;Serraria;Moinhos de Vento;50;0;23;20;0;50
7386;Serraria;Mont'Serrat;0;0;0;0;0;0
7387;Serraria;Morro Santana;50;0;32;2;0;50
7388;Serraria;Mário Quintana;50;0;34;6;0;50
7389;Serraria;Navegantes;0;0;0;0;0;0
7390;Serraria;Nonoai;200;50;81;10;150;50
7391;Serraria;Parque Santa Fé;0;0;0;0;0;0
7392;Serraria;Partenon;300;50;89;37;150;150
7393;Serraria;Passo D'Areia;50;0;0;0;50;0
7394;Serraria;Passo das Pedras;0;0;0;0;0;0
7395;Serraria;Pedra Redonda;150;50;50;18;50;100
7396;Serraria;Petrópolis;50;0;24;21;0;50
7397;Serraria;Pitinga;50;0;27;9;0;50
7398;Serraria;Ponta Grossa;1000;150;451;131;250;750
7399;Serraria;Praia de Belas;0;0;0;0;0;0
7400;Serraria;Restinga;500;100;222;69;100;400
7401;Serraria;Rio Branco;0;0;0;0;0;0
7402;Serraria;Rubem Berta;100;0;22;15;50;50
7403;Serraria;Santa Cecília;0;0;0;0;0;0
7404;Serraria;Santa Maria Goretti;0;0;0;0;0;0
7405;Serraria;Santa Rosa de Lima;350;0;110;33;150;200
7406;Serraria;Santa Tereza;150;50;48;12;50;100
7407;Serraria;Santana;100;0;28;9;50;50
7408;Serraria;Santo Antônio;0;0;0;0;0;0
7409;Serraria;Sarandi;300;150;85;41;150;150
7410;Serraria;Serraria;2974;700;574;164;2074;900
7411;Serraria;São Caetano;0;0;0;0;0;0
7412;Serraria;São Geraldo;0;0;0;0;0;0
7413;Serraria;São José;200;0;88;33;50;150
7414;Serraria;São João;50;0;30;9;0;50
7415;Serraria;São Sebastião;50;0;32;9;0;50
7416;Serraria;Sétimo Céu;100;0;50;10;0;100
7417;Serraria;Teresópolis;50;0;30;7;0;50
7418;Serraria;Tristeza;250;50;104;34;100;150
7419;Serraria;Três Figueiras;50;0;29;12;0;50
7420;Serraria;Vila Assunção;0;0;0;0;0;0
7421;Serraria;Vila Conceição;150;0;92;25;0;150
7422;Serraria;Vila Ipiranga;100;0;59;26;0;100
7423;Serraria;Vila Jardim;50;50;0;0;50;0
7424;Serraria;Vila João Pessoa;150;0;90;28;0;150
7425;Serraria;Vila Nova;200;0;79;24;50;150
7426;São Caetano;Aberta dos Morros;0;0;0;0;0;0
7427;São Caetano;Agronomia;0;0;0;0;0;0
7428;São Caetano;Anchieta;0;0;0;0;0;0
7429;São Caetano;Arquipélago;0;0;0;0;0;0
7430;São Caetano;Auxiliadora;50;0;28;21;0;50
7431;São Caetano;Azenha;200;50;47;30;100;100
7432;São Caetano;Bela Vista;0;0;0;0;0;0
7433;São Caetano;Belém Novo;100;50;0;0;100;0
7434;São Caetano;Belém Velho;150;0;103;29;0;150
7435;São Caetano;Boa Vista;50;0;50;0;50;0
7436;São Caetano;Boa Vista do Sul;50;0;23;12;0;50
7437;São Caetano;Bom Fim;0;0;0;0;0;0
7438;São Caetano;Bom Jesus;100;0;27;7;50;50
7439;São Caetano;Camaquã;0;0;0;0;0;0
7440;São Caetano;Campo Novo;0;0;0;0;0;0
7441;São Caetano;Cascata;100;50;32;8;50;50
7442;São Caetano;Cavalhada;100;50;36;9;50;50
7443;São Caetano;Cel. Aparício Borges;150;50;0;0;150;0
7444;São Caetano;Centro Histórico;250;0;137;42;100;150
7445;São Caetano;Chapéu do Sol;0;0;0;0;0;0
7446;São Caetano;Chácara das Pedras;0;0;0;0;0;0
7447;São Caetano;Cidade Baixa;100;50;29;13;50;50
7448;São Caetano;Costa e Silva;0;0;0;0;0;0
7449;São Caetano;Cristal;150;50;51;15;50;100
7450;São Caetano;Cristo Redentor;0;0;0;0;0;0
7451;São Caetano;Espírito Santo;0;0;0;0;0;0
7452;São Caetano;Extrema;100;0;60;21;0;100
7453;São Caetano;Farrapos;0;0;0;0;0;0
7454;São Caetano;Farroupilha;0;0;0;0;0;0
7455;São Caetano;Floresta;0;0;0;0;0;0
7456;São Caetano;Glória;50;0;22;13;0;50
7457;São Caetano;Guarujá;0;0;0;0;0;0
7458;São Caetano;Higienópolis;50;0;0;0;50;0
7459;São Caetano;Humaitá;50;0;39;7;0;50
7460;São Caetano;Hípica;150;50;33;8;100;50
7461;São Caetano;Independência;50;0;0;0;50;0
7462;São Caetano;Ipanema;100;50;21;10;50;50
7463;São Caetano;Jardim Botânico;50;0;31;13;0;50
7464;São Caetano;Jardim Carvalho;150;0;76;18;50;100
7465;São Caetano;Jardim Europa;0;0;0;0;0;0
7466;São Caetano;Jardim Floresta;0;0;0;0;0;0
7467;São Caetano;Jardim Isabel;0;0;0;0;0;0
7468;São Caetano;Jardim Itú;100;0;55;27;0;100
7469;São Caetano;Jardim Leopoldina;100;0;59;14;0;100
7470;São Caetano;Jardim Lindóia;0;0;0;0;0;0
7471;São Caetano;Jardim Sabará;0;0;0;0;0;0
7472;São Caetano;Jardim São Pedro;0;0;0;0;0;0
7473;São Caetano;Jardim do Salso;50;0;35;12;0;50
7474;São Caetano;Lageado;1800;300;666;167;700;1100
7475;São Caetano;Lami;650;100;321;84;100;550
7476;São Caetano;Lomba do Pinheiro;100;0;34;9;50;50
7477;São Caetano;Medianeira;50;0;0;0;50;0
7478;São Caetano;Menino Deus;50;0;28;20;0;50
7479;São Caetano;Moinhos de Vento;50;50;0;0;50;0
7480;São Caetano;Mont'Serrat;0;0;0;0;0;0
7481;São Caetano;Morro Santana;150;50;60;14;50;100
7482;São Caetano;Mário Quintana;0;0;0;0;0;0
7483;São Caetano;Navegantes;0;0;0;0;0;0
7484;São Caetano;Nonoai;150;0;85;25;0;150
7485;São Caetano;Parque Santa Fé;0;0;0;0;0;0
7486;São Caetano;Partenon;450;50;200;71;100;350
7487;São Caetano;Passo D'Areia;100;50;0;0;100;0
7488;São Caetano;Passo das Pedras;0;0;0;0;0;0
7489;São Caetano;Pedra Redonda;0;0;0;0;0;0
7490;São Caetano;Petrópolis;50;50;0;0;50;0
7491;São Caetano;Pitinga;0;0;0;0;0;0
7492;São Caetano;Ponta Grossa;0;0;0;0;0;0
7493;São Caetano;Praia de Belas;0;0;0;0;0;0
7494;São Caetano;Restinga;100;50;37;5;50;50
7495;São Caetano;Rio Branco;50;0;25;14;0;50
7496;São Caetano;Rubem Berta;0;0;0;0;0;0
7497;São Caetano;Santa Cecília;0;0;0;0;0;0
7498;São Caetano;Santa Maria Goretti;0;0;0;0;0;0
7499;São Caetano;Santa Rosa de Lima;50;50;0;0;50;0
7500;São Caetano;Santa Tereza;400;0;174;61;100;300
7501;São Caetano;Santana;0;0;0;0;0;0
7502;São Caetano;Santo Antônio;100;0;23;12;50;50
7503;São Caetano;Sarandi;250;100;77;14;200;50
7504;São Caetano;Serraria;0;0;0;0;0;0
7505;São Caetano;São Caetano;410;0;252;88;10;400
7506;São Caetano;São Geraldo;0;0;0;0;0;0
7507;São Caetano;São José;50;0;27;7;0;50
7508;São Caetano;São João;0;0;0;0;0;0
7509;São Caetano;São Sebastião;0;0;0;0;0;0
7510;São Caetano;Sétimo Céu;0;0;0;0;0;0
7511;São Caetano;Teresópolis;50;0;0;0;50;0
7512;São Caetano;Tristeza;0;0;0;0;0;0
7513;São Caetano;Três Figueiras;0;0;0;0;0;0
7514;São Caetano;Vila Assunção;0;0;0;0;0;0
7515;São Caetano;Vila Conceição;0;0;0;0;0;0
7516;São Caetano;Vila Ipiranga;0;0;0;0;0;0
7517;São Caetano;Vila Jardim;150;50;58;26;50;100
7518;São Caetano;Vila João Pessoa;50;0;33;13;0;50
7519;São Caetano;Vila Nova;100;50;24;14;50;50
7520;São Geraldo;Aberta dos Morros;50;0;34;15;0;50
7521;São Geraldo;Agronomia;100;0;0;0;100;0
7522;São Geraldo;Anchieta;100;0;51;39;0;100
7523;São Geraldo;Arquipélago;100;0;24;8;50;50
7524;São Geraldo;Auxiliadora;400;50;61;21;300;100
7525;São Geraldo;Azenha;200;100;22;11;150;50
7526;São Geraldo;Bela Vista;200;0;143;42;0;200
7527;São Geraldo;Belém Novo;0;0;0;0;0;0
7528;São Geraldo;Belém Velho;0;0;0;0;0;0
7529;São Geraldo;Boa Vista;50;0;0;0;50;0
7530;São Geraldo;Boa Vista do Sul;50;0;25;17;0;50
7531;São Geraldo;Bom Fim;200;50;28;18;150;50
7532;São Geraldo;Bom Jesus;50;0;32;5;0;50
7533;São Geraldo;Camaquã;100;0;57;21;0;100
7534;São Geraldo;Campo Novo;50;0;33;10;0;50
7535;São Geraldo;Cascata;0;0;0;0;0;0
7536;São Geraldo;Cavalhada;150;50;57;22;50;100
7537;São Geraldo;Cel. Aparício Borges;0;0;0;0;0;0
7538;São Geraldo;Centro Histórico;300;50;54;20;200;100
7539;São Geraldo;Chapéu do Sol;0;0;0;0;0;0
7540;São Geraldo;Chácara das Pedras;50;50;0;0;50;0
7541;São Geraldo;Cidade Baixa;226;0;32;11;176;50
7542;São Geraldo;Costa e Silva;50;0;0;0;50;0
7543;São Geraldo;Cristal;150;50;30;11;100;50
7544;São Geraldo;Cristo Redentor;100;0;32;17;50;50
7545;São Geraldo;Espírito Santo;100;0;0;0;100;0
7546;São Geraldo;Extrema;0;0;0;0;0;0
7547;São Geraldo;Farrapos;350;150;78;7;300;50
7548;São Geraldo;Farroupilha;50;0;28;7;0;50
7549;São Geraldo;Floresta;3890;1200;857;352;2590;1300
7550;São Geraldo;Glória;300;50;136;64;50;250
7551;São Geraldo;Guarujá;0;0;0;0;0;0
7552;São Geraldo;Higienópolis;100;0;56;27;0;100
7553;São Geraldo;Humaitá;200;50;89;35;50;150
7554;São Geraldo;Hípica;0;0;0;0;0;0
7555;São Geraldo;Independência;300;0;160;92;0;300
7556;São Geraldo;Ipanema;0;0;0;0;0;0
7557;São Geraldo;Jardim Botânico;150;0;53;26;50;100
7558;São Geraldo;Jardim Carvalho;50;0;32;6;0;50
7559;São Geraldo;Jardim Europa;100;50;22;14;50;50
7560;São Geraldo;Jardim Floresta;50;0;22;15;0;50
7561;São Geraldo;Jardim Isabel;0;0;0;0;0;0
7562;São Geraldo;Jardim Itú;0;0;0;0;0;0
7563;São Geraldo;Jardim Leopoldina;50;0;25;13;0;50
7564;São Geraldo;Jardim Lindóia;0;0;0;0;0;0
7565;São Geraldo;Jardim Sabará;100;0;53;33;0;100
7566;São Geraldo;Jardim São Pedro;50;0;0;0;50;0
7567;São Geraldo;Jardim do Salso;0;0;0;0;0;0
7568;São Geraldo;Lageado;0;0;0;0;0;0
7569;São Geraldo;Lami;50;0;32;8;0;50
7570;São Geraldo;Lomba do Pinheiro;100;0;28;3;50;50
7571;São Geraldo;Medianeira;100;0;0;0;100;0
7572;São Geraldo;Menino Deus;150;0;85;43;0;150
7573;São Geraldo;Moinhos de Vento;600;150;188;113;250;350
7574;São Geraldo;Mont'Serrat;0;0;0;0;0;0
7575;São Geraldo;Morro Santana;50;0;34;5;0;50
7576;São Geraldo;Mário Quintana;250;50;88;21;100;150
7577;São Geraldo;Navegantes;1750;50;875;395;200;1550
7578;São Geraldo;Nonoai;0;0;0;0;0;0
7579;São Geraldo;Parque Santa Fé;0;0;0;0;0;0
7580;São Geraldo;Partenon;250;0;138;50;0;250
7581;São Geraldo;Passo D'Areia;250;150;51;31;150;100
7582;São Geraldo;Passo das Pedras;0;0;0;0;0;0
7583;São Geraldo;Pedra Redonda;0;0;0;0;0;0
7584;São Geraldo;Petrópolis;200;0;82;43;50;150
7585;São Geraldo;Pitinga;0;0;0;0;0;0
7586;São Geraldo;Ponta Grossa;50;0;24;14;0;50
7587;São Geraldo;Praia de Belas;150;0;31;8;100;50
7588;São Geraldo;Restinga;0;0;0;0;0;0
7589;São Geraldo;Rio Branco;200;0;75;39;50;150
7590;São Geraldo;Rubem Berta;50;0;33;15;0;50
7591;São Geraldo;Santa Cecília;150;50;26;20;100;50
7592;São Geraldo;Santa Maria Goretti;50;50;0;0;50;0
7593;São Geraldo;Santa Rosa de Lima;100;50;27;15;50;50
7594;São Geraldo;Santa Tereza;350;100;108;30;250;100
7595;São Geraldo;Santana;250;50;29;11;200;50
7596;São Geraldo;Santo Antônio;100;0;72;14;50;50
7597;São Geraldo;Sarandi;0;0;0;0;0;0
7598;São Geraldo;Serraria;0;0;0;0;0;0
7599;São Geraldo;São Caetano;0;0;0;0;0;0
7600;São Geraldo;São Geraldo;7100;1300;2118;1048;3300;3800
7601;São Geraldo;São José;100;50;36;3;50;50
7602;São Geraldo;São João;1150;50;428;219;400;750
7603;São Geraldo;São Sebastião;0;0;0;0;0;0
7604;São Geraldo;Sétimo Céu;50;0;26;13;0;50
7605;São Geraldo;Teresópolis;0;0;0;0;0;0
7606;São Geraldo;Tristeza;50;0;28;22;0;50
7607;São Geraldo;Três Figueiras;50;50;0;0;50;0
7608;São Geraldo;Vila Assunção;0;0;0;0;0;0
7609;São Geraldo;Vila Conceição;50;0;28;14;0;50
7610;São Geraldo;Vila Ipiranga;100;50;0;0;100;0
7611;São Geraldo;Vila Jardim;100;50;0;0;100;0
7612;São Geraldo;Vila João Pessoa;50;0;0;0;50;0
7613;São Geraldo;Vila Nova;150;0;89;24;0;150
7614;São José;Aberta dos Morros;50;0;24;10;0;50
7615;São José;Agronomia;3700;850;1359;354;1450;2250
7616;São José;Anchieta;100;0;67;19;0;100
7617;São José;Arquipélago;250;50;119;29;50;200
7618;São José;Auxiliadora;100;0;25;13;50;50
7619;São José;Azenha;200;0;109;20;100;100
7620;São José;Bela Vista;200;50;79;33;50;150
7621;São José;Belém Novo;100;50;31;8;50;50
7622;São José;Belém Velho;850;100;452;90;200;650
7623;São José;Boa Vista;100;0;68;17;0;100
7624;São José;Boa Vista do Sul;150;50;53;13;50;100
7625;São José;Bom Fim;50;0;26;10;0;50
7626;São José;Bom Jesus;450;100;238;41;150;300
7627;São José;Camaquã;200;0;92;33;50;150
7628;São José;Campo Novo;50;0;32;10;0;50
7629;São José;Cascata;6100;450;3036;734;1450;4650
7630;São José;Cavalhada;50;0;0;0;50;0
7631;São José;Cel. Aparício Borges;1950;900;261;86;1450;500
7632;São José;Centro Histórico;100;50;0;0;100;0
7633;São José;Chapéu do Sol;50;0;26;9;0;50
7634;São José;Chácara das Pedras;250;0;147;43;0;250
7635;São José;Cidade Baixa;50;50;0;0;50;0
7636;São José;Costa e Silva;0;0;0;0;0;0
7637;São José;Cristal;250;50;97;23;100;150
7638;São José;Cristo Redentor;0;0;0;0;0;0
7639;São José;Espírito Santo;100;0;50;20;0;100
7640;São José;Extrema;50;0;0;0;50;0
7641;São José;Farrapos;100;50;30;12;50;50
7642;São José;Farroupilha;50;0;32;10;0;50
7643;São José;Floresta;100;50;22;15;50;50
7644;São José;Glória;650;100;149;46;400;250
7645;São José;Guarujá;0;0;0;0;0;0
7646;São José;Higienópolis;50;0;32;15;0;50
7647;São José;Humaitá;50;0;35;6;0;50
7648;São José;Hípica;150;50;76;11;50;100
7649;São José;Independência;150;0;21;19;100;50
7650;São José;Ipanema;50;0;34;12;0;50
7651;São José;Jardim Botânico;650;0;389;113;0;650
7652;São José;Jardim Carvalho;1043;200;329;86;593;450
7653;São José;Jardim Europa;200;0;90;21;50;150
7654;São José;Jardim Floresta;100;50;24;7;50;50
7655;São José;Jardim Isabel;0;0;0;0;0;0
7656;São José;Jardim Itú;150;100;27;9;100;50
7657;São José;Jardim Leopoldina;50;50;0;0;50;0
7658;São José;Jardim Lindóia;50;0;31;11;0;50
7659;São José;Jardim Sabará;50;0;25;15;0;50
7660;São José;Jardim São Pedro;0;0;0;0;0;0
7661;São José;Jardim do Salso;850;150;258;76;400;450
7662;São José;Lageado;0;0;0;0;0;0
7663;São José;Lami;100;0;64;14;0;100
7664;São José;Lomba do Pinheiro;1000;250;404;98;350;650
7665;São José;Medianeira;50;0;32;11;0;50
7666;São José;Menino Deus;50;50;0;0;50;0
7667;São José;Moinhos de Vento;150;0;38;49;50;100
7668;São José;Mont'Serrat;50;50;0;0;50;0
7669;São José;Morro Santana;150;0;55;16;50;100
7670;São José;Mário Quintana;200;0;108;33;0;200
7671;São José;Navegantes;0;0;0;0;0;0
7672;São José;Nonoai;350;50;214;42;100;250
7673;São José;Parque Santa Fé;200;150;27;11;150;50
7674;São José;Partenon;500;50;251;81;100;400
7675;São José;Passo D'Areia;150;50;39;36;50;100
7676;São José;Passo das Pedras;100;0;26;9;50;50
7677;São José;Pedra Redonda;50;50;0;0;50;0
7678;São José;Petrópolis;600;150;217;105;200;400
7679;São José;Pitinga;200;0;83;22;50;150
7680;São José;Ponta Grossa;200;100;32;8;150;50
7681;São José;Praia de Belas;0;0;0;0;0;0
7682;São José;Restinga;400;50;169;41;100;300
7683;São José;Rio Branco;100;50;38;5;50;50
7684;São José;Rubem Berta;200;50;110;26;100;100
7685;São José;Santa Cecília;0;0;0;0;0;0
7686;São José;Santa Maria Goretti;0;0;0;0;0;0
7687;São José;Santa Rosa de Lima;150;0;26;8;100;50
7688;São José;Santa Tereza;250;0;82;25;100;150
7689;São José;Santana;250;50;130;44;100;150
7690;São José;Santo Antônio;100;0;29;14;50;50
7691;São José;Sarandi;350;50;113;47;150;200
7692;São José;Serraria;200;0;88;33;50;150
7693;São José;São Caetano;50;0;27;7;0;50
7694;São José;São Geraldo;100;50;36;3;50;50
7695;São José;São José;10200;700;5124;1456;1800;8400
7696;São José;São João;150;50;67;20;50;100
7697;São José;São Sebastião;0;0;0;0;0;0
7698;São José;Sétimo Céu;100;100;0;0;100;0
7699;São José;Teresópolis;250;50;89;37;100;150
7700;São José;Tristeza;150;0;57;30;50;100
7701;São José;Três Figueiras;200;50;84;27;50;150
7702;São José;Vila Assunção;0;0;0;0;0;0
7703;São José;Vila Conceição;50;50;0;0;50;0
7704;São José;Vila Ipiranga;100;50;34;8;50;50
7705;São José;Vila Jardim;250;50;27;15;200;50
7706;São José;Vila João Pessoa;1735;600;414;144;1035;700
7707;São José;Vila Nova;600;200;130;55;350;250
7708;São João;Aberta dos Morros;50;0;0;0;50;0
7709;São João;Agronomia;50;0;0;0;50;0
7710;São João;Anchieta;157;50;54;19;57;100
7711;São João;Arquipélago;100;50;50;0;100;0
7712;São João;Auxiliadora;1500;300;427;256;650;850
7713;São João;Azenha;150;50;23;17;100;50
7714;São João;Bela Vista;350;50;136;78;100;250
7715;São João;Belém Novo;0;0;0;0;0;0
7716;São João;Belém Velho;0;0;0;0;0;0
7717;São João;Boa Vista;350;0;190;75;0;350
7718;São João;Boa Vista do Sul;0;0;0;0;0;0
7719;São João;Bom Fim;350;50;116;53;150;200
7720;São João;Bom Jesus;0;0;0;0;0;0
7721;São João;Camaquã;150;0;60;14;50;100
7722;São João;Campo Novo;0;0;0;0;0;0
7723;São João;Cascata;0;0;0;0;0;0
7724;São João;Cavalhada;50;50;0;0;50;0
7725;São João;Cel. Aparício Borges;50;0;28;14;0;50
7726;São João;Centro Histórico;366;0;128;56;166;200
7727;São João;Chapéu do Sol;0;0;0;0;0;0
7728;São João;Chácara das Pedras;50;0;33;12;0;50
7729;São João;Cidade Baixa;100;0;54;23;0;100
7730;São João;Costa e Silva;50;50;0;0;50;0
7731;São João;Cristal;100;0;59;17;0;100
7732;São João;Cristo Redentor;350;50;149;59;100;250
7733;São João;Espírito Santo;50;0;26;12;0;50
7734;São João;Extrema;50;0;21;16;0;50
7735;São João;Farrapos;300;0;135;37;150;150
7736;São João;Farroupilha;150;0;81;44;0;150
7737;São João;Floresta;2250;50;1053;597;250;2000
7738;São João;Glória;100;0;26;18;50;50
7739;São João;Guarujá;0;0;0;0;0;0
7740;São João;Higienópolis;1000;350;166;48;800;200
7741;São João;Humaitá;250;100;63;11;150;100
7742;São João;Hípica;150;50;59;25;50;100
7743;São João;Independência;200;0;23;19;150;50
7744;São João;Ipanema;50;0;0;0;50;0
7745;São João;Jardim Botânico;200;0;122;42;0;200
7746;São João;Jardim Carvalho;100;0;49;27;0;100
7747;São João;Jardim Europa;150;0;56;27;50;100
7748;São João;Jardim Floresta;50;0;0;0;50;0
7749;São João;Jardim Isabel;0;0;0;0;0;0
7750;São João;Jardim Itú;150;50;53;24;50;100
7751;São João;Jardim Leopoldina;50;0;28;6;0;50
7752;São João;Jardim Lindóia;150;100;24;12;100;50
7753;São João;Jardim Sabará;100;0;29;16;50;50
7754;São João;Jardim São Pedro;200;0;136;55;50;150
7755;São João;Jardim do Salso;150;0;68;43;0;150
7756;São João;Lageado;0;0;0;0;0;0
7757;São João;Lami;0;0;0;0;0;0
7758;São João;Lomba do Pinheiro;400;100;115;39;200;200
7759;São João;Medianeira;150;0;57;19;50;100
7760;São João;Menino Deus;400;0;192;83;150;250
7761;São João;Moinhos de Vento;750;100;307;185;150;600
7762;São João;Mont'Serrat;1100;100;471;219;300;800
7763;São João;Morro Santana;100;0;30;9;50;50
7764;São João;Mário Quintana;50;0;31;7;0;50
7765;São João;Navegantes;400;150;103;60;200;200
7766;São João;Nonoai;50;0;27;9;0;50
7767;São João;Parque Santa Fé;0;0;0;0;0;0
7768;São João;Partenon;250;100;60;24;150;100
7769;São João;Passo D'Areia;200;50;46;32;100;100
7770;São João;Passo das Pedras;100;0;79;12;50;50
7771;São João;Pedra Redonda;100;0;25;21;50;50
7772;São João;Petrópolis;300;50;81;42;150;150
7773;São João;Pitinga;0;0;0;0;0;0
7774;São João;Ponta Grossa;150;50;58;29;50;100
7775;São João;Praia de Belas;50;0;0;0;50;0
7776;São João;Restinga;0;0;0;0;0;0
7777;São João;Rio Branco;350;50;128;78;100;250
7778;São João;Rubem Berta;50;0;28;10;0;50
7779;São João;Santa Cecília;100;0;30;10;50;50
7780;São João;Santa Maria Goretti;500;150;52;27;400;100
7781;São João;Santa Rosa de Lima;150;0;98;21;0;150
7782;São João;Santa Tereza;150;0;86;29;0;150
7783;São João;Santana;150;50;60;32;50;100
7784;São João;Santo Antônio;50;0;22;13;0;50
7785;São João;Sarandi;250;50;50;33;150;100
7786;São João;Serraria;50;0;30;9;0;50
7787;São João;São Caetano;0;0;0;0;0;0
7788;São João;São Geraldo;1150;50;428;219;400;750
7789;São João;São José;150;50;67;20;50;100
7790;São João;São João;3500;100;1766;850;300;3200
7791;São João;São Sebastião;0;0;0;0;0;0
7792;São João;Sétimo Céu;100;0;20;12;50;50
7793;São João;Teresópolis;50;0;25;20;0;50
7794;São João;Tristeza;50;0;27;15;0;50
7795;São João;Três Figueiras;350;50;182;68;100;250
7796;São João;Vila Assunção;50;0;31;9;0;50
7797;São João;Vila Conceição;0;0;0;0;0;0
7798;São João;Vila Ipiranga;100;50;34;12;50;50
7799;São João;Vila Jardim;200;50;89;40;50;150
7800;São João;Vila João Pessoa;250;50;121;48;100;150
7801;São João;Vila Nova;100;50;32;10;50;50
7802;São Sebastião;Aberta dos Morros;0;0;0;0;0;0
7803;São Sebastião;Agronomia;0;0;0;0;0;0
7804;São Sebastião;Anchieta;100;0;28;12;50;50
7805;São Sebastião;Arquipélago;100;50;27;7;50;50
7806;São Sebastião;Auxiliadora;100;0;53;19;0;100
7807;São Sebastião;Azenha;0;0;0;0;0;0
7808;São Sebastião;Bela Vista;0;0;0;0;0;0
7809;São Sebastião;Belém Novo;0;0;0;0;0;0
7810;São Sebastião;Belém Velho;50;0;0;0;50;0
7811;São Sebastião;Boa Vista;200;50;85;32;50;150
7812;São Sebastião;Boa Vista do Sul;0;0;0;0;0;0
7813;São Sebastião;Bom Fim;50;0;26;12;0;50
7814;São Sebastião;Bom Jesus;200;50;37;7;150;50
7815;São Sebastião;Camaquã;50;0;29;12;0;50
7816;São Sebastião;Campo Novo;0;0;0;0;0;0
7817;São Sebastião;Cascata;0;0;0;0;0;0
7818;São Sebastião;Cavalhada;50;0;33;7;0;50
7819;São Sebastião;Cel. Aparício Borges;50;0;0;0;50;0
7820;São Sebastião;Centro Histórico;250;50;58;23;150;100
7821;São Sebastião;Chapéu do Sol;0;0;0;0;0;0
7822;São Sebastião;Chácara das Pedras;100;0;56;10;0;100
7823;São Sebastião;Cidade Baixa;0;0;0;0;0;0
7824;São Sebastião;Costa e Silva;600;100;205;56;250;350
7825;São Sebastião;Cristal;100;0;67;9;0;100
7826;São Sebastião;Cristo Redentor;500;50;284;90;100;400
7827;São Sebastião;Espírito Santo;0;0;0;0;0;0
7828;São Sebastião;Extrema;0;0;0;0;0;0
7829;São Sebastião;Farrapos;0;0;0;0;0;0
7830;São Sebastião;Farroupilha;0;0;0;0;0;0
7831;São Sebastião;Floresta;150;0;81;38;0;150
7832;São Sebastião;Glória;100;0;26;10;50;50
7833;São Sebastião;Guarujá;0;0;0;0;0;0
7834;São Sebastião;Higienópolis;100;50;30;9;50;50
7835;São Sebastião;Humaitá;50;0;37;8;0;50
7836;São Sebastião;Hípica;0;0;0;0;0;0
7837;São Sebastião;Independência;150;0;62;25;50;100
7838;São Sebastião;Ipanema;150;0;82;35;0;150
7839;São Sebastião;Jardim Botânico;200;0;88;28;50;150
7840;São Sebastião;Jardim Carvalho;100;50;31;5;50;50
7841;São Sebastião;Jardim Europa;50;50;0;0;50;0
7842;São Sebastião;Jardim Floresta;700;150;295;102;250;450
7843;São Sebastião;Jardim Isabel;50;0;32;6;0;50
7844;São Sebastião;Jardim Itú;550;50;187;64;250;300
7845;São Sebastião;Jardim Leopoldina;350;100;85;28;200;150
7846;São Sebastião;Jardim Lindóia;1850;300;822;352;500;1350
7847;São Sebastião;Jardim Sabará;250;50;88;27;100;150
7848;São Sebastião;Jardim São Pedro;100;50;33;14;50;50
7849;São Sebastião;Jardim do Salso;0;0;0;0;0;0
7850;São Sebastião;Lageado;50;0;0;0;50;0
7851;São Sebastião;Lami;0;0;0;0;0;0
7852;São Sebastião;Lomba do Pinheiro;200;0;115;30;0;200
7853;São Sebastião;Medianeira;0;0;0;0;0;0
7854;São Sebastião;Menino Deus;250;0;138;59;0;250
7855;São Sebastião;Moinhos de Vento;50;0;24;15;0;50
7856;São Sebastião;Mont'Serrat;150;0;51;23;50;100
7857;São Sebastião;Morro Santana;150;50;0;0;150;0
7858;São Sebastião;Mário Quintana;100;0;65;13;0;100
7859;São Sebastião;Navegantes;0;0;0;0;0;0
7860;São Sebastião;Nonoai;50;0;33;12;0;50
7861;São Sebastião;Parque Santa Fé;250;50;101;26;100;150
7862;São Sebastião;Partenon;250;100;54;20;150;100
7863;São Sebastião;Passo D'Areia;164;0;80;24;64;100
7864;São Sebastião;Passo das Pedras;750;150;269;75;350;400
7865;São Sebastião;Pedra Redonda;0;0;0;0;0;0
7866;São Sebastião;Petrópolis;150;0;59;27;50;100
7867;São Sebastião;Pitinga;50;0;29;6;0;50
7868;São Sebastião;Ponta Grossa;0;0;0;0;0;0
7869;São Sebastião;Praia de Belas;100;100;0;0;100;0
7870;São Sebastião;Restinga;0;0;0;0;0;0
7871;São Sebastião;Rio Branco;0;0;0;0;0;0
7872;São Sebastião;Rubem Berta;300;100;86;42;150;150
7873;São Sebastião;Santa Cecília;0;0;0;0;0;0
7874;São Sebastião;Santa Maria Goretti;150;0;33;14;100;50
7875;São Sebastião;Santa Rosa de Lima;650;0;358;75;150;500
7876;São Sebastião;Santa Tereza;100;0;24;8;50;50
7877;São Sebastião;Santana;100;0;53;25;0;100
7878;São Sebastião;Santo Antônio;50;50;0;0;50;0
7879;São Sebastião;Sarandi;750;50;262;118;250;500
7880;São Sebastião;Serraria;50;0;32;9;0;50
7881;São Sebastião;São Caetano;0;0;0;0;0;0
7882;São Sebastião;São Geraldo;0;0;0;0;0;0
7883;São Sebastião;São José;0;0;0;0;0;0
7884;São Sebastião;São João;0;0;0;0;0;0
7885;São Sebastião;São Sebastião;6960;1800;2544;814;2660;4300
7886;São Sebastião;Sétimo Céu;0;0;0;0;0;0
7887;São Sebastião;Teresópolis;300;50;146;64;50;250
7888;São Sebastião;Tristeza;0;0;0;0;0;0
7889;São Sebastião;Três Figueiras;0;0;0;0;0;0
7890;São Sebastião;Vila Assunção;0;0;0;0;0;0
7891;São Sebastião;Vila Conceição;150;50;59;14;50;100
7892;São Sebastião;Vila Ipiranga;550;100;240;94;100;450
7893;São Sebastião;Vila Jardim;200;50;66;13;100;100
7894;São Sebastião;Vila João Pessoa;50;0;30;11;0;50
7895;São Sebastião;Vila Nova;100;0;0;0;100;0
7896;Sétimo Céu;Aberta dos Morros;50;0;31;11;0;50
7897;Sétimo Céu;Agronomia;0;0;0;0;0;0
7898;Sétimo Céu;Anchieta;0;0;0;0;0;0
7899;Sétimo Céu;Arquipélago;0;0;0;0;0;0
7900;Sétimo Céu;Auxiliadora;0;0;0;0;0;0
7901;Sétimo Céu;Azenha;0;0;0;0;0;0
7902;Sétimo Céu;Bela Vista;150;0;98;34;0;150
7903;Sétimo Céu;Belém Novo;50;0;31;7;0;50
7904;Sétimo Céu;Belém Velho;50;0;32;9;0;50
7905;Sétimo Céu;Boa Vista;0;0;0;0;0;0
7906;Sétimo Céu;Boa Vista do Sul;0;0;0;0;0;0
7907;Sétimo Céu;Bom Fim;0;0;0;0;0;0
7908;Sétimo Céu;Bom Jesus;0;0;0;0;0;0
7909;Sétimo Céu;Camaquã;1400;300;577;201;400;1000
7910;Sétimo Céu;Campo Novo;50;0;26;9;0;50
7911;Sétimo Céu;Cascata;50;0;25;9;0;50
7912;Sétimo Céu;Cavalhada;6350;700;2991;1080;1300;5050
7913;Sétimo Céu;Cel. Aparício Borges;0;0;0;0;0;0
7914;Sétimo Céu;Centro Histórico;50;0;0;0;50;0
7915;Sétimo Céu;Chapéu do Sol;0;0;0;0;0;0
7916;Sétimo Céu;Chácara das Pedras;0;0;0;0;0;0
7917;Sétimo Céu;Cidade Baixa;0;0;0;0;0;0
7918;Sétimo Céu;Costa e Silva;0;0;0;0;0;0
7919;Sétimo Céu;Cristal;900;250;209;51;650;250
7920;Sétimo Céu;Cristo Redentor;50;50;0;0;50;0
7921;Sétimo Céu;Espírito Santo;150;50;56;19;50;100
7922;Sétimo Céu;Extrema;0;0;0;0;0;0
7923;Sétimo Céu;Farrapos;200;50;90;21;50;150
7924;Sétimo Céu;Farroupilha;0;0;0;0;0;0
7925;Sétimo Céu;Floresta;50;0;29;20;0;50
7926;Sétimo Céu;Glória;50;0;32;11;0;50
7927;Sétimo Céu;Guarujá;200;0;82;23;50;150
7928;Sétimo Céu;Higienópolis;50;0;0;0;50;0
7929;Sétimo Céu;Humaitá;0;0;0;0;0;0
7930;Sétimo Céu;Hípica;50;0;36;6;0;50
7931;Sétimo Céu;Independência;0;0;0;0;0;0
7932;Sétimo Céu;Ipanema;1350;300;568;200;500;850
7933;Sétimo Céu;Jardim Botânico;0;0;0;0;0;0
7934;Sétimo Céu;Jardim Carvalho;50;0;36;11;0;50
7935;Sétimo Céu;Jardim Europa;50;0;29;9;0;50
7936;Sétimo Céu;Jardim Floresta;0;0;0;0;0;0
7937;Sétimo Céu;Jardim Isabel;496;0;259;64;96;400
7938;Sétimo Céu;Jardim Itú;50;0;0;0;50;0
7939;Sétimo Céu;Jardim Leopoldina;50;0;35;8;0;50
7940;Sétimo Céu;Jardim Lindóia;0;0;0;0;0;0
7941;Sétimo Céu;Jardim Sabará;0;0;0;0;0;0
7942;Sétimo Céu;Jardim São Pedro;50;50;0;0;50;0
7943;Sétimo Céu;Jardim do Salso;0;0;0;0;0;0
7944;Sétimo Céu;Lageado;0;0;0;0;0;0
7945;Sétimo Céu;Lami;0;0;0;0;0;0
7946;Sétimo Céu;Lomba do Pinheiro;100;50;22;9;50;50
7947;Sétimo Céu;Medianeira;50;0;30;9;0;50
7948;Sétimo Céu;Menino Deus;50;0;28;17;0;50
7949;Sétimo Céu;Moinhos de Vento;0;0;0;0;0;0
7950;Sétimo Céu;Mont'Serrat;0;0;0;0;0;0
7951;Sétimo Céu;Morro Santana;50;0;0;0;50;0
7952;Sétimo Céu;Mário Quintana;0;0;0;0;0;0
7953;Sétimo Céu;Navegantes;0;0;0;0;0;0
7954;Sétimo Céu;Nonoai;450;50;210;55;100;350
7955;Sétimo Céu;Parque Santa Fé;0;0;0;0;0;0
7956;Sétimo Céu;Partenon;0;0;0;0;0;0
7957;Sétimo Céu;Passo D'Areia;50;50;0;0;50;0
7958;Sétimo Céu;Passo das Pedras;0;0;0;0;0;0
7959;Sétimo Céu;Pedra Redonda;100;0;67;14;0;100
7960;Sétimo Céu;Petrópolis;150;50;68;23;50;100
7961;Sétimo Céu;Pitinga;0;0;0;0;0;0
7962;Sétimo Céu;Ponta Grossa;50;0;30;9;0;50
7963;Sétimo Céu;Praia de Belas;0;0;0;0;0;0
7964;Sétimo Céu;Restinga;250;50;82;23;100;150
7965;Sétimo Céu;Rio Branco;100;0;51;32;0;100
7966;Sétimo Céu;Rubem Berta;50;0;21;23;0;50
7967;Sétimo Céu;Santa Cecília;0;0;0;0;0;0
7968;Sétimo Céu;Santa Maria Goretti;0;0;0;0;0;0
7969;Sétimo Céu;Santa Rosa de Lima;150;0;88;29;0;150
7970;Sétimo Céu;Santa Tereza;250;50;118;32;50;200
7971;Sétimo Céu;Santana;50;0;0;0;50;0
7972;Sétimo Céu;Santo Antônio;50;0;0;0;50;0
7973;Sétimo Céu;Sarandi;150;50;23;11;100;50
7974;Sétimo Céu;Serraria;100;0;50;10;0;100
7975;Sétimo Céu;São Caetano;0;0;0;0;0;0
7976;Sétimo Céu;São Geraldo;50;0;26;13;0;50
7977;Sétimo Céu;São José;100;100;0;0;100;0
7978;Sétimo Céu;São João;100;0;20;12;50;50
7979;Sétimo Céu;São Sebastião;0;0;0;0;0;0
7980;Sétimo Céu;Sétimo Céu;300;100;112;34;100;200
7981;Sétimo Céu;Teresópolis;150;50;66;16;50;100
7982;Sétimo Céu;Tristeza;3552;1700;397;161;3052;500
7983;Sétimo Céu;Três Figueiras;50;0;0;0;50;0
7984;Sétimo Céu;Vila Assunção;250;0;146;63;0;250
7985;Sétimo Céu;Vila Conceição;0;0;0;0;0;0
7986;Sétimo Céu;Vila Ipiranga;50;0;27;11;0;50
7987;Sétimo Céu;Vila Jardim;50;50;0;0;50;0
7988;Sétimo Céu;Vila João Pessoa;0;0;0;0;0;0
7989;Sétimo Céu;Vila Nova;350;0;183;53;50;300
7990;Teresópolis;Aberta dos Morros;100;50;0;0;100;0
7991;Teresópolis;Agronomia;0;0;0;0;0;0
7992;Teresópolis;Anchieta;100;0;31;10;50;50
7993;Teresópolis;Arquipélago;50;0;29;5;0;50
7994;Teresópolis;Auxiliadora;100;0;57;28;0;100
7995;Teresópolis;Azenha;500;100;207;90;150;350
7996;Teresópolis;Bela Vista;0;0;0;0;0;0
7997;Teresópolis;Belém Novo;100;0;28;16;50;50
7998;Teresópolis;Belém Velho;850;100;307;95;350;500
7999;Teresópolis;Boa Vista;200;50;59;31;100;100
8000;Teresópolis;Boa Vista do Sul;150;0;60;20;50;100
8001;Teresópolis;Bom Fim;150;100;50;0;150;0
8002;Teresópolis;Bom Jesus;50;0;32;7;0;50
8003;Teresópolis;Camaquã;850;100;448;136;100;750
8004;Teresópolis;Campo Novo;350;100;151;44;100;250
8005;Teresópolis;Cascata;450;100;109;29;250;200
8006;Teresópolis;Cavalhada;600;150;246;97;250;350
8007;Teresópolis;Cel. Aparício Borges;350;50;177;64;50;300
8008;Teresópolis;Centro Histórico;150;0;52;28;50;100
8009;Teresópolis;Chapéu do Sol;150;50;33;7;100;50
8010;Teresópolis;Chácara das Pedras;100;0;57;26;0;100
8011;Teresópolis;Cidade Baixa;250;0;114;51;50;200
8012;Teresópolis;Costa e Silva;150;100;0;0;150;0
8013;Teresópolis;Cristal;350;0;205;50;100;250
8014;Teresópolis;Cristo Redentor;100;50;0;0;100;0
8015;Teresópolis;Espírito Santo;250;50;92;28;100;150
8016;Teresópolis;Extrema;50;0;25;13;0;50
8017;Teresópolis;Farrapos;50;0;33;3;0;50
8018;Teresópolis;Farroupilha;100;0;78;15;0;100
8019;Teresópolis;Floresta;100;50;31;8;50;50
8020;Teresópolis;Glória;1550;900;214;82;1200;350
8021;Teresópolis;Guarujá;0;0;0;0;0;0
8022;Teresópolis;Higienópolis;250;0;111;53;50;200
8023;Teresópolis;Humaitá;50;0;50;0;50;0
8024;Teresópolis;Hípica;100;0;67;21;0;100
8025;Teresópolis;Independência;0;0;0;0;0;0
8026;Teresópolis;Ipanema;550;200;178;45;350;200
8027;Teresópolis;Jardim Botânico;250;50;27;13;200;50
8028;Teresópolis;Jardim Carvalho;250;0;83;26;100;150
8029;Teresópolis;Jardim Europa;0;0;0;0;0;0
8030;Teresópolis;Jardim Floresta;50;0;32;7;0;50
8031;Teresópolis;Jardim Isabel;0;0;0;0;0;0
8032;Teresópolis;Jardim Itú;100;0;33;8;50;50
8033;Teresópolis;Jardim Leopoldina;50;0;32;6;0;50
8034;Teresópolis;Jardim Lindóia;100;0;31;11;50;50
8035;Teresópolis;Jardim Sabará;150;50;56;20;50;100
8036;Teresópolis;Jardim São Pedro;50;0;23;14;0;50
8037;Teresópolis;Jardim do Salso;50;0;29;12;0;50
8038;Teresópolis;Lageado;50;0;0;0;50;0
8039;Teresópolis;Lami;150;50;62;18;50;100
8040;Teresópolis;Lomba do Pinheiro;50;0;27;5;0;50
8041;Teresópolis;Medianeira;350;50;115;50;150;200
8042;Teresópolis;Menino Deus;100;50;31;17;50;50
8043;Teresópolis;Moinhos de Vento;50;0;31;18;0;50
8044;Teresópolis;Mont'Serrat;50;0;25;12;0;50
8045;Teresópolis;Morro Santana;50;0;30;11;0;50
8046;Teresópolis;Mário Quintana;150;0;21;15;100;50
8047;Teresópolis;Navegantes;50;0;27;13;0;50
8048;Teresópolis;Nonoai;7700;400;3966;1546;1000;6700
8049;Teresópolis;Parque Santa Fé;50;0;33;7;0;50
8050;Teresópolis;Partenon;850;150;285;99;350;500
8051;Teresópolis;Passo D'Areia;100;0;53;35;0;100
8052;Teresópolis;Passo das Pedras;250;0;154;48;0;250
8053;Teresópolis;Pedra Redonda;0;0;0;0;0;0
8054;Teresópolis;Petrópolis;450;200;94;38;300;150
8055;Teresópolis;Pitinga;50;0;31;4;0;50
8056;Teresópolis;Ponta Grossa;50;0;33;10;0;50
8057;Teresópolis;Praia de Belas;150;0;86;21;0;150
8058;Teresópolis;Restinga;550;50;304;82;50;500
8059;Teresópolis;Rio Branco;150;50;68;26;50;100
8060;Teresópolis;Rubem Berta;150;0;88;36;0;150
8061;Teresópolis;Santa Cecília;100;0;30;14;50;50
8062;Teresópolis;Santa Maria Goretti;100;100;0;0;100;0
8063;Teresópolis;Santa Rosa de Lima;100;100;0;0;100;0
8064;Teresópolis;Santa Tereza;1000;100;376;132;350;650
8065;Teresópolis;Santana;350;150;22;12;300;50
8066;Teresópolis;Santo Antônio;250;100;86;40;100;150
8067;Teresópolis;Sarandi;350;50;164;86;50;300
8068;Teresópolis;Serraria;50;0;30;7;0;50
8069;Teresópolis;São Caetano;50;0;0;0;50;0
8070;Teresópolis;São Geraldo;0;0;0;0;0;0
8071;Teresópolis;São José;250;50;89;37;100;150
8072;Teresópolis;São João;50;0;25;20;0;50
8073;Teresópolis;São Sebastião;300;50;146;64;50;250
8074;Teresópolis;Sétimo Céu;150;50;66;16;50;100
8075;Teresópolis;Teresópolis;1300;100;646;276;200;1100
8076;Teresópolis;Tristeza;650;0;377;161;100;550
8077;Teresópolis;Três Figueiras;50;50;0;0;50;0
8078;Teresópolis;Vila Assunção;100;0;65;27;0;100
8079;Teresópolis;Vila Conceição;0;0;0;0;0;0
8080;Teresópolis;Vila Ipiranga;150;100;34;14;100;50
8081;Teresópolis;Vila Jardim;50;0;0;0;50;0
8082;Teresópolis;Vila João Pessoa;300;0;158;52;50;250
8083;Teresópolis;Vila Nova;2050;400;768;272;700;1350
8084;Tristeza;Aberta dos Morros;50;0;0;0;50;0
8085;Tristeza;Agronomia;50;0;31;13;0;50
8086;Tristeza;Anchieta;50;0;0;0;50;0
8087;Tristeza;Arquipélago;151;100;30;11;101;50
8088;Tristeza;Auxiliadora;150;50;24;20;100;50
8089;Tristeza;Azenha;150;0;86;41;0;150
8090;Tristeza;Bela Vista;0;0;0;0;0;0
8091;Tristeza;Belém Novo;50;50;0;0;50;0
8092;Tristeza;Belém Velho;100;0;60;23;0;100
8093;Tristeza;Boa Vista;0;0;0;0;0;0
8094;Tristeza;Boa Vista do Sul;50;0;23;17;0;50
8095;Tristeza;Bom Fim;0;0;0;0;0;0
8096;Tristeza;Bom Jesus;0;0;0;0;0;0
8097;Tristeza;Camaquã;1250;400;451;217;450;800
8098;Tristeza;Campo Novo;400;0;199;106;50;350
8099;Tristeza;Cascata;200;50;0;0;200;0
8100;Tristeza;Cavalhada;900;150;290;121;400;500
8101;Tristeza;Cel. Aparício Borges;50;0;30;18;0;50
8102;Tristeza;Centro Histórico;200;0;114;51;0;200
8103;Tristeza;Chapéu do Sol;100;50;29;14;50;50
8104;Tristeza;Chácara das Pedras;50;0;22;14;0;50
8105;Tristeza;Cidade Baixa;200;0;86;38;50;150
8106;Tristeza;Costa e Silva;150;50;67;29;50;100
8107;Tristeza;Cristal;1100;50;437;202;350;750
8108;Tristeza;Cristo Redentor;50;0;25;14;0;50
8109;Tristeza;Espírito Santo;100;0;58;37;0;100
8110;Tristeza;Extrema;50;0;0;0;50;0
8111;Tristeza;Farrapos;150;50;36;10;100;50
8112;Tristeza;Farroupilha;150;100;35;12;100;50
8113;Tristeza;Floresta;50;0;28;11;0;50
8114;Tristeza;Glória;150;50;34;16;100;50
8115;Tristeza;Guarujá;100;50;33;15;50;50
8116;Tristeza;Higienópolis;50;50;0;0;50;0
8117;Tristeza;Humaitá;50;0;0;0;50;0
8118;Tristeza;Hípica;200;0;142;23;0;200
8119;Tristeza;Independência;0;0;0;0;0;0
8120;Tristeza;Ipanema;700;100;312;128;200;500
8121;Tristeza;Jardim Botânico;100;0;30;16;50;50
8122;Tristeza;Jardim Carvalho;100;0;56;28;0;100
8123;Tristeza;Jardim Europa;50;0;36;11;0;50
8124;Tristeza;Jardim Floresta;50;0;32;14;0;50
8125;Tristeza;Jardim Isabel;1000;0;531;258;100;900
8126;Tristeza;Jardim Itú;100;0;59;32;0;100
8127;Tristeza;Jardim Leopoldina;50;50;0;0;50;0
8128;Tristeza;Jardim Lindóia;0;0;0;0;0;0
8129;Tristeza;Jardim Sabará;100;0;58;28;0;100
8130;Tristeza;Jardim São Pedro;50;50;0;0;50;0
8131;Tristeza;Jardim do Salso;0;0;0;0;0;0
8132;Tristeza;Lageado;100;0;62;23;0;100
8133;Tristeza;Lami;0;0;0;0;0;0
8134;Tristeza;Lomba do Pinheiro;350;50;159;47;50;300
8135;Tristeza;Medianeira;200;0;91;55;50;150
8136;Tristeza;Menino Deus;250;0;132;68;0;250
8137;Tristeza;Moinhos de Vento;0;0;0;0;0;0
8138;Tristeza;Mont'Serrat;0;0;0;0;0;0
8139;Tristeza;Morro Santana;50;50;0;0;50;0
8140;Tristeza;Mário Quintana;50;0;33;4;0;50
8141;Tristeza;Navegantes;50;0;22;17;0;50
8142;Tristeza;Nonoai;900;350;261;91;550;350
8143;Tristeza;Parque Santa Fé;0;0;0;0;0;0
8144;Tristeza;Partenon;100;0;44;23;0;100
8145;Tristeza;Passo D'Areia;0;0;0;0;0;0
8146;Tristeza;Passo das Pedras;0;0;0;0;0;0
8147;Tristeza;Pedra Redonda;1000;100;452;211;250;750
8148;Tristeza;Petrópolis;100;0;61;23;0;100
8149;Tristeza;Pitinga;50;50;0;0;50;0
8150;Tristeza;Ponta Grossa;100;100;0;0;100;0
8151;Tristeza;Praia de Belas;100;50;37;11;50;50
8152;Tristeza;Restinga;150;0;52;29;50;100
8153;Tristeza;Rio Branco;50;0;0;0;50;0
8154;Tristeza;Rubem Berta;100;0;44;34;0;100
8155;Tristeza;Santa Cecília;0;0;0;0;0;0
8156;Tristeza;Santa Maria Goretti;0;0;0;0;0;0
8157;Tristeza;Santa Rosa de Lima;100;0;53;42;0;100
8158;Tristeza;Santa Tereza;900;400;168;85;600;300
8159;Tristeza;Santana;50;0;0;0;50;0
8160;Tristeza;Santo Antônio;200;150;29;16;150;50
8161;Tristeza;Sarandi;250;0;138;62;0;250
8162;Tristeza;Serraria;250;50;104;34;100;150
8163;Tristeza;São Caetano;0;0;0;0;0;0
8164;Tristeza;São Geraldo;50;0;28;22;0;50
8165;Tristeza;São José;150;0;57;30;50;100
8166;Tristeza;São João;50;0;27;15;0;50
8167;Tristeza;São Sebastião;0;0;0;0;0;0
8168;Tristeza;Sétimo Céu;3552;1700;397;161;3052;500
8169;Tristeza;Teresópolis;650;0;377;161;100;550
8170;Tristeza;Tristeza;1300;300;372;228;600;700
8171;Tristeza;Três Figueiras;50;0;0;0;50;0
8172;Tristeza;Vila Assunção;1500;400;417;183;850;650
8173;Tristeza;Vila Conceição;650;200;241;135;200;450
8174;Tristeza;Vila Ipiranga;0;0;0;0;0;0
8175;Tristeza;Vila Jardim;50;0;33;12;0;50
8176;Tristeza;Vila João Pessoa;0;0;0;0;0;0
8177;Tristeza;Vila Nova;1300;50;718;362;50;1250
8178;Três Figueiras;Aberta dos Morros;0;0;0;0;0;0
8179;Três Figueiras;Agronomia;50;0;0;0;50;0
8180;Três Figueiras;Anchieta;100;50;31;15;50;50
8181;Três Figueiras;Arquipélago;100;0;72;16;50;50
8182;Três Figueiras;Auxiliadora;800;50;300;180;200;600
8183;Três Figueiras;Azenha;0;0;0;0;0;0
8184;Três Figueiras;Bela Vista;400;150;114;50;200;200
8185;Três Figueiras;Belém Novo;100;0;49;25;0;100
8186;Três Figueiras;Belém Velho;50;0;35;8;0;50
8187;Três Figueiras;Boa Vista;800;150;393;138;250;550
8188;Três Figueiras;Boa Vista do Sul;0;0;0;0;0;0
8189;Três Figueiras;Bom Fim;0;0;0;0;0;0
8190;Três Figueiras;Bom Jesus;250;0;149;45;0;250
8191;Três Figueiras;Camaquã;100;0;46;26;0;100
8192;Três Figueiras;Campo Novo;100;0;31;15;50;50
8193;Três Figueiras;Cascata;50;0;22;7;0;50
8194;Três Figueiras;Cavalhada;150;100;27;11;100;50
8195;Três Figueiras;Cel. Aparício Borges;100;0;59;11;0;100
8196;Três Figueiras;Centro Histórico;500;50;173;76;150;350
8197;Três Figueiras;Chapéu do Sol;50;0;27;7;0;50
8198;Três Figueiras;Chácara das Pedras;628;300;25;14;578;50
8199;Três Figueiras;Cidade Baixa;200;50;80;31;50;150
8200;Três Figueiras;Costa e Silva;100;50;23;6;50;50
8201;Três Figueiras;Cristal;150;0;84;27;0;150
8202;Três Figueiras;Cristo Redentor;200;50;60;18;100;100
8203;Três Figueiras;Espírito Santo;0;0;0;0;0;0
8204;Três Figueiras;Extrema;0;0;0;0;0;0
8205;Três Figueiras;Farrapos;150;50;46;20;50;100
8206;Três Figueiras;Farroupilha;100;50;0;0;100;0
8207;Três Figueiras;Floresta;200;0;58;27;100;100
8208;Três Figueiras;Glória;150;0;27;16;100;50
8209;Três Figueiras;Guarujá;0;0;0;0;0;0
8210;Três Figueiras;Higienópolis;250;0;121;50;50;200
8211;Três Figueiras;Humaitá;50;0;32;7;0;50
8212;Três Figueiras;Hípica;100;0;35;6;50;50
8213;Três Figueiras;Independência;50;0;0;0;50;0
8214;Três Figueiras;Ipanema;0;0;0;0;0;0
8215;Três Figueiras;Jardim Botânico;300;100;88;34;150;150
8216;Três Figueiras;Jardim Carvalho;0;0;0;0;0;0
8217;Três Figueiras;Jardim Europa;300;150;70;22;200;100
8218;Três Figueiras;Jardim Floresta;0;0;0;0;0;0
8219;Três Figueiras;Jardim Isabel;50;0;35;7;0;50
8220;Três Figueiras;Jardim Itú;200;50;87;38;50;150
8221;Três Figueiras;Jardim Leopoldina;200;50;61;18;100;100
8222;Três Figueiras;Jardim Lindóia;100;0;50;0;100;0
8223;Três Figueiras;Jardim Sabará;200;0;52;25;100;100
8224;Três Figueiras;Jardim São Pedro;150;50;62;20;50;100
8225;Três Figueiras;Jardim do Salso;0;0;0;0;0;0
8226;Três Figueiras;Lageado;50;0;23;13;0;50
8227;Três Figueiras;Lami;0;0;0;0;0;0
8228;Três Figueiras;Lomba do Pinheiro;300;100;113;27;100;200
8229;Três Figueiras;Medianeira;100;50;30;8;50;50
8230;Três Figueiras;Menino Deus;100;0;30;20;50;50
8231;Três Figueiras;Moinhos de Vento;450;50;199;147;50;400
8232;Três Figueiras;Mont'Serrat;1800;150;890;348;300;1500
8233;Três Figueiras;Morro Santana;50;0;50;0;50;0
8234;Três Figueiras;Mário Quintana;250;100;58;14;150;100
8235;Três Figueiras;Navegantes;50;0;38;7;0;50
8236;Três Figueiras;Nonoai;150;0;37;8;100;50
8237;Três Figueiras;Parque Santa Fé;150;0;85;33;0;150
8238;Três Figueiras;Partenon;150;0;100;30;0;150
8239;Três Figueiras;Passo D'Areia;600;100;257;136;150;450
8240;Três Figueiras;Passo das Pedras;0;0;0;0;0;0
8241;Três Figueiras;Pedra Redonda;0;0;0;0;0;0
8242;Três Figueiras;Petrópolis;10400;1600;4190;1854;3600;6800
8243;Três Figueiras;Pitinga;0;0;0;0;0;0
8244;Três Figueiras;Ponta Grossa;0;0;0;0;0;0
8245;Três Figueiras;Praia de Belas;50;0;33;7;0;50
8246;Três Figueiras;Restinga;0;0;0;0;0;0
8247;Três Figueiras;Rio Branco;50;0;24;14;0;50
8248;Três Figueiras;Rubem Berta;300;50;74;41;150;150
8249;Três Figueiras;Santa Cecília;0;0;0;0;0;0
8250;Três Figueiras;Santa Maria Goretti;50;0;27;14;0;50
8251;Três Figueiras;Santa Rosa de Lima;150;0;64;11;50;100
8252;Três Figueiras;Santa Tereza;150;0;100;20;0;150
8253;Três Figueiras;Santana;150;100;31;16;100;50
8254;Três Figueiras;Santo Antônio;133;50;29;9;83;50
8255;Três Figueiras;Sarandi;100;50;23;14;50;50
8256;Três Figueiras;Serraria;50;0;29;12;0;50
8257;Três Figueiras;São Caetano;0;0;0;0;0;0
8258;Três Figueiras;São Geraldo;50;50;0;0;50;0
8259;Três Figueiras;São José;200;50;84;27;50;150
8260;Três Figueiras;São João;350;50;182;68;100;250
8261;Três Figueiras;São Sebastião;0;0;0;0;0;0
8262;Três Figueiras;Sétimo Céu;50;0;0;0;50;0
8263;Três Figueiras;Teresópolis;50;50;0;0;50;0
8264;Três Figueiras;Tristeza;50;0;0;0;50;0
8265;Três Figueiras;Três Figueiras;300;0;112;38;100;200
8266;Três Figueiras;Vila Assunção;0;0;0;0;0;0
8267;Três Figueiras;Vila Conceição;0;0;0;0;0;0
8268;Três Figueiras;Vila Ipiranga;450;200;132;69;200;250
8269;Três Figueiras;Vila Jardim;550;150;188;72;250;300
8270;Três Figueiras;Vila João Pessoa;150;0;62;24;50;100
8271;Três Figueiras;Vila Nova;50;0;30;7;0;50
8272;Vila Assunção;Aberta dos Morros;50;0;0;0;50;0
8273;Vila Assunção;Agronomia;0;0;0;0;0;0
8274;Vila Assunção;Anchieta;0;0;0;0;0;0
8275;Vila Assunção;Arquipélago;100;0;19;6;50;50
8276;Vila Assunção;Auxiliadora;50;0;33;10;0;50
8277;Vila Assunção;Azenha;50;0;27;10;0;50
8278;Vila Assunção;Bela Vista;50;0;28;17;0;50
8279;Vila Assunção;Belém Novo;100;0;62;24;0;100
8280;Vila Assunção;Belém Velho;0;0;0;0;0;0
8281;Vila Assunção;Boa Vista;100;50;24;16;50;50
8282;Vila Assunção;Boa Vista do Sul;50;0;25;11;0;50
8283;Vila Assunção;Bom Fim;0;0;0;0;0;0
8284;Vila Assunção;Bom Jesus;0;0;0;0;0;0
8285;Vila Assunção;Camaquã;900;200;160;73;600;300
8286;Vila Assunção;Campo Novo;50;0;50;0;50;0
8287;Vila Assunção;Cascata;0;0;0;0;0;0
8288;Vila Assunção;Cavalhada;400;50;195;83;50;350
8289;Vila Assunção;Cel. Aparício Borges;50;0;26;5;0;50
8290;Vila Assunção;Centro Histórico;100;0;40;25;0;100
8291;Vila Assunção;Chapéu do Sol;0;0;0;0;0;0
8292;Vila Assunção;Chácara das Pedras;50;0;26;11;0;50
8293;Vila Assunção;Cidade Baixa;0;0;0;0;0;0
8294;Vila Assunção;Costa e Silva;50;0;32;12;0;50
8295;Vila Assunção;Cristal;1300;300;511;183;500;800
8296;Vila Assunção;Cristo Redentor;50;0;50;0;50;0
8297;Vila Assunção;Espírito Santo;100;0;31;8;50;50
8298;Vila Assunção;Extrema;0;0;0;0;0;0
8299;Vila Assunção;Farrapos;0;0;0;0;0;0
8300;Vila Assunção;Farroupilha;0;0;0;0;0;0
8301;Vila Assunção;Floresta;0;0;0;0;0;0
8302;Vila Assunção;Glória;50;0;23;10;0;50
8303;Vila Assunção;Guarujá;0;0;0;0;0;0
8304;Vila Assunção;Higienópolis;0;0;0;0;0;0
8305;Vila Assunção;Humaitá;100;50;35;9;50;50
8306;Vila Assunção;Hípica;50;50;0;0;50;0
8307;Vila Assunção;Independência;50;0;0;0;50;0
8308;Vila Assunção;Ipanema;100;0;0;0;100;0
8309;Vila Assunção;Jardim Botânico;50;0;30;12;0;50
8310;Vila Assunção;Jardim Carvalho;100;0;27;15;50;50
8311;Vila Assunção;Jardim Europa;50;0;26;12;0;50
8312;Vila Assunção;Jardim Floresta;0;0;0;0;0;0
8313;Vila Assunção;Jardim Isabel;0;0;0;0;0;0
8314;Vila Assunção;Jardim Itú;50;50;0;0;50;0
8315;Vila Assunção;Jardim Leopoldina;0;0;0;0;0;0
8316;Vila Assunção;Jardim Lindóia;0;0;0;0;0;0
8317;Vila Assunção;Jardim Sabará;0;0;0;0;0;0
8318;Vila Assunção;Jardim São Pedro;0;0;0;0;0;0
8319;Vila Assunção;Jardim do Salso;0;0;0;0;0;0
8320;Vila Assunção;Lageado;0;0;0;0;0;0
8321;Vila Assunção;Lami;0;0;0;0;0;0
8322;Vila Assunção;Lomba do Pinheiro;150;0;92;17;0;150
8323;Vila Assunção;Medianeira;150;0;55;23;50;100
8324;Vila Assunção;Menino Deus;100;0;52;29;0;100
8325;Vila Assunção;Moinhos de Vento;50;0;30;11;0;50
8326;Vila Assunção;Mont'Serrat;0;0;0;0;0;0
8327;Vila Assunção;Morro Santana;50;0;30;9;0;50
8328;Vila Assunção;Mário Quintana;100;0;59;22;0;100
8329;Vila Assunção;Navegantes;0;0;0;0;0;0
8330;Vila Assunção;Nonoai;300;100;102;46;100;200
8331;Vila Assunção;Parque Santa Fé;0;0;0;0;0;0
8332;Vila Assunção;Partenon;100;0;28;12;50;50
8333;Vila Assunção;Passo D'Areia;50;0;16;22;0;50
8334;Vila Assunção;Passo das Pedras;0;0;0;0;0;0
8335;Vila Assunção;Pedra Redonda;50;0;34;14;0;50
8336;Vila Assunção;Petrópolis;100;50;0;0;100;0
8337;Vila Assunção;Pitinga;0;0;0;0;0;0
8338;Vila Assunção;Ponta Grossa;50;0;0;0;50;0
8339;Vila Assunção;Praia de Belas;100;50;24;13;50;50
8340;Vila Assunção;Restinga;50;0;31;8;0;50
8341;Vila Assunção;Rio Branco;100;0;51;30;0;100
8342;Vila Assunção;Rubem Berta;50;50;0;0;50;0
8343;Vila Assunção;Santa Cecília;0;0;0;0;0;0
8344;Vila Assunção;Santa Maria Goretti;0;0;0;0;0;0
8345;Vila Assunção;Santa Rosa de Lima;50;0;28;13;0;50
8346;Vila Assunção;Santa Tereza;200;100;30;10;150;50
8347;Vila Assunção;Santana;50;0;24;17;0;50
8348;Vila Assunção;Santo Antônio;50;50;0;0;50;0
8349;Vila Assunção;Sarandi;100;0;59;28;0;100
8350;Vila Assunção;Serraria;0;0;0;0;0;0
8351;Vila Assunção;São Caetano;0;0;0;0;0;0
8352;Vila Assunção;São Geraldo;0;0;0;0;0;0
8353;Vila Assunção;São José;0;0;0;0;0;0
8354;Vila Assunção;São João;50;0;31;9;0;50
8355;Vila Assunção;São Sebastião;0;0;0;0;0;0
8356;Vila Assunção;Sétimo Céu;250;0;146;63;0;250
8357;Vila Assunção;Teresópolis;100;0;65;27;0;100
8358;Vila Assunção;Tristeza;1500;400;417;183;850;650
8359;Vila Assunção;Três Figueiras;0;0;0;0;0;0
8360;Vila Assunção;Vila Assunção;1800;600;462;204;1000;800
8361;Vila Assunção;Vila Conceição;250;100;103;27;100;150
8362;Vila Assunção;Vila Ipiranga;50;0;33;15;0;50
8363;Vila Assunção;Vila Jardim;100;0;66;27;0;100
8364;Vila Assunção;Vila João Pessoa;100;0;52;31;0;100
8365;Vila Assunção;Vila Nova;550;50;263;126;50;500
8366;Vila Conceição;Aberta dos Morros;150;100;0;0;150;0
8367;Vila Conceição;Agronomia;0;0;0;0;0;0
8368;Vila Conceição;Anchieta;0;0;0;0;0;0
8369;Vila Conceição;Arquipélago;0;0;0;0;0;0
8370;Vila Conceição;Auxiliadora;50;0;50;0;50;0
8371;Vila Conceição;Azenha;50;0;28;15;0;50
8372;Vila Conceição;Bela Vista;100;0;57;31;0;100
8373;Vila Conceição;Belém Novo;50;50;0;0;50;0
8374;Vila Conceição;Belém Velho;50;0;29;17;0;50
8375;Vila Conceição;Boa Vista;0;0;0;0;0;0
8376;Vila Conceição;Boa Vista do Sul;0;0;0;0;0;0
8377;Vila Conceição;Bom Fim;50;0;0;0;50;0
8378;Vila Conceição;Bom Jesus;0;0;0;0;0;0
8379;Vila Conceição;Camaquã;300;50;154;46;50;250
8380;Vila Conceição;Campo Novo;0;0;0;0;0;0
8381;Vila Conceição;Cascata;0;0;0;0;0;0
8382;Vila Conceição;Cavalhada;600;150;186;68;250;350
8383;Vila Conceição;Cel. Aparício Borges;50;0;25;9;0;50
8384;Vila Conceição;Centro Histórico;150;0;56;18;50;100
8385;Vila Conceição;Chapéu do Sol;0;0;0;0;0;0
8386;Vila Conceição;Chácara das Pedras;50;0;27;8;0;50
8387;Vila Conceição;Cidade Baixa;0;0;0;0;0;0
8388;Vila Conceição;Costa e Silva;100;0;30;9;50;50
8389;Vila Conceição;Cristal;650;100;273;85;200;450
8390;Vila Conceição;Cristo Redentor;50;0;25;19;0;50
8391;Vila Conceição;Espírito Santo;250;100;102;26;100;150
8392;Vila Conceição;Extrema;0;0;0;0;0;0
8393;Vila Conceição;Farrapos;50;0;34;7;0;50
8394;Vila Conceição;Farroupilha;0;0;0;0;0;0
8395;Vila Conceição;Floresta;50;0;0;0;50;0
8396;Vila Conceição;Glória;0;0;0;0;0;0
8397;Vila Conceição;Guarujá;0;0;0;0;0;0
8398;Vila Conceição;Higienópolis;0;0;0;0;0;0
8399;Vila Conceição;Humaitá;0;0;0;0;0;0
8400;Vila Conceição;Hípica;50;0;0;0;50;0
8401;Vila Conceição;Independência;0;0;0;0;0;0
8402;Vila Conceição;Ipanema;1100;100;568;187;200;900
8403;Vila Conceição;Jardim Botânico;200;50;109;32;100;100
8404;Vila Conceição;Jardim Carvalho;150;0;93;25;0;150
8405;Vila Conceição;Jardim Europa;50;0;28;17;0;50
8406;Vila Conceição;Jardim Floresta;0;0;0;0;0;0
8407;Vila Conceição;Jardim Isabel;400;200;150;31;250;150
8408;Vila Conceição;Jardim Itú;50;50;0;0;50;0
8409;Vila Conceição;Jardim Leopoldina;0;0;0;0;0;0
8410;Vila Conceição;Jardim Lindóia;0;0;0;0;0;0
8411;Vila Conceição;Jardim Sabará;50;0;29;12;0;50
8412;Vila Conceição;Jardim São Pedro;0;0;0;0;0;0
8413;Vila Conceição;Jardim do Salso;0;0;0;0;0;0
8414;Vila Conceição;Lageado;0;0;0;0;0;0
8415;Vila Conceição;Lami;0;0;0;0;0;0
8416;Vila Conceição;Lomba do Pinheiro;150;0;88;27;0;150
8417;Vila Conceição;Medianeira;0;0;0;0;0;0
8418;Vila Conceição;Menino Deus;100;0;22;13;50;50
8419;Vila Conceição;Moinhos de Vento;0;0;0;0;0;0
8420;Vila Conceição;Mont'Serrat;0;0;0;0;0;0
8421;Vila Conceição;Morro Santana;50;0;26;7;0;50
8422;Vila Conceição;Mário Quintana;200;0;119;34;0;200
8423;Vila Conceição;Navegantes;0;0;0;0;0;0
8424;Vila Conceição;Nonoai;100;0;60;17;0;100
8425;Vila Conceição;Parque Santa Fé;0;0;0;0;0;0
8426;Vila Conceição;Partenon;100;0;75;8;0;100
8427;Vila Conceição;Passo D'Areia;50;0;25;17;0;50
8428;Vila Conceição;Passo das Pedras;50;50;0;0;50;0
8429;Vila Conceição;Pedra Redonda;141;50;28;19;91;50
8430;Vila Conceição;Petrópolis;200;0;118;59;0;200
8431;Vila Conceição;Pitinga;0;0;0;0;0;0
8432;Vila Conceição;Ponta Grossa;50;0;28;7;0;50
8433;Vila Conceição;Praia de Belas;0;0;0;0;0;0
8434;Vila Conceição;Restinga;50;0;27;8;0;50
8435;Vila Conceição;Rio Branco;100;0;45;30;0;100
8436;Vila Conceição;Rubem Berta;50;0;25;18;0;50
8437;Vila Conceição;Santa Cecília;0;0;0;0;0;0
8438;Vila Conceição;Santa Maria Goretti;0;0;0;0;0;0
8439;Vila Conceição;Santa Rosa de Lima;0;0;0;0;0;0
8440;Vila Conceição;Santa Tereza;150;0;26;15;100;50
8441;Vila Conceição;Santana;0;0;0;0;0;0
8442;Vila Conceição;Santo Antônio;50;50;0;0;50;0
8443;Vila Conceição;Sarandi;150;0;90;39;0;150
8444;Vila Conceição;Serraria;150;0;92;25;0;150
8445;Vila Conceição;São Caetano;0;0;0;0;0;0
8446;Vila Conceição;São Geraldo;50;0;28;14;0;50
8447;Vila Conceição;São José;50;50;0;0;50;0
8448;Vila Conceição;São João;0;0;0;0;0;0
8449;Vila Conceição;São Sebastião;150;50;59;14;50;100
8450;Vila Conceição;Sétimo Céu;0;0;0;0;0;0
8451;Vila Conceição;Teresópolis;0;0;0;0;0;0
8452;Vila Conceição;Tristeza;650;200;241;135;200;450
8453;Vila Conceição;Três Figueiras;0;0;0;0;0;0
8454;Vila Conceição;Vila Assunção;250;100;103;27;100;150
8455;Vila Conceição;Vila Conceição;1100;200;496;212;400;700
8456;Vila Conceição;Vila Ipiranga;100;0;26;12;50;50
8457;Vila Conceição;Vila Jardim;50;0;28;13;0;50
8458;Vila Conceição;Vila João Pessoa;0;0;0;0;0;0
8459;Vila Conceição;Vila Nova;0;0;0;0;0;0
8460;Vila Ipiranga;Aberta dos Morros;150;0;29;12;100;50
8461;Vila Ipiranga;Agronomia;0;0;0;0;0;0
8462;Vila Ipiranga;Anchieta;50;50;0;0;50;0
8463;Vila Ipiranga;Arquipélago;0;0;0;0;0;0
8464;Vila Ipiranga;Auxiliadora;150;0;88;46;0;150
8465;Vila Ipiranga;Azenha;50;0;36;12;0;50
8466;Vila Ipiranga;Bela Vista;100;0;30;13;50;50
8467;Vila Ipiranga;Belém Novo;150;0;82;43;0;150
8468;Vila Ipiranga;Belém Velho;150;100;26;15;100;50
8469;Vila Ipiranga;Boa Vista;600;150;249;97;150;450
8470;Vila Ipiranga;Boa Vista do Sul;100;0;71;15;0;100
8471;Vila Ipiranga;Bom Fim;100;0;32;10;50;50
8472;Vila Ipiranga;Bom Jesus;750;150;320;107;200;550
8473;Vila Ipiranga;Camaquã;200;0;54;23;100;100
8474;Vila Ipiranga;Campo Novo;100;100;0;0;100;0
8475;Vila Ipiranga;Cascata;0;0;0;0;0;0
8476;Vila Ipiranga;Cavalhada;150;0;77;35;0;150
8477;Vila Ipiranga;Cel. Aparício Borges;100;0;57;21;0;100
8478;Vila Ipiranga;Centro Histórico;150;0;86;30;0;150
8479;Vila Ipiranga;Chapéu do Sol;100;0;58;16;0;100
8480;Vila Ipiranga;Chácara das Pedras;650;100;119;55;450;200
8481;Vila Ipiranga;Cidade Baixa;150;50;30;8;100;50
8482;Vila Ipiranga;Costa e Silva;400;50;201;39;100;300
8483;Vila Ipiranga;Cristal;300;100;114;47;100;200
8484;Vila Ipiranga;Cristo Redentor;3500;850;1264;497;1550;1950
8485;Vila Ipiranga;Espírito Santo;50;0;35;13;0;50
8486;Vila Ipiranga;Extrema;50;0;28;10;0;50
8487;Vila Ipiranga;Farrapos;150;0;103;25;0;150
8488;Vila Ipiranga;Farroupilha;50;0;30;10;0;50
8489;Vila Ipiranga;Floresta;50;0;25;13;0;50
8490;Vila Ipiranga;Glória;100;50;0;0;100;0
8491;Vila Ipiranga;Guarujá;0;0;0;0;0;0
8492;Vila Ipiranga;Higienópolis;250;0;167;41;50;200
8493;Vila Ipiranga;Humaitá;50;0;28;6;0;50
8494;Vila Ipiranga;Hípica;0;0;0;0;0;0
8495;Vila Ipiranga;Independência;50;0;0;0;50;0
8496;Vila Ipiranga;Ipanema;150;50;63;32;50;100
8497;Vila Ipiranga;Jardim Botânico;50;0;28;10;0;50
8498;Vila Ipiranga;Jardim Carvalho;250;50;75;35;100;150
8499;Vila Ipiranga;Jardim Europa;2800;300;1414;601;350;2450
8500;Vila Ipiranga;Jardim Floresta;350;50;117;53;150;200
8501;Vila Ipiranga;Jardim Isabel;50;0;26;11;0;50
8502;Vila Ipiranga;Jardim Itú;850;200;309;113;300;550
8503;Vila Ipiranga;Jardim Leopoldina;200;50;91;26;50;150
8504;Vila Ipiranga;Jardim Lindóia;600;100;132;75;350;250
8505;Vila Ipiranga;Jardim Sabará;400;0;186;71;100;300
8506;Vila Ipiranga;Jardim São Pedro;500;50;215;116;100;400
8507;Vila Ipiranga;Jardim do Salso;150;0;70;41;0;150
8508;Vila Ipiranga;Lageado;100;0;25;9;50;50
8509;Vila Ipiranga;Lami;100;0;32;10;50;50
8510;Vila Ipiranga;Lomba do Pinheiro;300;100;80;38;150;150
8511;Vila Ipiranga;Medianeira;50;0;23;24;0;50
8512;Vila Ipiranga;Menino Deus;350;100;153;50;100;250
8513;Vila Ipiranga;Moinhos de Vento;100;0;46;43;0;100
8514;Vila Ipiranga;Mont'Serrat;200;0;31;16;150;50
8515;Vila Ipiranga;Morro Santana;500;100;103;39;300;200
8516;Vila Ipiranga;Mário Quintana;350;50;117;33;150;200
8517;Vila Ipiranga;Navegantes;150;0;66;20;50;100
8518;Vila Ipiranga;Nonoai;350;50;150;51;100;250
8519;Vila Ipiranga;Parque Santa Fé;50;0;25;11;0;50
8520;Vila Ipiranga;Partenon;150;0;92;36;0;150
8521;Vila Ipiranga;Passo D'Areia;1250;350;285;199;650;600
8522;Vila Ipiranga;Passo das Pedras;400;150;118;35;200;200
8523;Vila Ipiranga;Pedra Redonda;0;0;0;0;0;0
8524;Vila Ipiranga;Petrópolis;350;100;93;40;200;150
8525;Vila Ipiranga;Pitinga;100;100;0;0;100;0
8526;Vila Ipiranga;Ponta Grossa;0;0;0;0;0;0
8527;Vila Ipiranga;Praia de Belas;200;50;55;18;100;100
8528;Vila Ipiranga;Restinga;200;0;77;37;50;150
8529;Vila Ipiranga;Rio Branco;400;50;160;91;100;300
8530;Vila Ipiranga;Rubem Berta;350;50;116;100;100;250
8531;Vila Ipiranga;Santa Cecília;350;100;112;49;150;200
8532;Vila Ipiranga;Santa Maria Goretti;300;100;84;35;150;150
8533;Vila Ipiranga;Santa Rosa de Lima;150;100;0;0;150;0
8534;Vila Ipiranga;Santa Tereza;300;50;141;50;50;250
8535;Vila Ipiranga;Santana;250;0;88;32;100;150
8536;Vila Ipiranga;Santo Antônio;100;0;55;32;0;100
8537;Vila Ipiranga;Sarandi;550;50;259;110;100;450
8538;Vila Ipiranga;Serraria;100;0;59;26;0;100
8539;Vila Ipiranga;São Caetano;0;0;0;0;0;0
8540;Vila Ipiranga;São Geraldo;100;50;0;0;100;0
8541;Vila Ipiranga;São José;100;50;34;8;50;50
8542;Vila Ipiranga;São João;100;50;34;12;50;50
8543;Vila Ipiranga;São Sebastião;550;100;240;94;100;450
8544;Vila Ipiranga;Sétimo Céu;50;0;27;11;0;50
8545;Vila Ipiranga;Teresópolis;150;100;34;14;100;50
8546;Vila Ipiranga;Tristeza;0;0;0;0;0;0
8547;Vila Ipiranga;Três Figueiras;450;200;132;69;200;250
8548;Vila Ipiranga;Vila Assunção;50;0;33;15;0;50
8549;Vila Ipiranga;Vila Conceição;100;0;26;12;50;50
8550;Vila Ipiranga;Vila Ipiranga;8800;1600;3938;1410;2900;5900
8551;Vila Ipiranga;Vila Jardim;1900;150;871;363;400;1500
8552;Vila Ipiranga;Vila João Pessoa;50;0;21;18;0;50
8553;Vila Ipiranga;Vila Nova;150;0;110;22;50;100
8554;Vila Jardim;Aberta dos Morros;50;0;34;13;0;50
8555;Vila Jardim;Agronomia;150;50;21;13;100;50
8556;Vila Jardim;Anchieta;0;0;0;0;0;0
8557;Vila Jardim;Arquipélago;50;0;36;6;0;50
8558;Vila Jardim;Auxiliadora;100;0;55;25;0;100
8559;Vila Jardim;Azenha;100;50;20;20;50;50
8560;Vila Jardim;Bela Vista;100;0;63;27;0;100
8561;Vila Jardim;Belém Novo;50;0;28;8;0;50
8562;Vila Jardim;Belém Velho;100;50;36;9;50;50
8563;Vila Jardim;Boa Vista;300;100;90;41;150;150
8564;Vila Jardim;Boa Vista do Sul;100;0;29;12;50;50
8565;Vila Jardim;Bom Fim;100;0;25;11;50;50
8566;Vila Jardim;Bom Jesus;2400;900;693;230;1200;1200
8567;Vila Jardim;Camaquã;50;50;0;0;50;0
8568;Vila Jardim;Campo Novo;50;50;0;0;50;0
8569;Vila Jardim;Cascata;100;50;50;0;100;0
8570;Vila Jardim;Cavalhada;100;50;22;12;50;50
8571;Vila Jardim;Cel. Aparício Borges;200;50;104;23;100;100
8572;Vila Jardim;Centro Histórico;300;50;121;30;100;200
8573;Vila Jardim;Chapéu do Sol;0;0;0;0;0;0
8574;Vila Jardim;Chácara das Pedras;1800;400;328;152;1250;550
8575;Vila Jardim;Cidade Baixa;150;0;65;35;0;150
8576;Vila Jardim;Costa e Silva;150;0;69;20;50;100
8577;Vila Jardim;Cristal;50;50;0;0;50;0
8578;Vila Jardim;Cristo Redentor;350;50;103;59;150;200
8579;Vila Jardim;Espírito Santo;50;0;0;0;50;0
8580;Vila Jardim;Extrema;100;0;26;14;50;50
8581;Vila Jardim;Farrapos;50;0;24;11;0;50
8582;Vila Jardim;Farroupilha;150;0;23;9;100;50
8583;Vila Jardim;Floresta;0;0;0;0;0;0
8584;Vila Jardim;Glória;0;0;0;0;0;0
8585;Vila Jardim;Guarujá;0;0;0;0;0;0
8586;Vila Jardim;Higienópolis;100;0;55;30;0;100
8587;Vila Jardim;Humaitá;150;100;29;12;100;50
8588;Vila Jardim;Hípica;0;0;0;0;0;0
8589;Vila Jardim;Independência;100;0;66;23;0;100
8590;Vila Jardim;Ipanema;100;0;62;24;0;100
8591;Vila Jardim;Jardim Botânico;250;0;143;61;0;250
8592;Vila Jardim;Jardim Carvalho;500;100;175;74;200;300
8593;Vila Jardim;Jardim Europa;400;0;214;112;0;400
8594;Vila Jardim;Jardim Floresta;200;50;77;48;50;150
8595;Vila Jardim;Jardim Isabel;50;0;26;12;0;50
8596;Vila Jardim;Jardim Itú;1400;50;756;307;100;1300
8597;Vila Jardim;Jardim Leopoldina;0;0;0;0;0;0
8598;Vila Jardim;Jardim Lindóia;350;50;179;95;50;300
8599;Vila Jardim;Jardim Sabará;3133;1050;545;193;2333;800
8600;Vila Jardim;Jardim São Pedro;0;0;0;0;0;0
8601;Vila Jardim;Jardim do Salso;350;100;132;65;100;250
8602;Vila Jardim;Lageado;50;0;25;21;0;50
8603;Vila Jardim;Lami;100;0;23;23;50;50
8604;Vila Jardim;Lomba do Pinheiro;100;0;56;13;0;100
8605;Vila Jardim;Medianeira;50;50;0;0;50;0
8606;Vila Jardim;Menino Deus;100;50;0;0;100;0
8607;Vila Jardim;Moinhos de Vento;150;50;43;26;50;100
8608;Vila Jardim;Mont'Serrat;100;0;55;32;0;100
8609;Vila Jardim;Morro Santana;100;50;30;7;50;50
8610;Vila Jardim;Mário Quintana;250;0;154;17;100;150
8611;Vila Jardim;Navegantes;50;0;0;0;50;0
8612;Vila Jardim;Nonoai;250;100;67;18;150;100
8613;Vila Jardim;Parque Santa Fé;100;0;64;27;0;100
8614;Vila Jardim;Partenon;450;100;212;47;250;200
8615;Vila Jardim;Passo D'Areia;200;50;57;50;50;150
8616;Vila Jardim;Passo das Pedras;250;0;140;59;0;250
8617;Vila Jardim;Pedra Redonda;50;0;22;13;0;50
8618;Vila Jardim;Petrópolis;850;200;305;117;400;450
8619;Vila Jardim;Pitinga;0;0;0;0;0;0
8620;Vila Jardim;Ponta Grossa;0;0;0;0;0;0
8621;Vila Jardim;Praia de Belas;100;0;30;6;50;50
8622;Vila Jardim;Restinga;250;100;22;15;200;50
8623;Vila Jardim;Rio Branco;250;50;97;43;100;150
8624;Vila Jardim;Rubem Berta;50;50;0;0;50;0
8625;Vila Jardim;Santa Cecília;50;0;33;11;0;50
8626;Vila Jardim;Santa Maria Goretti;50;0;30;18;0;50
8627;Vila Jardim;Santa Rosa de Lima;200;0;60;18;100;100
8628;Vila Jardim;Santa Tereza;50;0;33;12;0;50
8629;Vila Jardim;Santana;200;0;124;56;0;200
8630;Vila Jardim;Santo Antônio;150;0;50;35;50;100
8631;Vila Jardim;Sarandi;400;0;191;101;50;350
8632;Vila Jardim;Serraria;50;50;0;0;50;0
8633;Vila Jardim;São Caetano;150;50;58;26;50;100
8634;Vila Jardim;São Geraldo;100;50;0;0;100;0
8635;Vila Jardim;São José;250;50;27;15;200;50
8636;Vila Jardim;São João;200;50;89;40;50;150
8637;Vila Jardim;São Sebastião;200;50;66;13;100;100
8638;Vila Jardim;Sétimo Céu;50;50;0;0;50;0
8639;Vila Jardim;Teresópolis;50;0;0;0;50;0
8640;Vila Jardim;Tristeza;50;0;33;12;0;50
8641;Vila Jardim;Três Figueiras;550;150;188;72;250;300
8642;Vila Jardim;Vila Assunção;100;0;66;27;0;100
8643;Vila Jardim;Vila Conceição;50;0;28;13;0;50
8644;Vila Jardim;Vila Ipiranga;1900;150;871;363;400;1500
8645;Vila Jardim;Vila Jardim;8900;500;4374;2042;1200;7700
8646;Vila Jardim;Vila João Pessoa;350;50;101;48;150;200
8647;Vila Jardim;Vila Nova;200;50;89;30;50;150
8648;Vila João Pessoa;Aberta dos Morros;0;0;0;0;0;0
8649;Vila João Pessoa;Agronomia;150;0;90;28;0;150
8650;Vila João Pessoa;Anchieta;50;0;44;6;0;50
8651;Vila João Pessoa;Arquipélago;200;100;21;14;150;50
8652;Vila João Pessoa;Auxiliadora;250;100;92;30;100;150
8653;Vila João Pessoa;Azenha;100;50;32;15;50;50
8654;Vila João Pessoa;Bela Vista;50;0;25;11;0;50
8655;Vila João Pessoa;Belém Novo;200;0;131;42;0;200
8656;Vila João Pessoa;Belém Velho;250;0;161;38;0;250
8657;Vila João Pessoa;Boa Vista;50;0;25;9;0;50
8658;Vila João Pessoa;Boa Vista do Sul;50;0;25;12;0;50
8659;Vila João Pessoa;Bom Fim;50;0;28;14;0;50
8660;Vila João Pessoa;Bom Jesus;600;50;335;117;50;550
8661;Vila João Pessoa;Camaquã;150;50;67;18;50;100
8662;Vila João Pessoa;Campo Novo;200;50;55;25;100;100
8663;Vila João Pessoa;Cascata;1250;300;508;106;500;750
8664;Vila João Pessoa;Cavalhada;200;100;29;13;150;50
8665;Vila João Pessoa;Cel. Aparício Borges;4350;1200;1336;418;1950;2400
8666;Vila João Pessoa;Centro Histórico;50;0;19;15;0;50
8667;Vila João Pessoa;Chapéu do Sol;0;0;0;0;0;0
8668;Vila João Pessoa;Chácara das Pedras;400;0;166;80;100;300
8669;Vila João Pessoa;Cidade Baixa;150;50;30;8;100;50
8670;Vila João Pessoa;Costa e Silva;150;0;88;25;0;150
8671;Vila João Pessoa;Cristal;150;0;26;10;100;50
8672;Vila João Pessoa;Cristo Redentor;50;0;32;13;0;50
8673;Vila João Pessoa;Espírito Santo;0;0;0;0;0;0
8674;Vila João Pessoa;Extrema;100;0;56;23;0;100
8675;Vila João Pessoa;Farrapos;300;50;151;54;50;250
8676;Vila João Pessoa;Farroupilha;13;0;0;0;13;0
8677;Vila João Pessoa;Floresta;50;0;0;0;50;0
8678;Vila João Pessoa;Glória;1200;150;450;179;400;800
8679;Vila João Pessoa;Guarujá;50;0;36;9;0;50
8680;Vila João Pessoa;Higienópolis;150;50;34;9;100;50
8681;Vila João Pessoa;Humaitá;100;0;60;17;0;100
8682;Vila João Pessoa;Hípica;300;50;133;34;100;200
8683;Vila João Pessoa;Independência;100;0;0;0;100;0
8684;Vila João Pessoa;Ipanema;0;0;0;0;0;0
8685;Vila João Pessoa;Jardim Botânico;1300;350;407;151;600;700
8686;Vila João Pessoa;Jardim Carvalho;1150;0;618;215;100;1050
8687;Vila João Pessoa;Jardim Europa;200;0;122;48;0;200
8688;Vila João Pessoa;Jardim Floresta;0;0;0;0;0;0
8689;Vila João Pessoa;Jardim Isabel;50;0;31;11;0;50
8690;Vila João Pessoa;Jardim Itú;350;0;207;87;0;350
8691;Vila João Pessoa;Jardim Leopoldina;50;0;33;4;0;50
8692;Vila João Pessoa;Jardim Lindóia;50;0;0;0;50;0
8693;Vila João Pessoa;Jardim Sabará;50;0;0;0;50;0
8694;Vila João Pessoa;Jardim São Pedro;0;0;0;0;0;0
8695;Vila João Pessoa;Jardim do Salso;1150;200;472;192;350;800
8696;Vila João Pessoa;Lageado;50;0;27;11;0;50
8697;Vila João Pessoa;Lami;150;0;90;32;0;150
8698;Vila João Pessoa;Lomba do Pinheiro;1300;50;683;153;150;1150
8699;Vila João Pessoa;Medianeira;100;50;30;16;50;50
8700;Vila João Pessoa;Menino Deus;100;100;0;0;100;0
8701;Vila João Pessoa;Moinhos de Vento;0;0;0;0;0;0
8702;Vila João Pessoa;Mont'Serrat;200;50;89;33;50;150
8703;Vila João Pessoa;Morro Santana;150;0;56;20;50;100
8704;Vila João Pessoa;Mário Quintana;150;0;91;25;0;150
8705;Vila João Pessoa;Navegantes;50;0;29;12;0;50
8706;Vila João Pessoa;Nonoai;100;0;64;23;0;100
8707;Vila João Pessoa;Parque Santa Fé;0;0;0;0;0;0
8708;Vila João Pessoa;Partenon;2100;500;760;310;750;1350
8709;Vila João Pessoa;Passo D'Areia;50;0;37;6;0;50
8710;Vila João Pessoa;Passo das Pedras;50;0;28;11;0;50
8711;Vila João Pessoa;Pedra Redonda;50;0;0;0;50;0
8712;Vila João Pessoa;Petrópolis;500;50;226;111;100;400
8713;Vila João Pessoa;Pitinga;100;0;56;16;0;100
8714;Vila João Pessoa;Ponta Grossa;100;50;29;10;50;50
8715;Vila João Pessoa;Praia de Belas;100;0;31;9;50;50
8716;Vila João Pessoa;Restinga;250;50;83;26;100;150
8717;Vila João Pessoa;Rio Branco;150;0;31;9;100;50
8718;Vila João Pessoa;Rubem Berta;50;0;25;19;0;50
8719;Vila João Pessoa;Santa Cecília;100;0;60;23;0;100
8720;Vila João Pessoa;Santa Maria Goretti;100;50;26;10;50;50
8721;Vila João Pessoa;Santa Rosa de Lima;50;0;28;12;0;50
8722;Vila João Pessoa;Santa Tereza;450;200;147;54;200;250
8723;Vila João Pessoa;Santana;250;50;53;22;150;100
8724;Vila João Pessoa;Santo Antônio;550;50;79;39;400;150
8725;Vila João Pessoa;Sarandi;50;0;25;13;0;50
8726;Vila João Pessoa;Serraria;150;0;90;28;0;150
8727;Vila João Pessoa;São Caetano;50;0;33;13;0;50
8728;Vila João Pessoa;São Geraldo;50;0;0;0;50;0
8729;Vila João Pessoa;São José;1735;600;414;144;1035;700
8730;Vila João Pessoa;São João;250;50;121;48;100;150
8731;Vila João Pessoa;São Sebastião;50;0;30;11;0;50
8732;Vila João Pessoa;Sétimo Céu;0;0;0;0;0;0
8733;Vila João Pessoa;Teresópolis;300;0;158;52;50;250
8734;Vila João Pessoa;Tristeza;0;0;0;0;0;0
8735;Vila João Pessoa;Três Figueiras;150;0;62;24;50;100
8736;Vila João Pessoa;Vila Assunção;100;0;52;31;0;100
8737;Vila João Pessoa;Vila Conceição;0;0;0;0;0;0
8738;Vila João Pessoa;Vila Ipiranga;50;0;21;18;0;50
8739;Vila João Pessoa;Vila Jardim;350;50;101;48;150;200
8740;Vila João Pessoa;Vila João Pessoa;4500;1700;1300;430;2300;2200
8741;Vila João Pessoa;Vila Nova;150;0;85;26;0;150
8742;Vila Nova;Aberta dos Morros;1000;150;477;147;200;800
8743;Vila Nova;Agronomia;200;0;25;18;150;50
8744;Vila Nova;Anchieta;350;0;216;57;50;300
8745;Vila Nova;Arquipélago;150;0;54;21;50;100
8746;Vila Nova;Auxiliadora;100;0;53;30;0;100
8747;Vila Nova;Azenha;250;0;150;55;0;250
8748;Vila Nova;Bela Vista;100;50;29;13;50;50
8749;Vila Nova;Belém Novo;300;0;130;54;50;250
8750;Vila Nova;Belém Velho;4450;550;1928;670;1100;3350
8751;Vila Nova;Boa Vista;50;0;32;8;0;50
8752;Vila Nova;Boa Vista do Sul;100;100;0;0;100;0
8753;Vila Nova;Bom Fim;50;0;18;22;0;50
8754;Vila Nova;Bom Jesus;150;0;96;27;0;150
8755;Vila Nova;Camaquã;600;0;263;82;150;450
8756;Vila Nova;Campo Novo;1950;200;759;257;600;1350
8757;Vila Nova;Cascata;1100;250;315;91;650;450
8758;Vila Nova;Cavalhada;1750;300;751;293;450;1300
8759;Vila Nova;Cel. Aparício Borges;450;50;186;50;200;250
8760;Vila Nova;Centro Histórico;250;100;51;22;150;100
8761;Vila Nova;Chapéu do Sol;150;50;62;24;50;100
8762;Vila Nova;Chácara das Pedras;50;0;34;10;0;50
8763;Vila Nova;Cidade Baixa;250;50;123;40;50;200
8764;Vila Nova;Costa e Silva;150;100;31;7;100;50
8765;Vila Nova;Cristal;500;100;190;79;150;350
8766;Vila Nova;Cristo Redentor;200;0;31;8;150;50
8767;Vila Nova;Espírito Santo;750;200;194;64;400;350
8768;Vila Nova;Extrema;250;0;78;34;100;150
8769;Vila Nova;Farrapos;150;50;84;10;100;50
8770;Vila Nova;Farroupilha;50;50;0;0;50;0
8771;Vila Nova;Floresta;100;0;60;26;0;100
8772;Vila Nova;Glória;750;100;254;117;300;450
8773;Vila Nova;Guarujá;200;0;121;44;0;200
8774;Vila Nova;Higienópolis;100;0;70;18;0;100
8775;Vila Nova;Humaitá;150;50;54;18;50;100
8776;Vila Nova;Hípica;450;100;140;27;300;150
8777;Vila Nova;Independência;100;0;21;15;50;50
8778;Vila Nova;Ipanema;1750;0;950;371;150;1600
8779;Vila Nova;Jardim Botânico;300;100;64;21;200;100
8780;Vila Nova;Jardim Carvalho;150;50;26;11;100;50
8781;Vila Nova;Jardim Europa;50;50;0;0;50;0
8782;Vila Nova;Jardim Floresta;50;0;32;6;0;50
8783;Vila Nova;Jardim Isabel;300;0;143;51;50;250
8784;Vila Nova;Jardim Itú;100;0;33;12;50;50
8785;Vila Nova;Jardim Leopoldina;350;0;165;65;50;300
8786;Vila Nova;Jardim Lindóia;300;100;111;56;100;200
8787;Vila Nova;Jardim Sabará;250;0;119;27;50;200
8788;Vila Nova;Jardim São Pedro;100;0;54;23;0;100
8789;Vila Nova;Jardim do Salso;50;0;31;8;0;50
8790;Vila Nova;Lageado;250;150;0;0;250;0
8791;Vila Nova;Lami;250;0;93;23;100;150
8792;Vila Nova;Lomba do Pinheiro;300;150;55;11;200;100
8793;Vila Nova;Medianeira;150;100;31;11;100;50
8794;Vila Nova;Menino Deus;150;100;35;7;100;50
8795;Vila Nova;Moinhos de Vento;100;0;50;27;0;100
8796;Vila Nova;Mont'Serrat;100;50;0;0;100;0
8797;Vila Nova;Morro Santana;50;0;36;8;0;50
8798;Vila Nova;Mário Quintana;150;50;63;21;50;100
8799;Vila Nova;Navegantes;100;0;31;12;50;50
8800;Vila Nova;Nonoai;1050;50;509;166;200;850
8801;Vila Nova;Parque Santa Fé;150;50;27;10;100;50
8802;Vila Nova;Partenon;350;50;135;57;100;250
8803;Vila Nova;Passo D'Areia;200;0;74;47;50;150
8804;Vila Nova;Passo das Pedras;350;50;143;57;100;250
8805;Vila Nova;Pedra Redonda;100;0;58;19;0;100
8806;Vila Nova;Petrópolis;400;50;171;61;100;300
8807;Vila Nova;Pitinga;50;0;34;9;0;50
8808;Vila Nova;Ponta Grossa;200;50;59;15;100;100
8809;Vila Nova;Praia de Belas;50;0;0;0;50;0
8810;Vila Nova;Restinga;1400;300;328;80;900;500
8811;Vila Nova;Rio Branco;100;50;34;9;50;50
8812;Vila Nova;Rubem Berta;250;0;76;38;100;150
8813;Vila Nova;Santa Cecília;100;50;23;8;50;50
8814;Vila Nova;Santa Maria Goretti;150;50;53;16;50;100
8815;Vila Nova;Santa Rosa de Lima;350;0;128;51;100;250
8816;Vila Nova;Santa Tereza;200;50;53;23;100;100
8817;Vila Nova;Santana;150;50;62;20;50;100
8818;Vila Nova;Santo Antônio;100;0;56;17;0;100
8819;Vila Nova;Sarandi;450;50;202;80;100;350
8820;Vila Nova;Serraria;200;0;79;24;50;150
8821;Vila Nova;São Caetano;100;50;24;14;50;50
8822;Vila Nova;São Geraldo;150;0;89;24;0;150
8823;Vila Nova;São José;600;200;130;55;350;250
8824;Vila Nova;São João;100;50;32;10;50;50
8825;Vila Nova;São Sebastião;100;0;0;0;100;0
8826;Vila Nova;Sétimo Céu;350;0;183;53;50;300
8827;Vila Nova;Teresópolis;2050;400;768;272;700;1350
8828;Vila Nova;Tristeza;1300;50;718;362;50;1250
8829;Vila Nova;Três Figueiras;50;0;30;7;0;50
8830;Vila Nova;Vila Assunção;550;50;263;126;50;500
8831;Vila Nova;Vila Conceição;0;0;0;0;0;0
8832;Vila Nova;Vila Ipiranga;150;0;110;22;50;100
8833;Vila Nova;Vila Jardim;200;50;89;30;50;150
8834;Vila Nova;Vila João Pessoa;150;0;85;26;0;150
8835;Vila Nova;Vila Nova;8200;3500;542;110;7600;600
