Frame;Hour;Day;Region;Total;Locals;Outsiders;dTotals;dLocals;dOutsiders
0;0;0;Aberta dos Morros;7113;7081;32;-33;-65;32
0;0;0;Agronomia;2336;2300;36;5;-31;36
0;0;0;Anchieta;2024;1978;46;0;-46;46
0;0;0;Arquipélago;8336;8292;44;6;-38;44
0;0;0;Auxiliadora;9615;9554;61;-68;-129;61
0;0;0;Azenha;13732;13637;95;-72;-167;95
0;0;0;Bela Vista;11710;11648;62;-77;-139;62
0;0;0;Belém Novo;10085;10070;15;-15;-30;15
0;0;0;Belém Velho;10831;10792;39;-4;-43;39
0;0;0;Boa Vista;10000;9937;63;-53;-116;63
0;0;0;Boa Vista do Sul;2284;2269;15;-25;-40;15
0;0;0;Bom Fim;11472;11430;42;-121;-163;42
0;0;0;Bom Jesus;28644;28586;58;-31;-89;58
0;0;0;Camaquã;17901;17853;48;-37;-85;48
0;0;0;Campo Novo;8751;8709;42;-15;-57;42
0;0;0;Cascata;13005;12956;49;-8;-57;49
0;0;0;Cavalhada;29270;29218;52;-29;-81;52
0;0;0;Centro;39192;39077;115;38;-77;115
0;0;0;Chácara das Pedras;6639;6574;65;-29;-94;65
0;0;0;Chapéu do Sol;2900;2870;30;-13;-43;30
0;0;0;Cidade Baixa;15305;15244;61;-74;-135;61
0;0;0;Coronel Aparício Borges;19271;19212;59;-32;-91;59
0;0;0;Costa e Silva;15836;15782;54;-6;-60;54
0;0;0;Cristal;31929;31879;50;-17;-67;50
0;0;0;Cristo Redentor;16466;16322;144;11;-133;144
0;0;0;Espírito Santo;5585;5537;48;-21;-69;48
0;0;0;Extrema;1977;1968;9;-4;-13;9
0;0;0;Farrapos;19003;18949;54;17;-37;54
0;0;0;Farroupilha;952;809;143;-9;-152;143
0;0;0;Floresta;11543;11480;63;-53;-116;63
0;0;0;Glória;17106;16979;127;39;-88;127
0;0;0;Guarujá;4796;4746;50;-15;-65;50
0;0;0;Higienópolis;10693;10628;65;-31;-96;65
0;0;0;Hípica;18636;18592;44;-9;-53;44
0;0;0;Humaitá;11524;11465;59;22;-37;59
0;0;0;Independência;8137;7978;159;25;-134;159
0;0;0;Ipanema;13712;13662;50;-16;-66;50
0;0;0;Jardim Botânico;12555;12408;147;34;-113;147
0;0;0;Jardim Carvalho;25469;25329;140;83;-57;140
0;0;0;Jardim do Salso;4392;4327;65;-13;-78;65
0;0;0;Jardim Dona Leopoldina;18004;17947;57;-12;-69;57
0;0;0;Jardim Europa;2276;2207;69;-23;-92;69
0;0;0;Jardim Floresta;3292;3225;67;-15;-82;67
0;0;0;Jardim Isabel;2810;2756;54;-25;-79;54
0;0;0;Jardim Itu;17841;17775;66;-12;-78;66
0;0;0;Jardim Lindóia;7400;7331;69;-17;-86;69
0;0;0;Jardim Sabará;13522;13456;66;-8;-74;66
0;0;0;Jardim São Pedro;3946;3877;69;-21;-90;69
0;0;0;Lageado;4486;4452;34;5;-29;34
0;0;0;Lami;4283;4262;21;-6;-27;21
0;0;0;Lomba do Pinheiro;58134;58086;48;28;-20;48
0;0;0;Mário Quintana;38124;38067;57;8;-49;57
0;0;0;Medianeira;11183;11119;64;-40;-104;64
0;0;0;Menino Deus;31711;31547;164;61;-103;164
0;0;0;Moinhos de Vento;11992;11820;172;55;-117;172
0;0;0;MontSerrat;11188;11118;70;-48;-118;70
0;0;0;Morro Santana;19351;19288;63;13;-50;63
0;0;0;Navegantes;4335;4268;67;8;-59;67
0;0;0;Nonoai;25140;25081;59;-20;-79;59
0;0;0;Parque Santa Fé;6372;6313;59;-4;-63;59
0;0;0;Partenon;48146;48078;68;-14;-82;68
0;0;0;Passo DAreia;21948;21876;72;-20;-92;72
0;0;0;Passo das Pedras;15906;15841;65;4;-61;65
0;0;0;Pedra Redonda;253;197;56;-21;-77;56
0;0;0;Petrópolis;37469;37398;71;-27;-98;71
0;0;0;Pitinga;4371;4336;35;19;-16;35
0;0;0;Ponta Grossa;8735;8695;40;13;-27;40
0;0;0;Praia de Belas;2271;2201;70;-10;-80;70
0;0;0;Restinga;53593;53488;105;85;-20;105
0;0;0;Rio Branco;17588;17402;186;57;-129;186
0;0;0;Rubem Berta;33182;33113;69;14;-55;69
0;0;0;Santa Cecília;5837;5649;188;69;-119;188
0;0;0;Santa Maria Goretti;3512;3440;72;3;-69;72
0;0;0;Santa Rosa de Lima;35364;35305;59;31;-28;59
0;0;0;Santa Tereza;39571;39507;64;-6;-70;64
0;0;0;Santana;20803;20610;193;80;-113;193
0;0;0;Santo Antônio;13150;13071;79;-11;-90;79
0;0;0;São Caetano;775;739;36;18;-18;36
0;0;0;São Geraldo;8691;8613;78;10;-68;78
0;0;0;São João;12244;12162;82;18;-64;82
0;0;0;São Sebastião;7027;6955;72;8;-64;72
0;0;0;Sarandi;59734;59663;71;23;-48;71
0;0;0;Serraria;6255;6201;54;16;-38;54
0;0;0;Sétimo Céu;1308;1251;57;-21;-78;57
0;0;0;Teresópolis;14815;14639;176;108;-68;176
0;0;0;Três Figueiras;4072;3992;80;2;-78;80
0;0;0;Tristeza;16669;16613;56;-23;-79;56
0;0;0;Vila Assunção;4532;4382;150;114;-36;150
0;0;0;Vila Conceição;1367;1305;62;18;-44;62
0;0;0;Vila Ipiranga;18664;18584;80;5;-75;80
0;0;0;Vila Jardim;13195;13115;80;6;-74;80
0;0;0;Vila João Pessoa;13055;12979;76;14;-62;76
0;0;0;Vila Nova;32582;32426;156;113;-43;156
0;0;0;Vila São José;26550;26476;74;28;-46;74
1;1;0;Aberta dos Morros;7109;7071;38;-4;-10;6
1;1;0;Agronomia;2324;2286;38;-12;-14;2
1;1;0;Anchieta;2021;1974;47;-3;-4;1
1;1;0;Arquipélago;8342;8286;56;6;-6;12
1;1;0;Auxiliadora;9601;9534;67;-14;-20;6
1;1;0;Azenha;13739;13607;132;7;-30;37
1;1;0;Bela Vista;11702;11630;72;-8;-18;10
1;1;0;Belém Novo;10085;10066;19;0;-4;4
1;1;0;Belém Velho;10827;10777;50;-4;-15;11
1;1;0;Boa Vista;9994;9919;75;-6;-18;12
1;1;0;Boa Vista do Sul;2281;2264;17;-3;-5;2
1;1;0;Bom Fim;11445;11404;41;-27;-26;-1
1;1;0;Bom Jesus;28661;28568;93;17;-18;35
1;1;0;Camaquã;17905;17832;73;4;-21;25
1;1;0;Campo Novo;8745;8696;49;-6;-13;7
1;1;0;Cascata;13003;12935;68;-2;-21;19
1;1;0;Cavalhada;29281;29196;85;11;-22;33
1;1;0;Centro;39285;39072;213;93;-5;98
1;1;0;Chácara das Pedras;6615;6545;70;-24;-29;5
1;1;0;Chapéu do Sol;2890;2857;33;-10;-13;3
1;1;0;Cidade Baixa;15299;15228;71;-6;-16;10
1;1;0;Coronel Aparício Borges;19258;19182;76;-13;-30;17
1;1;0;Costa e Silva;15822;15751;71;-14;-31;17
1;1;0;Cristal;31955;31866;89;26;-13;39
1;1;0;Cristo Redentor;16492;16309;183;26;-13;39
1;1;0;Espírito Santo;5568;5515;53;-17;-22;5
1;1;0;Extrema;1975;1965;10;-2;-3;1
1;1;0;Farrapos;19022;18943;79;19;-6;25
1;1;0;Farroupilha;902;776;126;-50;-33;-17
1;1;0;Floresta;11531;11460;71;-12;-20;8
1;1;0;Glória;17098;16947;151;-8;-32;24
1;1;0;Guarujá;4792;4737;55;-4;-9;5
1;1;0;Higienópolis;10694;10611;83;1;-17;18
1;1;0;Hípica;18634;18575;59;-2;-17;15
1;1;0;Humaitá;11527;11456;71;3;-9;12
1;1;0;Independência;8112;7951;161;-25;-27;2
1;1;0;Ipanema;13714;13650;64;2;-12;14
1;1;0;Jardim Botânico;12544;12379;165;-11;-29;18
1;1;0;Jardim Carvalho;25504;25311;193;35;-18;53
1;1;0;Jardim do Salso;4366;4298;68;-26;-29;3
1;1;0;Jardim Dona Leopoldina;17995;17911;84;-9;-36;27
1;1;0;Jardim Europa;2251;2182;69;-25;-25;0
1;1;0;Jardim Floresta;3278;3208;70;-14;-17;3
1;1;0;Jardim Isabel;2797;2740;57;-13;-16;3
1;1;0;Jardim Itu;17828;17739;89;-13;-36;23
1;1;0;Jardim Lindóia;7389;7311;78;-11;-20;9
1;1;0;Jardim Sabará;13514;13426;88;-8;-30;22
1;1;0;Jardim São Pedro;3928;3855;73;-18;-22;4
1;1;0;Lageado;4481;4445;36;-5;-7;2
1;1;0;Lami;4280;4258;22;-3;-4;1
1;1;0;Lomba do Pinheiro;58180;58081;99;46;-5;51
1;1;0;Mário Quintana;38151;38048;103;27;-19;46
1;1;0;Medianeira;11161;11090;71;-22;-29;7
1;1;0;Menino Deus;31761;31526;235;50;-21;71
1;1;0;Moinhos de Vento;11993;11797;196;1;-23;24
1;1;0;MontSerrat;11176;11093;83;-12;-25;13
1;1;0;Morro Santana;19355;19268;87;4;-20;24
1;1;0;Navegantes;4325;4253;72;-10;-15;5
1;1;0;Nonoai;25142;25056;86;2;-25;27
1;1;0;Parque Santa Fé;6343;6276;67;-29;-37;8
1;1;0;Partenon;48197;48056;141;51;-22;73
1;1;0;Passo DAreia;21968;21859;109;20;-17;37
1;1;0;Passo das Pedras;15899;15813;86;-7;-28;21
1;1;0;Pedra Redonda;238;183;55;-15;-14;-1
1;1;0;Petrópolis;37509;37383;126;40;-15;55
1;1;0;Pitinga;4364;4327;37;-7;-9;2
1;1;0;Ponta Grossa;8730;8687;43;-5;-8;3
1;1;0;Praia de Belas;2241;2174;67;-30;-27;-3
1;1;0;Restinga;53672;53483;189;79;-5;84
1;1;0;Rio Branco;17593;17372;221;5;-30;35
1;1;0;Rubem Berta;33196;33084;112;14;-29;43
1;1;0;Santa Cecília;5809;5621;188;-28;-28;0
1;1;0;Santa Maria Goretti;3498;3422;76;-14;-18;4
1;1;0;Santa Rosa de Lima;35385;35291;94;21;-14;35
1;1;0;Santa Tereza;39601;39489;112;30;-18;48
1;1;0;Santana;20816;20583;233;13;-27;40
1;1;0;Santo Antônio;13126;13032;94;-24;-39;15
1;1;0;São Caetano;769;733;36;-6;-6;0
1;1;0;São Geraldo;8681;8591;90;-10;-22;12
1;1;0;São João;12249;12146;103;5;-16;21
1;1;0;São Sebastião;7013;6930;83;-14;-25;11
1;1;0;Sarandi;59794;59647;147;60;-16;76
1;1;0;Serraria;6247;6188;59;-8;-13;5
1;1;0;Sétimo Céu;1292;1236;56;-16;-15;-1
1;1;0;Teresópolis;14807;14613;194;-8;-26;18
1;1;0;Três Figueiras;4060;3975;85;-12;-17;5
1;1;0;Tristeza;16674;16598;76;5;-15;20
1;1;0;Vila Assunção;4517;4367;150;-15;-15;0
1;1;0;Vila Conceição;1361;1299;62;-6;-6;0
1;1;0;Vila Ipiranga;18657;18551;106;-7;-33;26
1;1;0;Vila Jardim;13179;13085;94;-16;-30;14
1;1;0;Vila João Pessoa;13033;12946;87;-22;-33;11
1;1;0;Vila Nova;32628;32414;214;46;-12;58
1;1;0;Vila São José;26556;26450;106;6;-26;32
2;2;0;Aberta dos Morros;7106;7068;38;-3;-3;0
2;2;0;Agronomia;2340;2301;39;16;15;1
2;2;0;Anchieta;2027;1978;49;6;4;2
2;2;0;Arquipélago;8335;8284;51;-7;-2;-5
2;2;0;Auxiliadora;9606;9551;55;5;17;-12
2;2;0;Azenha;13776;13643;133;37;36;1
2;2;0;Bela Vista;11694;11638;56;-8;8;-16
2;2;0;Belém Novo;10088;10067;21;3;1;2
2;2;0;Belém Velho;10830;10780;50;3;3;0
2;2;0;Boa Vista;10003;9936;67;9;17;-8
2;2;0;Boa Vista do Sul;2282;2266;16;1;2;-1
2;2;0;Bom Fim;11449;11427;22;4;23;-19
2;2;0;Bom Jesus;28662;28586;76;1;18;-17
2;2;0;Camaquã;17917;17849;68;12;17;-5
2;2;0;Campo Novo;8749;8697;52;4;1;3
2;2;0;Cascata;13001;12939;62;-2;4;-6
2;2;0;Cavalhada;29282;29206;76;1;10;-9
2;2;0;Centro;39314;39084;230;29;12;17
2;2;0;Chácara das Pedras;6619;6562;57;4;17;-13
2;2;0;Chapéu do Sol;2895;2862;33;5;5;0
2;2;0;Cidade Baixa;15302;15244;58;3;16;-13
2;2;0;Coronel Aparício Borges;19267;19201;66;9;19;-10
2;2;0;Costa e Silva;15843;15773;70;21;22;-1
2;2;0;Cristal;31958;31873;85;3;7;-4
2;2;0;Cristo Redentor;16475;16321;154;-17;12;-29
2;2;0;Espírito Santo;5570;5519;51;2;4;-2
2;2;0;Extrema;1977;1966;11;2;1;1
2;2;0;Farrapos;19024;18944;80;2;1;1
2;2;0;Farroupilha;923;808;115;21;32;-11
2;2;0;Floresta;11532;11476;56;1;16;-15
2;2;0;Glória;17113;16951;162;15;4;11
2;2;0;Guarujá;4790;4737;53;-2;0;-2
2;2;0;Higienópolis;10690;10614;76;-4;3;-7
2;2;0;Hípica;18641;18584;57;7;9;-2
2;2;0;Humaitá;11527;11455;72;0;-1;1
2;2;0;Independência;8122;7971;151;10;20;-10
2;2;0;Ipanema;13721;13654;67;7;4;3
2;2;0;Jardim Botânico;12552;12402;150;8;23;-15
2;2;0;Jardim Carvalho;25487;25311;176;-17;0;-17
2;2;0;Jardim do Salso;4375;4312;63;9;14;-5
2;2;0;Jardim Dona Leopoldina;18009;17942;67;14;31;-17
2;2;0;Jardim Europa;2256;2192;64;5;10;-5
2;2;0;Jardim Floresta;3285;3215;70;7;7;0
2;2;0;Jardim Isabel;2799;2744;55;2;4;-2
2;2;0;Jardim Itu;17836;17758;78;8;19;-11
2;2;0;Jardim Lindóia;7387;7319;68;-2;8;-10
2;2;0;Jardim Sabará;13516;13436;80;2;10;-8
2;2;0;Jardim São Pedro;3938;3870;68;10;15;-5
2;2;0;Lageado;4484;4448;36;3;3;0
2;2;0;Lami;4286;4262;24;6;4;2
2;2;0;Lomba do Pinheiro;58158;58081;77;-22;0;-22
2;2;0;Mário Quintana;38147;38061;86;-4;13;-17
2;2;0;Medianeira;11156;11100;56;-5;10;-15
2;2;0;Menino Deus;31748;31542;206;-13;16;-29
2;2;0;Moinhos de Vento;11989;11818;171;-4;21;-25
2;2;0;MontSerrat;11180;11109;71;4;16;-12
2;2;0;Morro Santana;19356;19268;88;1;0;1
2;2;0;Navegantes;4323;4252;71;-2;-1;-1
2;2;0;Nonoai;25148;25066;82;6;10;-4
2;2;0;Parque Santa Fé;6349;6290;59;6;14;-8
2;2;0;Partenon;48171;48064;107;-26;8;-34
2;2;0;Passo DAreia;21973;21868;105;5;9;-4
2;2;0;Passo das Pedras;15898;15821;77;-1;8;-9
2;2;0;Pedra Redonda;242;189;53;4;6;-2
2;2;0;Petrópolis;37487;37384;103;-22;1;-23
2;2;0;Pitinga;4369;4329;40;5;2;3
2;2;0;Ponta Grossa;8733;8686;47;3;-1;4
2;2;0;Praia de Belas;2245;2186;59;4;12;-8
2;2;0;Restinga;53632;53481;151;-40;-2;-38
2;2;0;Rio Branco;17571;17375;196;-22;3;-25
2;2;0;Rubem Berta;33182;33102;80;-14;18;-32
2;2;0;Santa Cecília;5801;5628;173;-8;7;-15
2;2;0;Santa Maria Goretti;3500;3422;78;2;0;2
2;2;0;Santa Rosa de Lima;35389;35295;94;4;4;0
2;2;0;Santa Tereza;39581;39487;94;-20;-2;-18
2;2;0;Santana;20804;20584;220;-12;1;-13
2;2;0;Santo Antônio;13109;13042;67;-17;10;-27
2;2;0;São Caetano;767;731;36;-2;-2;0
2;2;0;São Geraldo;8682;8600;82;1;9;-8
2;2;0;São João;12241;12145;96;-8;-1;-7
2;2;0;São Sebastião;7014;6939;75;1;9;-8
2;2;0;Sarandi;59761;59650;111;-33;3;-36
2;2;0;Serraria;6250;6191;59;3;3;0
2;2;0;Sétimo Céu;1299;1243;56;7;7;0
2;2;0;Teresópolis;14800;14614;186;-7;1;-8
2;2;0;Três Figueiras;4063;3975;88;3;0;3
2;2;0;Tristeza;16675;16601;74;1;3;-2
2;2;0;Vila Assunção;4508;4364;144;-9;-3;-6
2;2;0;Vila Conceição;1363;1300;63;2;1;1
2;2;0;Vila Ipiranga;18654;18559;95;-3;8;-11
2;2;0;Vila Jardim;13177;13088;89;-2;3;-5
2;2;0;Vila João Pessoa;13036;12961;75;3;15;-12
2;2;0;Vila Nova;32605;32413;192;-23;-1;-22
2;2;0;Vila São José;26555;26454;101;-1;4;-5
3;3;0;Aberta dos Morros;7107;7068;39;1;0;1
3;3;0;Agronomia;2338;2301;37;-2;0;-2
3;3;0;Anchieta;2030;1981;49;3;3;0
3;3;0;Arquipélago;8342;8289;53;7;5;2
3;3;0;Auxiliadora;9609;9567;42;3;16;-13
3;3;0;Azenha;13814;13688;126;38;45;-7
3;3;0;Bela Vista;11699;11664;35;5;26;-21
3;3;0;Belém Novo;10088;10068;20;0;1;-1
3;3;0;Belém Velho;10838;10787;51;8;7;1
3;3;0;Boa Vista;10009;9955;54;6;19;-13
3;3;0;Boa Vista do Sul;2281;2266;15;-1;0;-1
3;3;0;Bom Fim;11465;11448;17;16;21;-5
3;3;0;Bom Jesus;28672;28605;67;10;19;-9
3;3;0;Camaquã;17922;17870;52;5;21;-16
3;3;0;Campo Novo;8750;8701;49;1;4;-3
3;3;0;Cascata;13002;12950;52;1;11;-10
3;3;0;Cavalhada;29294;29228;66;12;22;-10
3;3;0;Centro;39285;39086;199;-29;2;-31
3;3;0;Chácara das Pedras;6633;6585;48;14;23;-9
3;3;0;Chapéu do Sol;2900;2867;33;5;5;0
3;3;0;Cidade Baixa;15286;15257;29;-16;13;-29
3;3;0;Coronel Aparício Borges;19260;19225;35;-7;24;-31
3;3;0;Costa e Silva;15842;15796;46;-1;23;-24
3;3;0;Cristal;31938;31881;57;-20;8;-28
3;3;0;Cristo Redentor;16498;16353;145;23;32;-9
3;3;0;Espírito Santo;5572;5524;48;2;5;-3
3;3;0;Extrema;1977;1965;12;0;-1;1
3;3;0;Farrapos;19021;18946;75;-3;2;-5
3;3;0;Farroupilha;944;836;108;21;28;-7
3;3;0;Floresta;11536;11494;42;4;18;-14
3;3;0;Glória;17127;16978;149;14;27;-13
3;3;0;Guarujá;4792;4740;52;2;3;-1
3;3;0;Higienópolis;10689;10623;66;-1;9;-10
3;3;0;Hípica;18637;18589;48;-4;5;-9
3;3;0;Humaitá;11527;11457;70;0;2;-2
3;3;0;Independência;8135;7995;140;13;24;-11
3;3;0;Ipanema;13722;13658;64;1;4;-3
3;3;0;Jardim Botânico;12558;12427;131;6;25;-19
3;3;0;Jardim Carvalho;25523;25334;189;36;23;13
3;3;0;Jardim do Salso;4372;4323;49;-3;11;-14
3;3;0;Jardim Dona Leopoldina;18012;17968;44;3;26;-23
3;3;0;Jardim Europa;2263;2211;52;7;19;-12
3;3;0;Jardim Floresta;3296;3233;63;11;18;-7
3;3;0;Jardim Isabel;2803;2749;54;4;5;-1
3;3;0;Jardim Itu;17822;17773;49;-14;15;-29
3;3;0;Jardim Lindóia;7398;7337;61;11;18;-7
3;3;0;Jardim Sabará;13513;13458;55;-3;22;-25
3;3;0;Jardim São Pedro;3945;3883;62;7;13;-6
3;3;0;Lageado;4484;4448;36;0;0;0
3;3;0;Lami;4282;4259;23;-4;-3;-1
3;3;0;Lomba do Pinheiro;58164;58082;82;6;1;5
3;3;0;Mário Quintana;38142;38077;65;-5;16;-21
3;3;0;Medianeira;11150;11115;35;-6;15;-21
3;3;0;Menino Deus;31756;31557;199;8;15;-7
3;3;0;Moinhos de Vento;11987;11824;163;-2;6;-8
3;3;0;MontSerrat;11173;11120;53;-7;11;-18
3;3;0;Morro Santana;19352;19282;70;-4;14;-18
3;3;0;Navegantes;4327;4256;71;4;4;0
3;3;0;Nonoai;25127;25080;47;-21;14;-35
3;3;0;Parque Santa Fé;6374;6326;48;25;36;-11
3;3;0;Partenon;48165;48080;85;-6;16;-22
3;3;0;Passo DAreia;21964;21884;80;-9;16;-25
3;3;0;Passo das Pedras;15891;15837;54;-7;16;-23
3;3;0;Pedra Redonda;242;192;50;0;3;-3
3;3;0;Petrópolis;37474;37391;83;-13;7;-20
3;3;0;Pitinga;4374;4332;42;5;3;2
3;3;0;Ponta Grossa;8732;8685;47;-1;-1;0
3;3;0;Praia de Belas;2251;2204;47;6;18;-12
3;3;0;Restinga;53630;53481;149;-2;0;-2
3;3;0;Rio Branco;17584;17396;188;13;21;-8
3;3;0;Rubem Berta;33158;33111;47;-24;9;-33
3;3;0;Santa Cecília;5802;5651;151;1;23;-22
3;3;0;Santa Maria Goretti;3501;3431;70;1;9;-8
3;3;0;Santa Rosa de Lima;35369;35300;69;-20;5;-25
3;3;0;Santa Tereza;39571;39502;69;-10;15;-25
3;3;0;Santana;20792;20595;197;-12;11;-23
3;3;0;Santo Antônio;13098;13059;39;-11;17;-28
3;3;0;São Caetano;770;734;36;3;3;0
3;3;0;São Geraldo;8677;8605;72;-5;5;-10
3;3;0;São João;12240;12154;86;-1;9;-10
3;3;0;São Sebastião;7011;6950;61;-3;11;-14
3;3;0;Sarandi;59751;59659;92;-10;9;-19
3;3;0;Serraria;6249;6190;59;-1;-1;0
3;3;0;Sétimo Céu;1302;1247;55;3;4;-1
3;3;0;Teresópolis;14791;14621;170;-9;7;-16
3;3;0;Três Figueiras;4061;3984;77;-2;9;-11
3;3;0;Tristeza;16669;16612;57;-6;11;-17
3;3;0;Vila Assunção;4509;4369;140;1;5;-4
3;3;0;Vila Conceição;1362;1298;64;-1;-2;1
3;3;0;Vila Ipiranga;18634;18571;63;-20;12;-32
3;3;0;Vila Jardim;13172;13101;71;-5;13;-18
3;3;0;Vila João Pessoa;13021;12965;56;-15;4;-19
3;3;0;Vila Nova;32598;32419;179;-7;6;-13
3;3;0;Vila São José;26532;26464;68;-23;10;-33
4;4;0;Aberta dos Morros;6815;6448;367;-292;-620;328
4;4;0;Agronomia;1737;1672;65;-601;-629;28
4;4;0;Anchieta;1399;1364;35;-631;-617;-14
4;4;0;Arquipélago;8156;7671;485;-186;-618;432
4;4;0;Auxiliadora;9162;8630;532;-447;-937;490
4;4;0;Azenha;13462;12669;793;-352;-1019;667
4;4;0;Bela Vista;11317;10622;695;-382;-1042;660
4;4;0;Belém Novo;10043;9571;472;-45;-497;452
4;4;0;Belém Velho;10704;10067;637;-134;-720;586
4;4;0;Boa Vista;9552;8984;568;-457;-971;514
4;4;0;Boa Vista do Sul;1812;1773;39;-469;-493;24
4;4;0;Bom Fim;10999;10371;628;-466;-1077;611
4;4;0;Bom Jesus;29332;27557;1775;660;-1048;1708
4;4;0;Camaquã;17970;16977;993;48;-893;941
4;4;0;Campo Novo;8429;7984;445;-321;-717;396
4;4;0;Cascata;12865;12131;734;-137;-819;682
4;4;0;Cavalhada;30033;28321;1712;739;-907;1646
4;4;0;Centro;40523;38252;2271;1238;-834;2072
4;4;0;Chácara das Pedras;5853;5543;310;-780;-1042;262
4;4;0;Chapéu do Sol;2326;2270;56;-574;-597;23
4;4;0;Cidade Baixa;15126;14239;887;-160;-1018;858
4;4;0;Coronel Aparício Borges;19347;18204;1143;87;-1021;1108
4;4;0;Costa e Silva;15636;14796;840;-206;-1000;794
4;4;0;Cristal;32928;31068;1860;990;-813;1803
4;4;0;Cristo Redentor;16254;15295;959;-244;-1058;814
4;4;0;Espírito Santo;5045;4797;248;-527;-727;200
4;4;0;Extrema;1579;1545;34;-398;-420;22
4;4;0;Farrapos;19328;18273;1055;307;-673;980
4;4;0;Farroupilha;440;440;0;-504;-396;-108
4;4;0;Floresta;11219;10550;669;-317;-944;627
4;4;0;Glória;16983;15963;1020;-144;-1015;871
4;4;0;Guarujá;4272;4071;201;-520;-669;149
4;4;0;Higienópolis;10263;9632;631;-426;-991;565
4;4;0;Hípica;18923;17927;996;286;-662;948
4;4;0;Humaitá;11404;10764;640;-123;-693;570
4;4;0;Independência;7398;6946;452;-737;-1049;312
4;4;0;Ipanema;13694;12947;747;-28;-711;683
4;4;0;Jardim Botânico;12048;11293;755;-510;-1134;624
4;4;0;Jardim Carvalho;25982;24401;1581;459;-933;1392
4;4;0;Jardim do Salso;3470;3289;181;-902;-1034;132
4;4;0;Jardim Dona Leopoldina;17933;16902;1031;-79;-1066;987
4;4;0;Jardim Europa;1309;1287;22;-954;-924;-30
4;4;0;Jardim Floresta;2484;2390;94;-812;-843;31
4;4;0;Jardim Isabel;2066;2031;35;-737;-718;-19
4;4;0;Jardim Itu;17884;16801;1083;62;-972;1034
4;4;0;Jardim Lindóia;6807;6412;395;-591;-925;334
4;4;0;Jardim Sabará;13298;12492;806;-215;-966;751
4;4;0;Jardim São Pedro;3160;2980;180;-785;-903;118
4;4;0;Lageado;4052;3854;198;-432;-594;162
4;4;0;Lami;3995;3787;208;-287;-472;185
4;4;0;Lomba do Pinheiro;60704;57412;3292;2540;-670;3210
4;4;0;Mário Quintana;39398;37257;2141;1256;-820;2076
4;4;0;Medianeira;10759;10115;644;-391;-1000;609
4;4;0;Menino Deus;32660;30633;2027;904;-924;1828
4;4;0;Moinhos de Vento;11564;10825;739;-423;-999;576
4;4;0;MontSerrat;10765;10096;669;-408;-1024;616
4;4;0;Morro Santana;19619;18471;1148;267;-811;1078
4;4;0;Navegantes;3674;3475;199;-653;-781;128
4;4;0;Nonoai;25662;24180;1482;535;-900;1435
4;4;0;Parque Santa Fé;5681;5366;315;-693;-960;267
4;4;0;Partenon;49923;47084;2839;1758;-996;2754
4;4;0;Passo DAreia;22306;20961;1345;342;-923;1265
4;4;0;Passo das Pedras;15827;14917;910;-64;-920;856
4;4;0;Pedra Redonda;155;128;27;-87;-64;-23
4;4;0;Petrópolis;38756;36388;2368;1282;-1003;2285
4;4;0;Pitinga;3962;3756;206;-412;-576;164
4;4;0;Ponta Grossa;8605;8168;437;-127;-517;390
4;4;0;Praia de Belas;1520;1397;123;-731;-807;76
4;4;0;Restinga;55919;52988;2931;2289;-493;2782
4;4;0;Rio Branco;17519;16383;1136;-65;-1013;948
4;4;0;Rubem Berta;34192;32279;1913;1034;-832;1866
4;4;0;Santa Cecília;4901;4590;311;-901;-1061;160
4;4;0;Santa Maria Goretti;2826;2594;232;-675;-837;162
4;4;0;Santa Rosa de Lima;36645;34604;2041;1276;-696;1972
4;4;0;Santa Tereza;40973;38638;2335;1402;-864;2266
4;4;0;Santana;21016;19631;1385;224;-964;1188
4;4;0;Santo Antônio;13015;12125;890;-83;-934;851
4;4;0;São Caetano;605;413;192;-165;-321;156
4;4;0;São Geraldo;8412;7818;594;-265;-787;522
4;4;0;São João;12256;11378;878;16;-776;792
4;4;0;São Sebastião;6496;6072;424;-515;-878;363
4;4;0;Sarandi;62637;58990;3647;2886;-669;3555
4;4;0;Serraria;6100;5715;385;-149;-475;326
4;4;0;Sétimo Céu;759;661;98;-543;-586;43
4;4;0;Teresópolis;14803;13737;1066;12;-884;896
4;4;0;Três Figueiras;3429;3045;384;-632;-939;307
4;4;0;Tristeza;16923;15908;1015;254;-704;958
4;4;0;Vila Assunção;4069;3706;363;-440;-663;223
4;4;0;Vila Conceição;940;766;174;-422;-532;110
4;4;0;Vila Ipiranga;19006;17700;1306;372;-871;1243
4;4;0;Vila Jardim;13216;12220;996;44;-881;925
4;4;0;Vila João Pessoa;12907;12015;892;-114;-950;836
4;4;0;Vila Nova;33917;31880;2037;1319;-539;1858
4;4;0;Vila São José;27514;25775;1739;982;-689;1671
5;5;0;Aberta dos Morros;6810;6441;369;-5;-7;2
5;5;0;Agronomia;1732;1671;61;-5;-1;-4
5;5;0;Anchieta;1390;1360;30;-9;-4;-5
5;5;0;Arquipélago;8167;7668;499;11;-3;14
5;5;0;Auxiliadora;9160;8625;535;-2;-5;3
5;5;0;Azenha;13445;12635;810;-17;-34;17
5;5;0;Bela Vista;11308;10616;692;-9;-6;-3
5;5;0;Belém Novo;10052;9571;481;9;0;9
5;5;0;Belém Velho;10698;10054;644;-6;-13;7
5;5;0;Boa Vista;9555;8980;575;3;-4;7
5;5;0;Boa Vista do Sul;1811;1774;37;-1;1;-2
5;5;0;Bom Fim;10984;10369;615;-15;-2;-13
5;5;0;Bom Jesus;29366;27534;1832;34;-23;57
5;5;0;Camaquã;17974;16957;1017;4;-20;24
5;5;0;Campo Novo;8424;7969;455;-5;-15;10
5;5;0;Cascata;12876;12117;759;11;-14;25
5;5;0;Cavalhada;30074;28304;1770;41;-17;58
5;5;0;Centro;40576;38243;2333;53;-9;62
5;5;0;Chácara das Pedras;5833;5532;301;-20;-11;-9
5;5;0;Chapéu do Sol;2314;2265;49;-12;-5;-7
5;5;0;Cidade Baixa;15130;14216;914;4;-23;27
5;5;0;Coronel Aparício Borges;19360;18181;1179;13;-23;36
5;5;0;Costa e Silva;15627;14766;861;-9;-30;21
5;5;0;Cristal;32974;31054;1920;46;-14;60
5;5;0;Cristo Redentor;16244;15275;969;-10;-20;10
5;5;0;Espírito Santo;5039;4795;244;-6;-2;-4
5;5;0;Extrema;1580;1547;33;1;2;-1
5;5;0;Farrapos;19350;18266;1084;22;-7;29
5;5;0;Farroupilha;437;437;0;-3;-3;0
5;5;0;Floresta;11219;10530;689;0;-20;20
5;5;0;Glória;16988;15930;1058;5;-33;38
5;5;0;Guarujá;4272;4070;202;0;-1;1
5;5;0;Higienópolis;10269;9626;643;6;-6;12
5;5;0;Hípica;18936;17916;1020;13;-11;24
5;5;0;Humaitá;11417;10759;658;13;-5;18
5;5;0;Independência;7391;6947;444;-7;1;-8
5;5;0;Ipanema;13704;12942;762;10;-5;15
5;5;0;Jardim Botânico;12046;11280;766;-2;-13;11
5;5;0;Jardim Carvalho;26019;24384;1635;37;-17;54
5;5;0;Jardim do Salso;3457;3283;174;-13;-6;-7
5;5;0;Jardim Dona Leopoldina;17923;16865;1058;-10;-37;27
5;5;0;Jardim Europa;1287;1281;6;-22;-6;-16
5;5;0;Jardim Floresta;2474;2386;88;-10;-4;-6
5;5;0;Jardim Isabel;2058;2030;28;-8;-1;-7
5;5;0;Jardim Itu;17895;16778;1117;11;-23;34
5;5;0;Jardim Lindóia;6810;6412;398;3;0;3
5;5;0;Jardim Sabará;13297;12471;826;-1;-21;20
5;5;0;Jardim São Pedro;3157;2977;180;-3;-3;0
5;5;0;Lageado;4050;3855;195;-2;1;-3
5;5;0;Lami;3998;3790;208;3;3;0
5;5;0;Lomba do Pinheiro;60774;57406;3368;70;-6;76
5;5;0;Mário Quintana;39443;37243;2200;45;-14;59
5;5;0;Medianeira;10746;10085;661;-13;-30;17
5;5;0;Menino Deus;32686;30607;2079;26;-26;52
5;5;0;Moinhos de Vento;11544;10796;748;-20;-29;9
5;5;0;MontSerrat;10774;10082;692;9;-14;23
5;5;0;Morro Santana;19639;18455;1184;20;-16;36
5;5;0;Navegantes;3670;3474;196;-4;-1;-3
5;5;0;Nonoai;25690;24168;1522;28;-12;40
5;5;0;Parque Santa Fé;5665;5346;319;-16;-20;4
5;5;0;Partenon;49986;47059;2927;63;-25;88
5;5;0;Passo DAreia;22326;20943;1383;20;-18;38
5;5;0;Passo das Pedras;15827;14893;934;0;-24;24
5;5;0;Pedra Redonda;143;124;19;-12;-4;-8
5;5;0;Petrópolis;38816;36378;2438;60;-10;70
5;5;0;Pitinga;3948;3746;202;-14;-10;-4
5;5;0;Ponta Grossa;8588;8151;437;-17;-17;0
5;5;0;Praia de Belas;1482;1394;88;-38;-3;-35
5;5;0;Restinga;55948;52977;2971;29;-11;40
5;5;0;Rio Branco;17506;16343;1163;-13;-40;27
5;5;0;Rubem Berta;34200;32253;1947;8;-26;34
5;5;0;Santa Cecília;4883;4583;300;-18;-7;-11
5;5;0;Santa Maria Goretti;2813;2590;223;-13;-4;-9
5;5;0;Santa Rosa de Lima;36655;34589;2066;10;-15;25
5;5;0;Santa Tereza;40992;38624;2368;19;-14;33
5;5;0;Santana;20990;19590;1400;-26;-41;15
5;5;0;Santo Antônio;12976;12091;885;-39;-34;-5
5;5;0;São Caetano;599;411;188;-6;-2;-4
5;5;0;São Geraldo;8398;7794;604;-14;-24;10
5;5;0;São João;12241;11358;883;-15;-20;5
5;5;0;São Sebastião;6482;6061;421;-14;-11;-3
5;5;0;Sarandi;62632;58968;3664;-5;-22;17
5;5;0;Serraria;6096;5707;389;-4;-8;4
5;5;0;Sétimo Céu;748;657;91;-11;-4;-7
5;5;0;Teresópolis;14769;13708;1061;-34;-29;-5
5;5;0;Três Figueiras;3396;3022;374;-33;-23;-10
5;5;0;Tristeza;16924;15898;1026;1;-10;11
5;5;0;Vila Assunção;4039;3697;342;-30;-9;-21
5;5;0;Vila Conceição;928;755;173;-12;-11;-1
5;5;0;Vila Ipiranga;18979;17658;1321;-27;-42;15
5;5;0;Vila Jardim;13170;12168;1002;-46;-52;6
5;5;0;Vila João Pessoa;12882;11987;895;-25;-28;3
5;5;0;Vila Nova;33910;31857;2053;-7;-23;16
5;5;0;Vila São José;27491;25738;1753;-23;-37;14
6;6;0;Aberta dos Morros;6640;5878;762;-170;-563;393
6;6;0;Agronomia;1343;1169;174;-389;-502;113
6;6;0;Anchieta;1126;1009;117;-264;-351;87
6;6;0;Arquipélago;8075;7101;974;-92;-567;475
6;6;0;Auxiliadora;8810;7691;1119;-350;-934;584
6;6;0;Azenha;13232;11604;1628;-213;-1031;818
6;6;0;Bela Vista;10992;9599;1393;-316;-1017;701
6;6;0;Belém Novo;10140;9170;970;88;-401;489
6;6;0;Belém Velho;10606;9394;1212;-92;-660;568
6;6;0;Boa Vista;9182;8023;1159;-373;-957;584
6;6;0;Boa Vista do Sul;1490;1398;92;-321;-376;55
6;6;0;Bom Fim;10630;9345;1285;-354;-1024;670
6;6;0;Bom Jesus;30058;26589;3469;692;-945;1637
6;6;0;Camaquã;18092;16139;1953;118;-818;936
6;6;0;Campo Novo;8203;7319;884;-221;-650;429
6;6;0;Cascata;12823;11353;1470;-53;-764;711
6;6;0;Cavalhada;30727;27434;3293;653;-870;1523
6;6;0;Centro;41737;37405;4332;1161;-838;1999
6;6;0;Chácara das Pedras;5180;4534;646;-653;-998;345
6;6;0;Chapéu do Sol;1882;1751;131;-432;-514;82
6;6;0;Cidade Baixa;15051;13264;1787;-79;-952;873
6;6;0;Coronel Aparício Borges;19455;17204;2251;95;-977;1072
6;6;0;Costa e Silva;15549;13826;1723;-78;-940;862
6;6;0;Cristal;33867;30262;3605;893;-792;1685
6;6;0;Cristo Redentor;16216;14297;1919;-28;-978;950
6;6;0;Espírito Santo;4661;4166;495;-378;-629;251
6;6;0;Extrema;1223;1175;48;-357;-372;15
6;6;0;Farrapos;19760;17649;2111;410;-617;1027
6;6;0;Farroupilha;439;439;0;2;2;0
6;6;0;Floresta;10942;9654;1288;-277;-876;599
6;6;0;Glória;16984;14998;1986;-4;-932;928
6;6;0;Guarujá;3877;3506;371;-395;-564;169
6;6;0;Higienópolis;9909;8700;1209;-360;-926;566
6;6;0;Hípica;19288;17328;1960;352;-588;940
6;6;0;Humaitá;11333;10103;1230;-84;-656;572
6;6;0;Independência;6791;5956;835;-600;-991;391
6;6;0;Ipanema;13707;12257;1450;3;-685;688
6;6;0;Jardim Botânico;11646;10229;1417;-400;-1051;651
6;6;0;Jardim Carvalho;26485;23456;3029;466;-928;1394
6;6;0;Jardim do Salso;2626;2262;364;-831;-1021;190
6;6;0;Jardim Dona Leopoldina;17852;15823;2029;-71;-1042;971
6;6;0;Jardim Europa;1208;1121;87;-79;-160;81
6;6;0;Jardim Floresta;1868;1650;218;-606;-736;130
6;6;0;Jardim Isabel;1530;1431;99;-528;-599;71
6;6;0;Jardim Itu;17907;15795;2112;12;-983;995
6;6;0;Jardim Lindóia;6294;5536;758;-516;-876;360
6;6;0;Jardim Sabará;13052;11491;1561;-245;-980;735
6;6;0;Jardim São Pedro;2434;2096;338;-723;-881;158
6;6;0;Lageado;3693;3372;321;-357;-483;126
6;6;0;Lami;3692;3394;298;-306;-396;90
6;6;0;Lomba do Pinheiro;62945;56724;6221;2171;-682;2853
6;6;0;Mário Quintana;40688;36394;4294;1245;-849;2094
6;6;0;Medianeira;10374;9114;1260;-372;-971;599
6;6;0;Menino Deus;33455;29632;3823;769;-975;1744
6;6;0;Moinhos de Vento;11246;9871;1375;-298;-925;627
6;6;0;MontSerrat;10378;9087;1291;-396;-995;599
6;6;0;Morro Santana;19876;17619;2257;237;-836;1073
6;6;0;Navegantes;3098;2727;371;-572;-747;175
6;6;0;Nonoai;26152;23258;2894;462;-910;1372
6;6;0;Parque Santa Fé;4992;4394;598;-673;-952;279
6;6;0;Partenon;51586;46002;5584;1600;-1057;2657
6;6;0;Passo DAreia;22675;20000;2675;349;-943;1292
6;6;0;Passo das Pedras;15729;13917;1812;-98;-976;878
6;6;0;Pedra Redonda;124;124;0;-19;0;-19
6;6;0;Petrópolis;39978;35348;4630;1162;-1030;2192
6;6;0;Pitinga;3551;3211;340;-397;-535;138
6;6;0;Ponta Grossa;8404;7605;799;-184;-546;362
6;6;0;Praia de Belas;1248;1121;127;-234;-273;39
6;6;0;Restinga;57514;52213;5301;1566;-764;2330
6;6;0;Rio Branco;17447;15316;2131;-59;-1027;968
6;6;0;Rubem Berta;35006;31349;3657;806;-904;1710
6;6;0;Santa Cecília;4110;3582;528;-773;-1001;228
6;6;0;Santa Maria Goretti;2089;1800;289;-724;-790;66
6;6;0;Santa Rosa de Lima;37666;33825;3841;1011;-764;1775
6;6;0;Santa Tereza;42246;37714;4532;1254;-910;2164
6;6;0;Santana;21054;18521;2533;64;-1069;1133
6;6;0;Santo Antônio;12640;11068;1572;-336;-1023;687
6;6;0;São Caetano;529;374;155;-70;-37;-33
6;6;0;São Geraldo;7993;6986;1007;-405;-808;403
6;6;0;São João;12000;10513;1487;-241;-845;604
6;6;0;São Sebastião;5899;5174;725;-583;-887;304
6;6;0;Sarandi;64701;58112;6589;2069;-856;2925
6;6;0;Serraria;5682;5089;593;-414;-618;204
6;6;0;Sétimo Céu;717;654;63;-31;-3;-28
6;6;0;Teresópolis;14461;12709;1752;-308;-999;691
6;6;0;Três Figueiras;2550;2104;446;-846;-918;72
6;6;0;Tristeza;17006;15176;1830;82;-722;804
6;6;0;Vila Assunção;3351;2956;395;-688;-741;53
6;6;0;Vila Conceição;828;668;160;-100;-87;-13
6;6;0;Vila Ipiranga;18977;16667;2310;-2;-991;989
6;6;0;Vila Jardim;12816;11174;1642;-354;-994;640
6;6;0;Vila João Pessoa;12527;10953;1574;-355;-1034;679
6;6;0;Vila Nova;34764;31087;3677;854;-770;1624
6;6;0;Vila São José;27972;24847;3125;481;-891;1372
7;7;0;Aberta dos Morros;6254;4843;1411;-386;-1035;649
7;7;0;Agronomia;1254;917;337;-89;-252;163
7;7;0;Anchieta;1033;774;259;-93;-235;142
7;7;0;Arquipélago;7623;5923;1700;-452;-1178;726
7;7;0;Auxiliadora;8212;6144;2068;-598;-1547;949
7;7;0;Azenha;12534;9371;3163;-698;-2233;1535
7;7;0;Bela Vista;10262;7693;2569;-730;-1906;1176
7;7;0;Belém Novo;10072;8424;1648;-68;-746;678
7;7;0;Belém Velho;10057;7898;2159;-549;-1496;947
7;7;0;Boa Vista;8598;6408;2190;-584;-1615;1031
7;7;0;Boa Vista do Sul;1420;1224;196;-70;-174;104
7;7;0;Bom Fim;9919;7464;2455;-711;-1881;1170
7;7;0;Bom Jesus;30694;24193;6501;636;-2396;3032
7;7;0;Camaquã;17941;14223;3718;-151;-1916;1765
7;7;0;Campo Novo;7723;6097;1626;-480;-1222;742
7;7;0;Cascata;12217;9538;2679;-606;-1815;1209
7;7;0;Cavalhada;31727;25536;6191;1000;-1898;2898
7;7;0;Centro;43984;35618;8366;2247;-1787;4034
7;7;0;Chácara das Pedras;4821;3560;1261;-359;-974;615
7;7;0;Chapéu do Sol;1821;1498;323;-61;-253;192
7;7;0;Cidade Baixa;14339;11114;3225;-712;-2150;1438
7;7;0;Coronel Aparício Borges;19043;14829;4214;-412;-2375;1963
7;7;0;Costa e Silva;14855;11586;3269;-694;-2240;1546
7;7;0;Cristal;35134;28549;6585;1267;-1713;2980
7;7;0;Cristo Redentor;15743;11969;3774;-473;-2328;1855
7;7;0;Espírito Santo;4407;3456;951;-254;-710;456
7;7;0;Extrema;1197;1051;146;-26;-124;98
7;7;0;Farrapos;20043;16240;3803;283;-1409;1692
7;7;0;Farroupilha;319;223;96;-120;-216;96
7;7;0;Floresta;10287;7909;2378;-655;-1745;1090
7;7;0;Glória;16475;12791;3684;-509;-2207;1698
7;7;0;Guarujá;3667;2927;740;-210;-579;369
7;7;0;Higienópolis;9344;7070;2274;-565;-1630;1065
7;7;0;Hípica;19547;16105;3442;259;-1223;1482
7;7;0;Humaitá;10867;8641;2226;-466;-1462;996
7;7;0;Independência;6543;4709;1834;-248;-1247;999
7;7;0;Ipanema;13496;10876;2620;-211;-1381;1170
7;7;0;Jardim Botânico;11087;8269;2818;-559;-1960;1401
7;7;0;Jardim Carvalho;26870;21376;5494;385;-2080;2465
7;7;0;Jardim do Salso;2428;1532;896;-198;-730;532
7;7;0;Jardim Dona Leopoldina;17101;13387;3714;-751;-2436;1685
7;7;0;Jardim Europa;1203;650;553;-5;-471;466
7;7;0;Jardim Floresta;1692;1105;587;-176;-545;369
7;7;0;Jardim Isabel;1461;1012;449;-69;-419;350
7;7;0;Jardim Itu;17229;13453;3776;-678;-2342;1664
7;7;0;Jardim Lindóia;6069;4438;1631;-225;-1098;873
7;7;0;Jardim Sabará;12255;9434;2821;-797;-2057;1260
7;7;0;Jardim São Pedro;2220;1418;802;-214;-678;464
7;7;0;Lageado;3482;2908;574;-211;-464;253
7;7;0;Lami;3515;3022;493;-177;-372;195
7;7;0;Lomba do Pinheiro;66401;55440;10961;3456;-1284;4740
7;7;0;Mário Quintana;42477;34543;7934;1789;-1851;3640
7;7;0;Medianeira;9757;7409;2348;-617;-1705;1088
7;7;0;Menino Deus;34352;27478;6874;897;-2154;3051
7;7;0;Moinhos de Vento;10796;8008;2788;-450;-1863;1413
7;7;0;MontSerrat;9797;7412;2385;-581;-1675;1094
7;7;0;Morro Santana;19674;15701;3973;-202;-1918;1716
7;7;0;Navegantes;3117;1990;1127;19;-737;756
7;7;0;Nonoai;26516;21234;5282;364;-2024;2388
7;7;0;Parque Santa Fé;4652;3284;1368;-340;-1110;770
7;7;0;Partenon;54121;43618;10503;2535;-2384;4919
7;7;0;Passo DAreia;22718;17760;4958;43;-2240;2283
7;7;0;Passo das Pedras;15020;11690;3330;-709;-2227;1518
7;7;0;Pedra Redonda;84;55;29;-40;-69;29
7;7;0;Petrópolis;41314;32992;8322;1336;-2356;3692
7;7;0;Pitinga;3358;2604;754;-193;-607;414
7;7;0;Ponta Grossa;8025;6680;1345;-379;-925;546
7;7;0;Praia de Belas;1342;713;629;94;-408;502
7;7;0;Restinga;60002;51096;8906;2488;-1117;3605
7;7;0;Rio Branco;16778;12917;3861;-669;-2399;1730
7;7;0;Rubem Berta;36070;29339;6731;1064;-2010;3074
7;7;0;Santa Cecília;3837;2562;1275;-273;-1020;747
7;7;0;Santa Maria Goretti;1968;1232;736;-121;-568;447
7;7;0;Santa Rosa de Lima;38833;32220;6613;1167;-1605;2772
7;7;0;Santa Tereza;44010;35772;8238;1764;-1942;3706
7;7;0;Santana;20734;16128;4606;-320;-2393;2073
7;7;0;Santo Antônio;11906;9130;2776;-734;-1938;1204
7;7;0;São Caetano;501;259;242;-28;-115;87
7;7;0;São Geraldo;7490;5422;2068;-503;-1564;1061
7;7;0;São João;11524;8823;2701;-476;-1690;1214
7;7;0;São Sebastião;5742;3906;1836;-157;-1268;1111
7;7;0;Sarandi;67582;56289;11293;2881;-1823;4704
7;7;0;Serraria;5415;4189;1226;-267;-900;633
7;7;0;Sétimo Céu;586;395;191;-131;-259;128
7;7;0;Teresópolis;13643;10650;2993;-818;-2059;1241
7;7;0;Três Figueiras;2591;1434;1157;41;-670;711
7;7;0;Tristeza;16676;13642;3034;-330;-1534;1204
7;7;0;Vila Assunção;3200;2233;967;-151;-723;572
7;7;0;Vila Conceição;739;430;309;-89;-238;149
7;7;0;Vila Ipiranga;18270;14350;3920;-707;-2317;1610
7;7;0;Vila Jardim;12086;8989;3097;-730;-2185;1455
7;7;0;Vila João Pessoa;11797;8812;2985;-730;-2141;1411
7;7;0;Vila Nova;35630;29495;6135;866;-1592;2458
7;7;0;Vila São José;28136;22705;5431;164;-2142;2306
8;8;0;Aberta dos Morros;6266;5017;1249;12;174;-162
8;8;0;Agronomia;1304;1105;199;50;188;-138
8;8;0;Anchieta;1075;904;171;42;130;-88
8;8;0;Arquipélago;7752;6129;1623;129;206;-77
8;8;0;Auxiliadora;8217;6387;1830;5;243;-238
8;8;0;Azenha;12362;9730;2632;-172;359;-531
8;8;0;Bela Vista;10272;7963;2309;10;270;-260
8;8;0;Belém Novo;10117;8447;1670;45;23;22
8;8;0;Belém Velho;10151;8039;2112;94;141;-47
8;8;0;Boa Vista;8623;6685;1938;25;277;-252
8;8;0;Boa Vista do Sul;1428;1293;135;8;69;-61
8;8;0;Bom Fim;9951;7786;2165;32;322;-290
8;8;0;Bom Jesus;30915;24365;6550;221;172;49
8;8;0;Camaquã;18044;14380;3664;103;157;-54
8;8;0;Campo Novo;7736;6201;1535;13;104;-91
8;8;0;Cascata;12256;9658;2598;39;120;-81
8;8;0;Cavalhada;31680;25666;6014;-47;130;-177
8;8;0;Centro;44193;35868;8325;209;250;-41
8;8;0;Chácara das Pedras;4834;3837;997;13;277;-264
8;8;0;Chapéu do Sol;1818;1602;216;-3;104;-107
8;8;0;Cidade Baixa;14539;11424;3115;200;310;-110
8;8;0;Coronel Aparício Borges;19151;14986;4165;108;157;-49
8;8;0;Costa e Silva;14968;11773;3195;113;187;-74
8;8;0;Cristal;35258;28672;6586;124;123;1
8;8;0;Cristo Redentor;15635;12249;3386;-108;280;-388
8;8;0;Espírito Santo;4291;3577;714;-116;121;-237
8;8;0;Extrema;1319;1163;156;122;112;10
8;8;0;Farrapos;20262;16440;3822;219;200;19
8;8;0;Farroupilha;200;170;30;-119;-53;-66
8;8;0;Floresta;10359;8135;2224;72;226;-154
8;8;0;Glória;16478;13003;3475;3;212;-209
8;8;0;Guarujá;3556;3008;548;-111;81;-192
8;8;0;Higienópolis;9376;7298;2078;32;228;-196
8;8;0;Hípica;19550;16169;3381;3;64;-61
8;8;0;Humaitá;11018;8822;2196;151;181;-30
8;8;0;Independência;6286;4961;1325;-257;252;-509
8;8;0;Ipanema;13487;10918;2569;-9;42;-51
8;8;0;Jardim Botânico;10819;8462;2357;-268;193;-461
8;8;0;Jardim Carvalho;26999;21571;5428;129;195;-66
8;8;0;Jardim do Salso;2441;1814;627;13;282;-269
8;8;0;Jardim Dona Leopoldina;17131;13548;3583;30;161;-131
8;8;0;Jardim Europa;846;612;234;-357;-38;-319
8;8;0;Jardim Floresta;1686;1259;427;-6;154;-160
8;8;0;Jardim Isabel;1503;1166;337;42;154;-112
8;8;0;Jardim Itu;17264;13632;3632;35;179;-144
8;8;0;Jardim Lindóia;5764;4596;1168;-305;158;-463
8;8;0;Jardim Sabará;12284;9592;2692;29;158;-129
8;8;0;Jardim São Pedro;2253;1680;573;33;262;-229
8;8;0;Lageado;3393;2943;450;-89;35;-124
8;8;0;Lami;3409;3045;364;-106;23;-129
8;8;0;Lomba do Pinheiro;66170;55425;10745;-231;-15;-216
8;8;0;Mário Quintana;42561;34621;7940;84;78;6
8;8;0;Medianeira;9725;7599;2126;-32;190;-222
8;8;0;Menino Deus;34466;27686;6780;114;208;-94
8;8;0;Moinhos de Vento;10516;8172;2344;-280;164;-444
8;8;0;MontSerrat;9768;7600;2168;-29;188;-217
8;8;0;Morro Santana;19738;15819;3919;64;118;-54
8;8;0;Navegantes;2875;2173;702;-242;183;-425
8;8;0;Nonoai;26528;21320;5208;12;86;-74
8;8;0;Parque Santa Fé;4573;3505;1068;-79;221;-300
8;8;0;Partenon;54190;43735;10455;69;117;-48
8;8;0;Passo DAreia;22762;17902;4860;44;142;-98
8;8;0;Passo das Pedras;15024;11813;3211;4;123;-119
8;8;0;Pedra Redonda;52;28;24;-32;-27;-5
8;8;0;Petrópolis;41322;33087;8235;8;95;-87
8;8;0;Pitinga;3309;2702;607;-49;98;-147
8;8;0;Ponta Grossa;7990;6703;1287;-35;23;-58
8;8;0;Praia de Belas;1063;740;323;-279;27;-306
8;8;0;Restinga;60199;51118;9081;197;22;175
8;8;0;Rio Branco;16716;13066;3650;-62;149;-211
8;8;0;Rubem Berta;36003;29415;6588;-67;76;-143
8;8;0;Santa Cecília;3780;2846;934;-57;284;-341
8;8;0;Santa Maria Goretti;2048;1471;577;80;239;-159
8;8;0;Santa Rosa de Lima;38936;32316;6620;103;96;7
8;8;0;Santa Tereza;44030;35897;8133;20;125;-105
8;8;0;Santana;20715;16304;4411;-19;176;-195
8;8;0;Santo Antônio;11878;9304;2574;-28;174;-202
8;8;0;São Caetano;604;273;331;103;14;89
8;8;0;São Geraldo;7509;5551;1958;19;129;-110
8;8;0;São João;11380;8892;2488;-144;69;-213
8;8;0;São Sebastião;5373;4027;1346;-369;121;-490
8;8;0;Sarandi;67717;56252;11465;135;-37;172
8;8;0;Serraria;5375;4219;1156;-40;30;-70
8;8;0;Sétimo Céu;576;362;214;-10;-33;23
8;8;0;Teresópolis;13650;10746;2904;7;96;-89
8;8;0;Três Figueiras;2545;1747;798;-46;313;-359
8;8;0;Tristeza;16646;13654;2992;-30;12;-42
8;8;0;Vila Assunção;3263;2392;871;63;159;-96
8;8;0;Vila Conceição;881;455;426;142;25;117
8;8;0;Vila Ipiranga;18272;14425;3847;2;75;-73
8;8;0;Vila Jardim;12223;9144;3079;137;155;-18
8;8;0;Vila João Pessoa;11793;8903;2890;-4;91;-95
8;8;0;Vila Nova;35710;29453;6257;80;-42;122
8;8;0;Vila São José;28378;22771;5607;242;66;176
9;9;0;Aberta dos Morros;6245;5010;1235;-21;-7;-14
9;9;0;Agronomia;1272;1091;181;-32;-14;-18
9;9;0;Anchieta;1088;909;179;13;5;8
9;9;0;Arquipélago;7748;6107;1641;-4;-22;18
9;9;0;Auxiliadora;8162;6349;1813;-55;-38;-17
9;9;0;Azenha;12315;9634;2681;-47;-96;49
9;9;0;Bela Vista;10192;7909;2283;-80;-54;-26
9;9;0;Belém Novo;10103;8449;1654;-14;2;-16
9;9;0;Belém Velho;10188;8053;2135;37;14;23
9;9;0;Boa Vista;8577;6650;1927;-46;-35;-11
9;9;0;Boa Vista do Sul;1441;1299;142;13;6;7
9;9;0;Bom Fim;9842;7705;2137;-109;-81;-28
9;9;0;Bom Jesus;31010;24282;6728;95;-83;178
9;9;0;Camaquã;18077;14351;3726;33;-29;62
9;9;0;Campo Novo;7719;6181;1538;-17;-20;3
9;9;0;Cascata;12306;9631;2675;50;-27;77
9;9;0;Cavalhada;31687;25609;6078;7;-57;64
9;9;0;Centro;44431;35822;8609;238;-46;284
9;9;0;Chácara das Pedras;4774;3803;971;-60;-34;-26
9;9;0;Chapéu do Sol;1791;1582;209;-27;-20;-7
9;9;0;Cidade Baixa;14505;11346;3159;-34;-78;44
9;9;0;Coronel Aparício Borges;19205;14920;4285;54;-66;120
9;9;0;Costa e Silva;14969;11684;3285;1;-89;90
9;9;0;Cristal;35299;28619;6680;41;-53;94
9;9;0;Cristo Redentor;15768;12263;3505;133;14;119
9;9;0;Espírito Santo;4290;3571;719;-1;-6;5
9;9;0;Extrema;1336;1173;163;17;10;7
9;9;0;Farrapos;20259;16411;3848;-3;-29;26
9;9;0;Farroupilha;195;195;0;-5;25;-30
9;9;0;Floresta;10373;8075;2298;14;-60;74
9;9;0;Glória;16592;12961;3631;114;-42;156
9;9;0;Guarujá;3586;3013;573;30;5;25
9;9;0;Higienópolis;9379;7257;2122;3;-41;44
9;9;0;Hípica;19589;16141;3448;39;-28;67
9;9;0;Humaitá;11064;8808;2256;46;-14;60
9;9;0;Independência;6229;4884;1345;-57;-77;20
9;9;0;Ipanema;13530;10908;2622;43;-10;53
9;9;0;Jardim Botânico;10831;8410;2421;12;-52;64
9;9;0;Jardim Carvalho;27165;21532;5633;166;-39;205
9;9;0;Jardim do Salso;2322;1795;527;-119;-19;-100
9;9;0;Jardim Dona Leopoldina;17110;13448;3662;-21;-100;79
9;9;0;Jardim Europa;810;626;184;-36;14;-50
9;9;0;Jardim Floresta;1649;1282;367;-37;23;-60
9;9;0;Jardim Isabel;1527;1204;323;24;38;-14
9;9;0;Jardim Itu;17309;13568;3741;45;-64;109
9;9;0;Jardim Lindóia;5781;4578;1203;17;-18;35
9;9;0;Jardim Sabará;12259;9541;2718;-25;-51;26
9;9;0;Jardim São Pedro;2209;1670;539;-44;-10;-34
9;9;0;Lageado;3383;2947;436;-10;4;-14
9;9;0;Lami;3406;3047;359;-3;2;-5
9;9;0;Lomba do Pinheiro;66353;55414;10939;183;-11;194
9;9;0;Mário Quintana;42582;34543;8039;21;-78;99
9;9;0;Medianeira;9722;7552;2170;-3;-47;44
9;9;0;Menino Deus;34555;27580;6975;89;-106;195
9;9;0;Moinhos de Vento;10524;8113;2411;8;-59;67
9;9;0;MontSerrat;9741;7540;2201;-27;-60;33
9;9;0;Morro Santana;19715;15716;3999;-23;-103;80
9;9;0;Navegantes;2859;2166;693;-16;-7;-9
9;9;0;Nonoai;26579;21239;5340;51;-81;132
9;9;0;Parque Santa Fé;4437;3462;975;-136;-43;-93
9;9;0;Partenon;54437;43653;10784;247;-82;329
9;9;0;Passo DAreia;22828;17869;4959;66;-33;99
9;9;0;Passo das Pedras;15078;11729;3349;54;-84;138
9;9;0;Pedra Redonda;50;40;10;-2;12;-14
9;9;0;Petrópolis;41508;32976;8532;186;-111;297
9;9;0;Pitinga;3304;2692;612;-5;-10;5
9;9;0;Ponta Grossa;7986;6690;1296;-4;-13;9
9;9;0;Praia de Belas;970;712;258;-93;-28;-65
9;9;0;Restinga;60124;51109;9015;-75;-9;-66
9;9;0;Rio Branco;16738;12946;3792;22;-120;142
9;9;0;Rubem Berta;36138;29333;6805;135;-82;217
9;9;0;Santa Cecília;3667;2799;868;-113;-47;-66
9;9;0;Santa Maria Goretti;2000;1453;547;-48;-18;-30
9;9;0;Santa Rosa de Lima;39004;32272;6732;68;-44;112
9;9;0;Santa Tereza;44108;35810;8298;78;-87;165
9;9;0;Santana;20736;16167;4569;21;-137;158
9;9;0;Santo Antônio;11840;9213;2627;-38;-91;53
9;9;0;São Caetano;591;277;314;-13;4;-17
9;9;0;São Geraldo;7459;5526;1933;-50;-25;-25
9;9;0;São João;11393;8870;2523;13;-22;35
9;9;0;São Sebastião;5290;4003;1287;-83;-24;-59
9;9;0;Sarandi;67703;56191;11512;-14;-61;47
9;9;0;Serraria;5366;4198;1168;-9;-21;12
9;9;0;Sétimo Céu;540;380;160;-36;18;-54
9;9;0;Teresópolis;13569;10666;2903;-81;-80;-1
9;9;0;Três Figueiras;2446;1684;762;-99;-63;-36
9;9;0;Tristeza;16679;13687;2992;33;33;0
9;9;0;Vila Assunção;3181;2378;803;-82;-14;-68
9;9;0;Vila Conceição;828;458;370;-53;3;-56
9;9;0;Vila Ipiranga;18150;14312;3838;-122;-113;-9
9;9;0;Vila Jardim;12130;9066;3064;-93;-78;-15
9;9;0;Vila João Pessoa;11764;8847;2917;-29;-56;27
9;9;0;Vila Nova;35582;29402;6180;-128;-51;-77
9;9;0;Vila São José;28200;22652;5548;-178;-119;-59
10;10;0;Aberta dos Morros;6287;5188;1099;42;178;-136
10;10;0;Agronomia;1453;1176;277;181;85;96
10;10;0;Anchieta;1251;998;253;163;89;74
10;10;0;Arquipélago;7799;6301;1498;51;194;-143
10;10;0;Auxiliadora;8195;6623;1572;33;274;-241
10;10;0;Azenha;12336;9891;2445;21;257;-236
10;10;0;Bela Vista;10252;8226;2026;60;317;-257
10;10;0;Belém Novo;10068;8629;1439;-35;180;-215
10;10;0;Belém Velho;10187;8246;1941;-1;193;-194
10;10;0;Boa Vista;8682;6961;1721;105;311;-206
10;10;0;Boa Vista do Sul;1720;1509;211;279;210;69
10;10;0;Bom Fim;9926;8036;1890;84;331;-247
10;10;0;Bom Jesus;30979;24590;6389;-31;308;-339
10;10;0;Camaquã;18016;14575;3441;-61;224;-285
10;10;0;Campo Novo;7768;6440;1328;49;259;-210
10;10;0;Cascata;12260;9880;2380;-46;249;-295
10;10;0;Cavalhada;31797;25785;6012;110;176;-66
10;10;0;Centro;44302;35742;8560;-129;-80;-49
10;10;0;Chácara das Pedras;5186;4203;983;412;400;12
10;10;0;Chapéu do Sol;2120;1805;315;329;223;106
10;10;0;Cidade Baixa;14459;11652;2807;-46;306;-352
10;10;0;Coronel Aparício Borges;19038;15177;3861;-167;257;-424
10;10;0;Costa e Silva;14843;11939;2904;-126;255;-381
10;10;0;Cristal;35128;28717;6411;-171;98;-269
10;10;0;Cristo Redentor;15700;12557;3143;-68;294;-362
10;10;0;Espírito Santo;4542;3814;728;252;243;9
10;10;0;Extrema;1483;1306;177;147;133;14
10;10;0;Farrapos;20197;16531;3666;-62;120;-182
10;10;0;Farroupilha;183;183;0;-12;-12;0
10;10;0;Floresta;10314;8383;1931;-59;308;-367
10;10;0;Glória;16399;13202;3197;-193;241;-434
10;10;0;Guarujá;3865;3250;615;279;237;42
10;10;0;Higienópolis;9370;7575;1795;-9;318;-327
10;10;0;Hípica;19409;16227;3182;-180;86;-266
10;10;0;Humaitá;11017;8998;2019;-47;190;-237
10;10;0;Independência;6637;5201;1436;408;317;91
10;10;0;Ipanema;13429;11094;2335;-101;186;-287
10;10;0;Jardim Botânico;10889;8737;2152;58;327;-269
10;10;0;Jardim Carvalho;26838;21661;5177;-327;129;-456
10;10;0;Jardim do Salso;2750;2186;564;428;391;37
10;10;0;Jardim Dona Leopoldina;16917;13701;3216;-193;253;-446
10;10;0;Jardim Europa;972;652;320;162;26;136
10;10;0;Jardim Floresta;1948;1534;414;299;252;47
10;10;0;Jardim Isabel;1781;1419;362;254;215;39
10;10;0;Jardim Itu;17142;13789;3353;-167;221;-388
10;10;0;Jardim Lindóia;6066;4821;1245;285;243;42
10;10;0;Jardim Sabará;12259;9861;2398;0;320;-320
10;10;0;Jardim São Pedro;2504;1978;526;295;308;-13
10;10;0;Lageado;3581;3144;437;198;197;1
10;10;0;Lami;3644;3234;410;238;187;51
10;10;0;Lomba do Pinheiro;65978;55317;10661;-375;-97;-278
10;10;0;Mário Quintana;42175;34646;7529;-407;103;-510
10;10;0;Medianeira;9674;7878;1796;-48;326;-374
10;10;0;Menino Deus;34188;27675;6513;-367;95;-462
10;10;0;Moinhos de Vento;10471;8343;2128;-53;230;-283
10;10;0;MontSerrat;9733;7883;1850;-8;343;-351
10;10;0;Morro Santana;19560;15849;3711;-155;133;-288
10;10;0;Navegantes;3291;2435;856;432;269;163
10;10;0;Nonoai;26395;21389;5006;-184;150;-334
10;10;0;Parque Santa Fé;4618;3708;910;181;246;-65
10;10;0;Partenon;54216;43782;10434;-221;129;-350
10;10;0;Passo DAreia;22661;18087;4574;-167;218;-385
10;10;0;Passo das Pedras;14907;11937;2970;-171;208;-379
10;10;0;Pedra Redonda;38;35;3;-12;-5;-7
10;10;0;Petrópolis;41242;33143;8099;-266;167;-433
10;10;0;Pitinga;3481;2838;643;177;146;31
10;10;0;Ponta Grossa;7931;6879;1052;-55;189;-244
10;10;0;Praia de Belas;1195;793;402;225;81;144
10;10;0;Restinga;59197;50975;8222;-927;-134;-793
10;10;0;Rio Branco;16584;13260;3324;-154;314;-468
10;10;0;Rubem Berta;35801;29363;6438;-337;30;-367
10;10;0;Santa Cecília;4047;3171;876;380;372;8
10;10;0;Santa Maria Goretti;2250;1739;511;250;286;-36
10;10;0;Santa Rosa de Lima;38704;32256;6448;-300;-16;-284
10;10;0;Santa Tereza;43778;35855;7923;-330;45;-375
10;10;0;Santana;20525;16431;4094;-211;264;-475
10;10;0;Santo Antônio;11816;9501;2315;-24;288;-312
10;10;0;São Caetano;486;279;207;-105;2;-107
10;10;0;São Geraldo;7429;5818;1611;-30;292;-322
10;10;0;São João;11514;9155;2359;121;285;-164
10;10;0;São Sebastião;5593;4290;1303;303;287;16
10;10;0;Sarandi;67650;56240;11410;-53;49;-102
10;10;0;Serraria;5411;4404;1007;45;206;-161
10;10;0;Sétimo Céu;502;363;139;-38;-17;-21
10;10;0;Teresópolis;13427;10895;2532;-142;229;-371
10;10;0;Três Figueiras;2843;1998;845;397;314;83
10;10;0;Tristeza;16594;13872;2722;-85;185;-270
10;10;0;Vila Assunção;3415;2637;778;234;259;-25
10;10;0;Vila Conceição;730;487;243;-98;29;-127
10;10;0;Vila Ipiranga;18103;14547;3556;-47;235;-282
10;10;0;Vila Jardim;12153;9448;2705;23;382;-359
10;10;0;Vila João Pessoa;11677;9206;2471;-87;359;-446
10;10;0;Vila Nova;35287;29492;5795;-295;90;-385
10;10;0;Vila São José;28193;22897;5296;-7;245;-252
11;11;0;Aberta dos Morros;6628;6086;542;341;898;-557
11;11;0;Agronomia;1429;1311;118;-24;135;-159
11;11;0;Anchieta;1179;1088;91;-72;90;-162
11;11;0;Arquipélago;8220;7302;918;421;1001;-580
11;11;0;Auxiliadora;8559;7902;657;364;1279;-915
11;11;0;Azenha;12950;11813;1137;614;1922;-1308
11;11;0;Bela Vista;10799;9814;985;547;1588;-1041
11;11;0;Belém Novo;10132;9303;829;64;674;-610
11;11;0;Belém Velho;10702;9559;1143;515;1313;-798
11;11;0;Boa Vista;8971;8251;720;289;1290;-1001
11;11;0;Boa Vista do Sul;1738;1629;109;18;120;-102
11;11;0;Bom Fim;10293;9520;773;367;1484;-1117
11;11;0;Bom Jesus;30509;26561;3948;-470;1971;-2441
11;11;0;Camaquã;18162;16174;1988;146;1599;-1453
11;11;0;Campo Novo;8169;7474;695;401;1034;-633
11;11;0;Cascata;12817;11405;1412;557;1525;-968
11;11;0;Cavalhada;31101;27391;3710;-696;1606;-2302
11;11;0;Centro;42552;37285;5267;-1750;1543;-3293
11;11;0;Chácara das Pedras;5234;4860;374;48;657;-609
11;11;0;Chapéu do Sol;2097;1962;135;-23;157;-180
11;11;0;Cidade Baixa;14961;13422;1539;502;1770;-1268
11;11;0;Coronel Aparício Borges;19359;17103;2256;321;1926;-1605
11;11;0;Costa e Silva;15420;13779;1641;577;1840;-1263
11;11;0;Cristal;34245;30150;4095;-883;1433;-2316
11;11;0;Cristo Redentor;16224;14455;1769;524;1898;-1374
11;11;0;Espírito Santo;4697;4346;351;155;532;-377
11;11;0;Extrema;1493;1403;90;10;97;-87
11;11;0;Farrapos;20046;17753;2293;-151;1222;-1373
11;11;0;Farroupilha;261;261;0;78;78;0
11;11;0;Floresta;10793;9754;1039;479;1371;-892
11;11;0;Glória;16808;15004;1804;409;1802;-1393
11;11;0;Guarujá;3985;3693;292;120;443;-323
11;11;0;Higienópolis;9721;8843;878;351;1268;-917
11;11;0;Hípica;19288;17253;2035;-121;1026;-1147
11;11;0;Humaitá;11418;10229;1189;401;1231;-830
11;11;0;Independência;6865;6139;726;228;938;-710
11;11;0;Ipanema;13579;12251;1328;150;1157;-1007
11;11;0;Jardim Botânico;11375;10323;1052;486;1586;-1100
11;11;0;Jardim Carvalho;26605;23333;3272;-233;1672;-1905
11;11;0;Jardim do Salso;2777;2574;203;27;388;-361
11;11;0;Jardim Dona Leopoldina;17477;15617;1860;560;1916;-1356
11;11;0;Jardim Europa;1175;857;318;203;205;-2
11;11;0;Jardim Floresta;1960;1860;100;12;326;-314
11;11;0;Jardim Isabel;1790;1683;107;9;264;-255
11;11;0;Jardim Itu;17711;15664;2047;569;1875;-1306
11;11;0;Jardim Lindóia;6299;5631;668;233;810;-577
11;11;0;Jardim Sabará;12887;11496;1391;628;1635;-1007
11;11;0;Jardim São Pedro;2548;2365;183;44;387;-343
11;11;0;Lageado;3706;3496;210;125;352;-227
11;11;0;Lami;3774;3560;214;130;326;-196
11;11;0;Lomba do Pinheiro;63348;56470;6878;-2630;1153;-3783
11;11;0;Mário Quintana;40895;36174;4721;-1280;1528;-2808
11;11;0;Medianeira;10099;9180;919;425;1302;-877
11;11;0;Menino Deus;33539;29413;4126;-649;1738;-2387
11;11;0;Moinhos de Vento;10954;9823;1131;483;1480;-997
11;11;0;MontSerrat;10106;9141;965;373;1258;-885
11;11;0;Morro Santana;19809;17427;2382;249;1578;-1329
11;11;0;Navegantes;3425;2926;499;134;491;-357
11;11;0;Nonoai;26104;23031;3073;-291;1642;-1933
11;11;0;Parque Santa Fé;4793;4444;349;175;736;-561
11;11;0;Partenon;52284;45755;6529;-1932;1973;-3905
11;11;0;Passo DAreia;22573;19828;2745;-88;1741;-1829
11;11;0;Passo das Pedras;15495;13725;1770;588;1788;-1200
11;11;0;Pedra Redonda;68;68;0;30;33;-3
11;11;0;Petrópolis;40155;35023;5132;-1087;1880;-2967
11;11;0;Pitinga;3587;3325;262;106;487;-381
11;11;0;Ponta Grossa;8246;7666;580;315;787;-472
11;11;0;Praia de Belas;1336;961;375;141;168;-27
11;11;0;Restinga;57304;51940;5364;-1893;965;-2858
11;11;0;Rio Branco;17051;15122;1929;467;1862;-1395
11;11;0;Rubem Berta;35012;30950;4062;-789;1587;-2376
11;11;0;Santa Cecília;4164;3781;383;117;610;-493
11;11;0;Santa Maria Goretti;2190;1995;195;-60;256;-316
11;11;0;Santa Rosa de Lima;37836;33573;4263;-868;1317;-2185
11;11;0;Santa Tereza;42504;37459;5045;-1274;1604;-2878
11;11;0;Santana;20797;18320;2477;272;1889;-1617
11;11;0;Santo Antônio;12348;11008;1340;532;1507;-975
11;11;0;São Caetano;507;347;160;21;68;-47
11;11;0;São Geraldo;7732;6999;733;303;1181;-878
11;11;0;São João;11978;10409;1569;464;1254;-790
11;11;0;São Sebastião;5866;5210;656;273;920;-647
11;11;0;Sarandi;65360;57592;7768;-2290;1352;-3642
11;11;0;Serraria;5587;5136;451;176;732;-556
11;11;0;Sétimo Céu;551;496;55;49;133;-84
11;11;0;Teresópolis;14128;12556;1572;701;1661;-960
11;11;0;Três Figueiras;2891;2287;604;48;289;-241
11;11;0;Tristeza;16779;15028;1751;185;1156;-971
11;11;0;Vila Assunção;3517;3135;382;102;498;-396
11;11;0;Vila Conceição;744;586;158;14;99;-85
11;11;0;Vila Ipiranga;18620;16323;2297;517;1776;-1259
11;11;0;Vila Jardim;12725;11160;1565;572;1712;-1140
11;11;0;Vila João Pessoa;12287;10920;1367;610;1714;-1104
11;11;0;Vila Nova;34617;30769;3848;-670;1277;-1947
11;11;0;Vila São José;27952;24587;3365;-241;1690;-1931
12;12;0;Aberta dos Morros;6533;5562;971;-95;-524;429
12;12;0;Agronomia;1360;1133;227;-69;-178;109
12;12;0;Anchieta;1124;951;173;-55;-137;82
12;12;0;Arquipélago;8068;6720;1348;-152;-582;430
12;12;0;Auxiliadora;8357;6996;1361;-202;-906;704
12;12;0;Azenha;12840;10858;1982;-110;-955;845
12;12;0;Bela Vista;10466;8779;1687;-333;-1035;702
12;12;0;Belém Novo;10237;8957;1280;105;-346;451
12;12;0;Belém Velho;10610;8925;1685;-92;-634;542
12;12;0;Boa Vista;8752;7377;1375;-219;-874;655
12;12;0;Boa Vista do Sul;1561;1454;107;-177;-175;-2
12;12;0;Bom Fim;10175;8590;1585;-118;-930;812
12;12;0;Bom Jesus;31131;25605;5526;622;-956;1578
12;12;0;Camaquã;18297;15491;2806;135;-683;818
12;12;0;Campo Novo;7990;6869;1121;-179;-605;426
12;12;0;Cascata;12618;10638;1980;-199;-767;568
12;12;0;Cavalhada;31846;26779;5067;745;-612;1357
12;12;0;Centro;44099;36641;7458;1547;-644;2191
12;12;0;Chácara das Pedras;5080;4281;799;-154;-579;425
12;12;0;Chapéu do Sol;1935;1787;148;-162;-175;13
12;12;0;Cidade Baixa;14728;12558;2170;-233;-864;631
12;12;0;Coronel Aparício Borges;19351;16156;3195;-8;-947;939
12;12;0;Costa e Silva;15130;12838;2292;-290;-941;651
12;12;0;Cristal;34927;29404;5523;682;-746;1428
12;12;0;Cristo Redentor;15902;13607;2295;-322;-848;526
12;12;0;Espírito Santo;4379;3843;536;-318;-503;185
12;12;0;Extrema;1322;1232;90;-171;-171;0
12;12;0;Farrapos;20353;17145;3208;307;-608;915
12;12;0;Farroupilha;220;169;51;-41;-92;51
12;12;0;Floresta;10469;8910;1559;-324;-844;520
12;12;0;Glória;16611;14102;2509;-197;-902;705
12;12;0;Guarujá;3718;3255;463;-267;-438;171
12;12;0;Higienópolis;9357;7896;1461;-364;-947;583
12;12;0;Hípica;19427;16699;2728;139;-554;693
12;12;0;Humaitá;11198;9536;1662;-220;-693;473
12;12;0;Independência;6527;5464;1063;-338;-675;337
12;12;0;Ipanema;13413;11575;1838;-166;-676;510
12;12;0;Jardim Botânico;11001;9315;1686;-374;-1008;634
12;12;0;Jardim Carvalho;26884;22475;4409;279;-858;1137
12;12;0;Jardim do Salso;2800;2236;564;23;-338;361
12;12;0;Jardim Dona Leopoldina;17183;14589;2594;-294;-1028;734
12;12;0;Jardim Europa;929;686;243;-246;-171;-75
12;12;0;Jardim Floresta;1931;1584;347;-29;-276;247
12;12;0;Jardim Isabel;1621;1359;262;-169;-324;155
12;12;0;Jardim Itu;17343;14624;2719;-368;-1040;672
12;12;0;Jardim Lindóia;5938;5002;936;-361;-629;268
12;12;0;Jardim Sabará;12370;10487;1883;-517;-1009;492
12;12;0;Jardim São Pedro;2526;2020;506;-22;-345;323
12;12;0;Lageado;3420;3098;322;-286;-398;112
12;12;0;Lami;3533;3217;316;-241;-343;102
12;12;0;Lomba do Pinheiro;65222;55671;9551;1874;-799;2673
12;12;0;Mário Quintana;41847;35243;6604;952;-931;1883
12;12;0;Medianeira;9766;8260;1506;-333;-920;587
12;12;0;Menino Deus;34108;28589;5519;569;-824;1393
12;12;0;Moinhos de Vento;10616;8950;1666;-338;-873;535
12;12;0;MontSerrat;9760;8224;1536;-346;-917;571
12;12;0;Morro Santana;19787;16615;3172;-22;-812;790
12;12;0;Navegantes;3153;2505;648;-272;-421;149
12;12;0;Nonoai;26416;22175;4241;312;-856;1168
12;12;0;Parque Santa Fé;4651;3893;758;-142;-551;409
12;12;0;Partenon;53711;44687;9024;1427;-1068;2495
12;12;0;Passo DAreia;22558;18867;3691;-15;-961;946
12;12;0;Passo das Pedras;15072;12802;2270;-423;-923;500
12;12;0;Pedra Redonda;55;22;33;-13;-46;33
12;12;0;Petrópolis;40865;33937;6928;710;-1086;1796
12;12;0;Pitinga;3360;2979;381;-227;-346;119
12;12;0;Ponta Grossa;8075;7146;929;-171;-520;349
12;12;0;Praia de Belas;1081;758;323;-255;-203;-52
12;12;0;Restinga;58651;51021;7630;1347;-919;2266
12;12;0;Rio Branco;16644;14107;2537;-407;-1015;608
12;12;0;Rubem Berta;35359;30046;5313;347;-904;1251
12;12;0;Santa Cecília;4047;3226;821;-117;-555;438
12;12;0;Santa Maria Goretti;2150;1635;515;-40;-360;320
12;12;0;Santa Rosa de Lima;38504;32744;5760;668;-829;1497
12;12;0;Santa Tereza;43414;36397;7017;910;-1062;1972
12;12;0;Santana;20368;17255;3113;-429;-1065;636
12;12;0;Santo Antônio;11850;10000;1850;-498;-1008;510
12;12;0;São Caetano;562;256;306;55;-91;146
12;12;0;São Geraldo;7486;6250;1236;-246;-749;503
12;12;0;São João;11353;9594;1759;-625;-815;190
12;12;0;São Sebastião;5580;4510;1070;-286;-700;414
12;12;0;Sarandi;67103;56732;10371;1743;-860;2603
12;12;0;Serraria;5351;4592;759;-236;-544;308
12;12;0;Sétimo Céu;565;364;201;14;-132;146
12;12;0;Teresópolis;13624;11571;2053;-504;-985;481
12;12;0;Três Figueiras;2634;1923;711;-257;-364;107
12;12;0;Tristeza;16537;14256;2281;-242;-772;530
12;12;0;Vila Assunção;3415;2658;757;-102;-477;375
12;12;0;Vila Conceição;812;418;394;68;-168;236
12;12;0;Vila Ipiranga;18279;15371;2908;-341;-952;611
12;12;0;Vila Jardim;12171;10167;2004;-554;-993;439
12;12;0;Vila João Pessoa;11726;9899;1827;-561;-1021;460
12;12;0;Vila Nova;35187;29845;5342;570;-924;1494
12;12;0;Vila São José;28286;23591;4695;334;-996;1330
13;13;0;Aberta dos Morros;6472;5523;949;-61;-39;-22
13;13;0;Agronomia;1306;1120;186;-54;-13;-41
13;13;0;Anchieta;1085;935;150;-39;-16;-23
13;13;0;Arquipélago;8061;6695;1366;-7;-25;18
13;13;0;Auxiliadora;8251;6986;1265;-106;-10;-96
13;13;0;Azenha;12687;10813;1874;-153;-45;-108
13;13;0;Bela Vista;10277;8726;1551;-189;-53;-136
13;13;0;Belém Novo;10253;8951;1302;16;-6;22
13;13;0;Belém Velho;10572;8845;1727;-38;-80;42
13;13;0;Boa Vista;8585;7330;1255;-167;-47;-120
13;13;0;Boa Vista do Sul;1565;1450;115;4;-4;8
13;13;0;Bom Fim;9961;8510;1451;-214;-80;-134
13;13;0;Bom Jesus;31254;25487;5767;123;-118;241
13;13;0;Camaquã;18293;15410;2883;-4;-81;77
13;13;0;Campo Novo;7949;6816;1133;-41;-53;12
13;13;0;Cascata;12574;10549;2025;-44;-89;45
13;13;0;Cavalhada;32057;26672;5385;211;-107;318
13;13;0;Centro;44457;36593;7864;358;-48;406
13;13;0;Chácara das Pedras;4903;4212;691;-177;-69;-108
13;13;0;Chapéu do Sol;1883;1750;133;-52;-37;-15
13;13;0;Cidade Baixa;14683;12442;2241;-45;-116;71
13;13;0;Coronel Aparício Borges;19258;15974;3284;-93;-182;89
13;13;0;Costa e Silva;15041;12716;2325;-89;-122;33
13;13;0;Cristal;35114;29290;5824;187;-114;301
13;13;0;Cristo Redentor;15934;13610;2324;32;3;29
13;13;0;Espírito Santo;4347;3798;549;-32;-45;13
13;13;0;Extrema;1324;1231;93;2;-1;3
13;13;0;Farrapos;20448;17103;3345;95;-42;137
13;13;0;Farroupilha;149;149;0;-71;-20;-51
13;13;0;Floresta;10411;8826;1585;-58;-84;26
13;13;0;Glória;16608;13983;2625;-3;-119;116
13;13;0;Guarujá;3695;3229;466;-23;-26;3
13;13;0;Higienópolis;9282;7832;1450;-75;-64;-11
13;13;0;Hípica;19523;16664;2859;96;-35;131
13;13;0;Humaitá;11289;9524;1765;91;-12;103
13;13;0;Independência;6432;5378;1054;-95;-86;-9
13;13;0;Ipanema;13456;11538;1918;43;-37;80
13;13;0;Jardim Botânico;10809;9170;1639;-192;-145;-47
13;13;0;Jardim Carvalho;27053;22354;4699;169;-121;290
13;13;0;Jardim do Salso;2609;2174;435;-191;-62;-129
13;13;0;Jardim Dona Leopoldina;17075;14414;2661;-108;-175;67
13;13;0;Jardim Europa;962;701;261;33;15;18
13;13;0;Jardim Floresta;1819;1583;236;-112;-1;-111
13;13;0;Jardim Isabel;1597;1319;278;-24;-40;16
13;13;0;Jardim Itu;17375;14507;2868;32;-117;149
13;13;0;Jardim Lindóia;5888;4978;910;-50;-24;-26
13;13;0;Jardim Sabará;12349;10373;1976;-21;-114;93
13;13;0;Jardim São Pedro;2354;1981;373;-172;-39;-133
13;13;0;Lageado;3408;3081;327;-12;-17;5
13;13;0;Lami;3515;3211;304;-18;-6;-12
13;13;0;Lomba do Pinheiro;65502;55658;9844;280;-13;293
13;13;0;Mário Quintana;41902;35091;6811;55;-152;207
13;13;0;Medianeira;9657;8105;1552;-109;-155;46
13;13;0;Menino Deus;34443;28473;5970;335;-116;451
13;13;0;Moinhos de Vento;10546;8873;1673;-70;-77;7
13;13;0;MontSerrat;9719;8109;1610;-41;-115;74
13;13;0;Morro Santana;19811;16470;3341;24;-145;169
13;13;0;Navegantes;3095;2475;620;-58;-30;-28
13;13;0;Nonoai;26488;21987;4501;72;-188;260
13;13;0;Parque Santa Fé;4469;3739;730;-182;-154;-28
13;13;0;Partenon;54266;44553;9713;555;-134;689
13;13;0;Passo DAreia;22741;18770;3971;183;-97;280
13;13;0;Passo das Pedras;15038;12623;2415;-34;-179;145
13;13;0;Pedra Redonda;23;20;3;-32;-2;-30
13;13;0;Petrópolis;41153;33765;7388;288;-172;460
13;13;0;Pitinga;3332;2956;376;-28;-23;-5
13;13;0;Ponta Grossa;8052;7134;918;-23;-12;-11
13;13;0;Praia de Belas;1020;734;286;-61;-24;-37
13;13;0;Restinga;58846;50988;7858;195;-33;228
13;13;0;Rio Branco;16819;14030;2789;175;-77;252
13;13;0;Rubem Berta;35530;29909;5621;171;-137;308
13;13;0;Santa Cecília;3822;3106;716;-225;-120;-105
13;13;0;Santa Maria Goretti;2007;1597;410;-143;-38;-105
13;13;0;Santa Rosa de Lima;38696;32667;6029;192;-77;269
13;13;0;Santa Tereza;43625;36269;7356;211;-128;339
13;13;0;Santana;20480;17093;3387;112;-162;274
13;13;0;Santo Antônio;11807;9824;1983;-43;-176;133
13;13;0;São Caetano;536;252;284;-26;-4;-22
13;13;0;São Geraldo;7466;6177;1289;-20;-73;53
13;13;0;São João;11355;9560;1795;2;-34;36
13;13;0;São Sebastião;5497;4471;1026;-83;-39;-44
13;13;0;Sarandi;67493;56670;10823;390;-62;452
13;13;0;Serraria;5348;4566;782;-3;-26;23
13;13;0;Sétimo Céu;515;379;136;-50;15;-65
13;13;0;Teresópolis;13633;11423;2210;9;-148;157
13;13;0;Três Figueiras;2382;1841;541;-252;-82;-170
13;13;0;Tristeza;16576;14239;2337;39;-17;56
13;13;0;Vila Assunção;3277;2588;689;-138;-70;-68
13;13;0;Vila Conceição;770;427;343;-42;9;-51
13;13;0;Vila Ipiranga;18312;15252;3060;33;-119;152
13;13;0;Vila Jardim;12112;10032;2080;-59;-135;76
13;13;0;Vila João Pessoa;11652;9729;1923;-74;-170;96
13;13;0;Vila Nova;35103;29732;5371;-84;-113;29
13;13;0;Vila São José;28183;23383;4800;-103;-208;105
14;14;0;Aberta dos Morros;6582;5580;1002;110;57;53
14;14;0;Agronomia;1474;1222;252;168;102;66
14;14;0;Anchieta;1243;1040;203;158;105;53
14;14;0;Arquipélago;8029;6743;1286;-32;48;-80
14;14;0;Auxiliadora;8447;7087;1360;196;101;95
14;14;0;Azenha;12757;10948;1809;70;135;-65
14;14;0;Bela Vista;10514;8848;1666;237;122;115
14;14;0;Belém Novo;10319;9038;1281;66;87;-21
14;14;0;Belém Velho;10612;8954;1658;40;109;-69
14;14;0;Boa Vista;8818;7431;1387;233;101;132
14;14;0;Boa Vista do Sul;1730;1535;195;165;85;80
14;14;0;Bom Fim;10337;8713;1624;376;203;173
14;14;0;Bom Jesus;30916;25634;5282;-338;147;-485
14;14;0;Camaquã;18152;15500;2652;-141;90;-231
14;14;0;Campo Novo;8126;6912;1214;177;96;81
14;14;0;Cascata;12576;10636;1940;2;87;-85
14;14;0;Cavalhada;31608;26862;4746;-449;190;-639
14;14;0;Centro;44002;36680;7322;-455;87;-542
14;14;0;Chácara das Pedras;5178;4368;810;275;156;119
14;14;0;Chapéu do Sol;2103;1866;237;220;116;104
14;14;0;Cidade Baixa;14828;12578;2250;145;136;9
14;14;0;Coronel Aparício Borges;19123;16156;2967;-135;182;-317
14;14;0;Costa e Silva;15036;12822;2214;-5;106;-111
14;14;0;Cristal;34683;29306;5377;-431;16;-447
14;14;0;Cristo Redentor;16298;13815;2483;364;205;159
14;14;0;Espírito Santo;4543;3901;642;196;103;93
14;14;0;Extrema;1503;1377;126;179;146;33
14;14;0;Farrapos;20158;17097;3061;-290;-6;-284
14;14;0;Farroupilha;163;163;0;14;14;0
14;14;0;Floresta;10657;9017;1640;246;191;55
14;14;0;Glória;16660;14037;2623;52;54;-2
14;14;0;Guarujá;3894;3340;554;199;111;88
14;14;0;Higienópolis;9559;8018;1541;277;186;91
14;14;0;Hípica;19062;16638;2424;-461;-26;-435
14;14;0;Humaitá;11192;9629;1563;-97;105;-202
14;14;0;Independência;6752;5629;1123;320;251;69
14;14;0;Ipanema;13507;11660;1847;51;122;-71
14;14;0;Jardim Botânico;11124;9439;1685;315;269;46
14;14;0;Jardim Carvalho;26491;22387;4104;-562;33;-595
14;14;0;Jardim do Salso;2840;2364;476;231;190;41
14;14;0;Jardim Dona Leopoldina;17149;14611;2538;74;197;-123
14;14;0;Jardim Europa;971;791;180;9;90;-81
14;14;0;Jardim Floresta;2008;1729;279;189;146;43
14;14;0;Jardim Isabel;1828;1504;324;231;185;46
14;14;0;Jardim Itu;17305;14665;2640;-70;158;-228
14;14;0;Jardim Lindóia;6187;5239;948;299;261;38
14;14;0;Jardim Sabará;12475;10510;1965;126;137;-11
14;14;0;Jardim São Pedro;2550;2146;404;196;165;31
14;14;0;Lageado;3632;3245;387;224;164;60
14;14;0;Lami;3759;3389;370;244;178;66
14;14;0;Lomba do Pinheiro;64867;55647;9220;-635;-11;-624
14;14;0;Mário Quintana;41391;35073;6318;-511;-18;-493
14;14;0;Medianeira;9795;8232;1563;138;127;11
14;14;0;Menino Deus;33887;28447;5440;-556;-26;-530
14;14;0;Moinhos de Vento;10854;9119;1735;308;246;62
14;14;0;MontSerrat;9859;8268;1591;140;159;-19
14;14;0;Morro Santana;19457;16569;2888;-354;99;-453
14;14;0;Navegantes;3349;2675;674;254;200;54
14;14;0;Nonoai;25918;22003;3915;-570;16;-586
14;14;0;Parque Santa Fé;4688;3920;768;219;181;38
14;14;0;Partenon;53494;44485;9009;-772;-68;-704
14;14;0;Passo DAreia;22397;18953;3444;-344;183;-527
14;14;0;Passo das Pedras;15008;12764;2244;-30;141;-171
14;14;0;Pedra Redonda;21;20;1;-2;0;-2
14;14;0;Petrópolis;40572;33822;6750;-581;57;-638
14;14;0;Pitinga;3541;3084;457;209;128;81
14;14;0;Ponta Grossa;8253;7285;968;201;151;50
14;14;0;Praia de Belas;1105;925;180;85;191;-106
14;14;0;Restinga;58372;50868;7504;-474;-120;-354
14;14;0;Rio Branco;16902;14186;2716;83;156;-73
14;14;0;Rubem Berta;35174;29906;5268;-356;-3;-353
14;14;0;Santa Cecília;3998;3264;734;176;158;18
14;14;0;Santa Maria Goretti;2194;1788;406;187;191;-4
14;14;0;Santa Rosa de Lima;38255;32638;5617;-441;-29;-412
14;14;0;Santa Tereza;43052;36257;6795;-573;-12;-561
14;14;0;Santana;20463;17231;3232;-17;138;-155
14;14;0;Santo Antônio;12005;9982;2023;198;158;40
14;14;0;São Caetano;473;297;176;-63;45;-108
14;14;0;São Geraldo;7639;6336;1303;173;159;14
14;14;0;São João;11651;9795;1856;296;235;61
14;14;0;São Sebastião;5723;4761;962;226;290;-64
14;14;0;Sarandi;67047;56823;10224;-446;153;-599
14;14;0;Serraria;5534;4787;747;186;221;-35
14;14;0;Sétimo Céu;513;400;113;-2;21;-23
14;14;0;Teresópolis;13729;11527;2202;96;104;-8
14;14;0;Três Figueiras;2558;2058;500;176;217;-41
14;14;0;Tristeza;16490;14321;2169;-86;82;-168
14;14;0;Vila Assunção;3502;2783;719;225;195;30
14;14;0;Vila Conceição;750;520;230;-20;93;-113
14;14;0;Vila Ipiranga;18299;15425;2874;-13;173;-186
14;14;0;Vila Jardim;12300;10202;2098;188;170;18
14;14;0;Vila João Pessoa;11784;9879;1905;132;150;-18
14;14;0;Vila Nova;34946;29942;5004;-157;210;-367
14;14;0;Vila São José;28082;23548;4534;-101;165;-266
15;15;0;Aberta dos Morros;6536;5556;980;-46;-24;-22
15;15;0;Agronomia;1405;1212;193;-69;-10;-59
15;15;0;Anchieta;1156;1038;118;-87;-2;-85
15;15;0;Arquipélago;8103;6748;1355;74;5;69
15;15;0;Auxiliadora;8293;7157;1136;-154;70;-224
15;15;0;Azenha;12291;10938;1353;-466;-10;-456
15;15;0;Bela Vista;10371;8902;1469;-143;54;-197
15;15;0;Belém Novo;10306;9019;1287;-13;-19;6
15;15;0;Belém Velho;10634;8956;1678;22;2;20
15;15;0;Boa Vista;8661;7460;1201;-157;29;-186
15;15;0;Boa Vista do Sul;1715;1528;187;-15;-7;-8
15;15;0;Bom Fim;10212;8810;1402;-125;97;-222
15;15;0;Bom Jesus;31134;25641;5493;218;7;211
15;15;0;Camaquã;18153;15569;2584;1;69;-68
15;15;0;Campo Novo;8113;6911;1202;-13;-1;-12
15;15;0;Cascata;12588;10634;1954;12;-2;14
15;15;0;Cavalhada;31616;26845;4771;8;-17;25
15;15;0;Centro;44186;36771;7415;184;91;93
15;15;0;Chácara das Pedras;4986;4372;614;-192;4;-196
15;15;0;Chapéu do Sol;2077;1867;210;-26;1;-27
15;15;0;Cidade Baixa;14898;12626;2272;70;48;22
15;15;0;Coronel Aparício Borges;19116;16109;3007;-7;-47;40
15;15;0;Costa e Silva;15020;12838;2182;-16;16;-32
15;15;0;Cristal;34865;29213;5652;182;-93;275
15;15;0;Cristo Redentor;16014;13882;2132;-284;67;-351
15;15;0;Espírito Santo;4531;3882;649;-12;-19;7
15;15;0;Extrema;1493;1369;124;-10;-8;-2
15;15;0;Farrapos;20357;17120;3237;199;23;176
15;15;0;Farroupilha;175;175;0;12;12;0
15;15;0;Floresta;10696;9078;1618;39;61;-22
15;15;0;Glória;16667;14014;2653;7;-23;30
15;15;0;Guarujá;3863;3322;541;-31;-18;-13
15;15;0;Higienópolis;9562;8078;1484;3;60;-57
15;15;0;Hípica;19156;16616;2540;94;-22;116
15;15;0;Humaitá;11281;9635;1646;89;6;83
15;15;0;Independência;6455;5703;752;-297;74;-371
15;15;0;Ipanema;13501;11593;1908;-6;-67;61
15;15;0;Jardim Botânico;10814;9455;1359;-310;16;-326
15;15;0;Jardim Carvalho;26725;22310;4415;234;-77;311
15;15;0;Jardim do Salso;2659;2339;320;-181;-25;-156
15;15;0;Jardim Dona Leopoldina;17083;14579;2504;-66;-32;-34
15;15;0;Jardim Europa;1002;812;190;31;21;10
15;15;0;Jardim Floresta;1912;1796;116;-96;67;-163
15;15;0;Jardim Isabel;1730;1492;238;-98;-12;-86
15;15;0;Jardim Itu;17312;14704;2608;7;39;-32
15;15;0;Jardim Lindóia;5892;5319;573;-295;80;-375
15;15;0;Jardim Sabará;12456;10493;1963;-19;-17;-2
15;15;0;Jardim São Pedro;2445;2196;249;-105;50;-155
15;15;0;Lageado;3633;3224;409;1;-21;22
15;15;0;Lami;3731;3365;366;-28;-24;-4
15;15;0;Lomba do Pinheiro;65267;55629;9638;400;-18;418
15;15;0;Mário Quintana;41644;35001;6643;253;-72;325
15;15;0;Medianeira;9726;8207;1519;-69;-25;-44
15;15;0;Menino Deus;34092;28435;5657;205;-12;217
15;15;0;Moinhos de Vento;10620;9152;1468;-234;33;-267
15;15;0;MontSerrat;9868;8316;1552;9;48;-39
15;15;0;Morro Santana;19548;16487;3061;91;-82;173
15;15;0;Navegantes;3094;2672;422;-255;-3;-252
15;15;0;Nonoai;25981;21901;4080;63;-102;165
15;15;0;Parque Santa Fé;4539;3908;631;-149;-12;-137
15;15;0;Partenon;53795;44411;9384;301;-74;375
15;15;0;Passo DAreia;22657;19010;3647;260;57;203
15;15;0;Passo das Pedras;15065;12732;2333;57;-32;89
15;15;0;Pedra Redonda;15;15;0;-6;-5;-1
15;15;0;Petrópolis;41065;33819;7246;493;-3;496
15;15;0;Pitinga;3555;3077;478;14;-7;21
15;15;0;Ponta Grossa;8261;7252;1009;8;-33;41
15;15;0;Praia de Belas;1053;898;155;-52;-27;-25
15;15;0;Restinga;58344;50833;7511;-28;-35;7
15;15;0;Rio Branco;17145;14259;2886;243;73;170
15;15;0;Rubem Berta;35389;29844;5545;215;-62;277
15;15;0;Santa Cecília;3816;3249;567;-182;-15;-167
15;15;0;Santa Maria Goretti;2090;1784;306;-104;-4;-100
15;15;0;Santa Rosa de Lima;38365;32607;5758;110;-31;141
15;15;0;Santa Tereza;43317;36125;7192;265;-132;397
15;15;0;Santana;20719;17242;3477;256;11;245
15;15;0;Santo Antônio;11989;9966;2023;-16;-16;0
15;15;0;São Caetano;469;280;189;-4;-17;13
15;15;0;São Geraldo;7719;6392;1327;80;56;24
15;15;0;São João;11637;9810;1827;-14;15;-29
15;15;0;São Sebastião;5479;4798;681;-244;37;-281
15;15;0;Sarandi;67263;56831;10432;216;8;208
15;15;0;Serraria;5532;4729;803;-2;-58;56
15;15;0;Sétimo Céu;469;393;76;-44;-7;-37
15;15;0;Teresópolis;13817;11462;2355;88;-65;153
15;15;0;Três Figueiras;2190;2009;181;-368;-49;-319
15;15;0;Tristeza;16570;14319;2251;80;-2;82
15;15;0;Vila Assunção;3457;2736;721;-45;-47;2
15;15;0;Vila Conceição;684;457;227;-66;-63;-3
15;15;0;Vila Ipiranga;18415;15425;2990;116;0;116
15;15;0;Vila Jardim;12262;10121;2141;-38;-81;43
15;15;0;Vila João Pessoa;11777;9796;1981;-7;-83;76
15;15;0;Vila Nova;35030;29841;5189;84;-101;185
15;15;0;Vila São José;27982;23398;4584;-100;-150;50
16;16;0;Aberta dos Morros;6528;5677;851;-8;121;-129
16;16;0;Agronomia;1458;1343;115;53;131;-78
16;16;0;Anchieta;1222;1172;50;66;134;-68
16;16;0;Arquipélago;8170;6965;1205;67;217;-150
16;16;0;Auxiliadora;8329;7470;859;36;313;-277
16;16;0;Azenha;12393;11306;1087;102;368;-266
16;16;0;Bela Vista;10444;9259;1185;73;357;-284
16;16;0;Belém Novo;10330;9081;1249;24;62;-38
16;16;0;Belém Velho;10668;9150;1518;34;194;-160
16;16;0;Boa Vista;8767;7782;985;106;322;-216
16;16;0;Boa Vista do Sul;1713;1589;124;-2;61;-63
16;16;0;Bom Fim;10238;9171;1067;26;361;-335
16;16;0;Bom Jesus;30624;25979;4645;-510;338;-848
16;16;0;Camaquã;18189;15804;2385;36;235;-199
16;16;0;Campo Novo;8211;7138;1073;98;227;-129
16;16;0;Cascata;12721;10936;1785;133;302;-169
16;16;0;Cavalhada;31223;27083;4140;-393;238;-631
16;16;0;Centro;43765;37092;6673;-421;321;-742
16;16;0;Chácara das Pedras;5131;4675;456;145;303;-158
16;16;0;Chapéu do Sol;2064;1952;112;-13;85;-98
16;16;0;Cidade Baixa;15023;13013;2010;125;387;-262
16;16;0;Coronel Aparício Borges;19219;16496;2723;103;387;-284
16;16;0;Costa e Silva;15240;13252;1988;220;414;-194
16;16;0;Cristal;34419;29365;5054;-446;152;-598
16;16;0;Cristo Redentor;16010;14208;1802;-4;326;-330
16;16;0;Espírito Santo;4552;4030;522;21;148;-127
16;16;0;Extrema;1500;1390;110;7;21;-14
16;16;0;Farrapos;20120;17248;2872;-237;128;-365
16;16;0;Farroupilha;154;154;0;-21;-21;0
16;16;0;Floresta;10805;9409;1396;109;331;-222
16;16;0;Glória;16808;14389;2419;141;375;-234
16;16;0;Guarujá;3883;3433;450;20;111;-91
16;16;0;Higienópolis;9662;8412;1250;100;334;-234
16;16;0;Hípica;19226;16725;2501;70;109;-39
16;16;0;Humaitá;11372;9787;1585;91;152;-61
16;16;0;Independência;6472;6035;437;17;332;-315
16;16;0;Ipanema;13560;11678;1882;59;85;-26
16;16;0;Jardim Botânico;10917;9821;1096;103;366;-263
16;16;0;Jardim Carvalho;26443;22527;3916;-282;217;-499
16;16;0;Jardim do Salso;2809;2555;254;150;216;-66
16;16;0;Jardim Dona Leopoldina;17232;14996;2236;149;417;-268
16;16;0;Jardim Europa;1047;914;133;45;102;-57
16;16;0;Jardim Floresta;1990;1953;37;78;157;-79
16;16;0;Jardim Isabel;1793;1634;159;63;142;-79
16;16;0;Jardim Itu;17349;14990;2359;37;286;-249
16;16;0;Jardim Lindóia;5956;5580;376;64;261;-197
16;16;0;Jardim Sabará;12580;10818;1762;124;325;-201
16;16;0;Jardim São Pedro;2589;2418;171;144;222;-78
16;16;0;Lageado;3647;3279;368;14;55;-41
16;16;0;Lami;3686;3367;319;-45;2;-47
16;16;0;Lomba do Pinheiro;65188;55797;9391;-79;168;-247
16;16;0;Mário Quintana;41319;35287;6032;-325;286;-611
16;16;0;Medianeira;9924;8554;1370;198;347;-149
16;16;0;Menino Deus;33923;28862;5061;-169;427;-596
16;16;0;Moinhos de Vento;10775;9554;1221;155;402;-247
16;16;0;MontSerrat;10056;8697;1359;188;381;-193
16;16;0;Morro Santana;19542;16715;2827;-6;228;-234
16;16;0;Navegantes;3129;2832;297;35;160;-125
16;16;0;Nonoai;25837;22250;3587;-144;349;-493
16;16;0;Parque Santa Fé;4806;4268;538;267;360;-93
16;16;0;Partenon;53059;44617;8442;-736;206;-942
16;16;0;Passo DAreia;22605;19316;3289;-52;306;-358
16;16;0;Passo das Pedras;15251;13090;2161;186;358;-172
16;16;0;Pedra Redonda;35;1;34;20;-14;34
16;16;0;Petrópolis;40435;34117;6318;-630;298;-928
16;16;0;Pitinga;3581;3194;387;26;117;-91
16;16;0;Ponta Grossa;8277;7261;1016;16;9;7
16;16;0;Praia de Belas;1101;1052;49;48;154;-106
16;16;0;Restinga;58318;51021;7297;-26;188;-214
16;16;0;Rio Branco;17340;14706;2634;195;447;-252
16;16;0;Rubem Berta;34755;30053;4702;-634;209;-843
16;16;0;Santa Cecília;4003;3560;443;187;311;-124
16;16;0;Santa Maria Goretti;2222;1986;236;132;202;-70
16;16;0;Santa Rosa de Lima;37974;32724;5250;-391;117;-508
16;16;0;Santa Tereza;43001;36250;6751;-316;125;-441
16;16;0;Santana;20882;17635;3247;163;393;-230
16;16;0;Santo Antônio;12220;10289;1931;231;323;-92
16;16;0;São Caetano;554;281;273;85;1;84
16;16;0;São Geraldo;7846;6627;1219;127;235;-108
16;16;0;São João;11620;10108;1512;-17;298;-315
16;16;0;São Sebastião;5508;5058;450;29;260;-231
16;16;0;Sarandi;66896;57064;9832;-367;233;-600
16;16;0;Serraria;5568;4755;813;36;26;10
16;16;0;Sétimo Céu;505;394;111;36;1;35
16;16;0;Teresópolis;13876;11812;2064;59;350;-291
16;16;0;Três Figueiras;2509;2309;200;319;300;19
16;16;0;Tristeza;16713;14442;2271;143;123;20
16;16;0;Vila Assunção;3587;2909;678;130;173;-43
16;16;0;Vila Conceição;740;477;263;56;20;36
16;16;0;Vila Ipiranga;18627;15745;2882;212;320;-108
16;16;0;Vila Jardim;12529;10438;2091;267;317;-50
16;16;0;Vila João Pessoa;11936;10104;1832;159;308;-149
16;16;0;Vila Nova;34684;29781;4903;-346;-60;-286
16;16;0;Vila São José;27844;23607;4237;-138;209;-347
17;17;0;Aberta dos Morros;6783;6452;331;255;775;-520
17;17;0;Agronomia;1745;1735;10;287;392;-105
17;17;0;Anchieta;1494;1494;0;272;322;-50
17;17;0;Arquipélago;8292;7787;505;122;822;-700
17;17;0;Auxiliadora;8857;8618;239;528;1148;-620
17;17;0;Azenha;12986;12671;315;593;1365;-772
17;17;0;Bela Vista;10988;10604;384;544;1345;-801
17;17;0;Belém Novo;10170;9568;602;-160;487;-647
17;17;0;Belém Velho;10859;10092;767;191;942;-751
17;17;0;Boa Vista;9315;8976;339;548;1194;-646
17;17;0;Boa Vista do Sul;1935;1883;52;222;294;-72
17;17;0;Bom Fim;10896;10517;379;658;1346;-688
17;17;0;Bom Jesus;29794;27357;2437;-830;1378;-2208
17;17;0;Camaquã;18121;16913;1208;-68;1109;-1177
17;17;0;Campo Novo;8530;7999;531;319;861;-542
17;17;0;Cascata;12980;12059;921;259;1123;-864
17;17;0;Cavalhada;30321;28180;2141;-902;1097;-1999
17;17;0;Centro;41706;38188;3518;-2059;1096;-3155
17;17;0;Chácara das Pedras;5679;5611;68;548;936;-388
17;17;0;Chapéu do Sol;2341;2306;35;277;354;-77
17;17;0;Cidade Baixa;15210;14257;953;187;1244;-1057
17;17;0;Coronel Aparício Borges;19259;17891;1368;40;1395;-1355
17;17;0;Costa e Silva;15485;14587;898;245;1335;-1090
17;17;0;Cristal;33551;30508;3043;-868;1143;-2011
17;17;0;Cristo Redentor;16176;15445;731;166;1237;-1071
17;17;0;Espírito Santo;4946;4750;196;394;720;-326
17;17;0;Extrema;1672;1586;86;172;196;-24
17;17;0;Farrapos;19659;18153;1506;-461;905;-1366
17;17;0;Farroupilha;338;338;0;184;184;0
17;17;0;Floresta;11164;10589;575;359;1180;-821
17;17;0;Glória;17034;15756;1278;226;1367;-1141
17;17;0;Guarujá;4242;4063;179;359;630;-271
17;17;0;Higienópolis;10083;9626;457;421;1214;-793
17;17;0;Hípica;18927;17578;1349;-299;853;-1152
17;17;0;Humaitá;11553;10732;821;181;945;-764
17;17;0;Independência;7205;7070;135;733;1035;-302
17;17;0;Ipanema;13618;12641;977;58;963;-905
17;17;0;Jardim Botânico;11664;11264;400;747;1443;-696
17;17;0;Jardim Carvalho;26149;23884;2265;-294;1357;-1651
17;17;0;Jardim do Salso;3280;3260;20;471;705;-234
17;17;0;Jardim Dona Leopoldina;17487;16395;1092;255;1399;-1144
17;17;0;Jardim Europa;1406;1335;71;359;421;-62
17;17;0;Jardim Floresta;2486;2483;3;496;530;-34
17;17;0;Jardim Isabel;2163;2114;49;370;480;-110
17;17;0;Jardim Itu;17573;16384;1189;224;1394;-1170
17;17;0;Jardim Lindóia;6654;6527;127;698;947;-249
17;17;0;Jardim Sabará;13082;12180;902;502;1362;-860
17;17;0;Jardim São Pedro;3046;3015;31;457;597;-140
17;17;0;Lageado;3934;3782;152;287;503;-216
17;17;0;Lami;3908;3748;160;222;381;-159
17;17;0;Lomba do Pinheiro;62697;56854;5843;-2491;1057;-3548
17;17;0;Mário Quintana;40016;36458;3558;-1303;1171;-2474
17;17;0;Medianeira;10491;9896;595;567;1342;-775
17;17;0;Menino Deus;33183;30172;3011;-740;1310;-2050
17;17;0;Moinhos de Vento;11321;10839;482;546;1285;-739
17;17;0;MontSerrat;10589;9949;640;533;1252;-719
17;17;0;Morro Santana;19482;17957;1525;-60;1242;-1302
17;17;0;Navegantes;3759;3555;204;630;723;-93
17;17;0;Nonoai;25593;23519;2074;-244;1269;-1513
17;17;0;Parque Santa Fé;5270;5123;147;464;855;-391
17;17;0;Partenon;51332;46054;5278;-1727;1437;-3164
17;17;0;Passo DAreia;22372;20558;1814;-233;1242;-1475
17;17;0;Passo das Pedras;15655;14489;1166;404;1399;-995
17;17;0;Pedra Redonda;48;48;0;13;47;-34
17;17;0;Petrópolis;39132;35574;3558;-1303;1457;-2760
17;17;0;Pitinga;3900;3720;180;319;526;-207
17;17;0;Ponta Grossa;8406;7878;528;129;617;-488
17;17;0;Praia de Belas;1505;1444;61;404;392;12
17;17;0;Restinga;56356;52128;4228;-1962;1107;-3069
17;17;0;Rio Branco;17496;16074;1422;156;1368;-1212
17;17;0;Rubem Berta;34019;31334;2685;-736;1281;-2017
17;17;0;Santa Cecília;4575;4425;150;572;865;-293
17;17;0;Santa Maria Goretti;2605;2558;47;383;572;-189
17;17;0;Santa Rosa de Lima;36966;33831;3135;-1008;1107;-2115
17;17;0;Santa Tereza;41469;37482;3987;-1532;1232;-2764
17;17;0;Santana;20941;19067;1874;59;1432;-1373
17;17;0;Santo Antônio;12705;11684;1021;485;1395;-910
17;17;0;São Caetano;620;401;219;66;120;-54
17;17;0;São Geraldo;8256;7646;610;410;1019;-609
17;17;0;São João;12041;11218;823;421;1110;-689
17;17;0;São Sebastião;6210;6041;169;702;983;-281
17;17;0;Sarandi;64273;58151;6122;-2623;1087;-3710
17;17;0;Serraria;5822;5382;440;254;627;-373
17;17;0;Sétimo Céu;697;660;37;192;266;-74
17;17;0;Teresópolis;14406;13185;1221;530;1373;-843
17;17;0;Três Figueiras;2988;2963;25;479;654;-175
17;17;0;Tristeza;16609;15391;1218;-104;949;-1053
17;17;0;Vila Assunção;3755;3568;187;168;659;-491
17;17;0;Vila Conceição;844;707;137;104;230;-126
17;17;0;Vila Ipiranga;18682;17066;1616;55;1321;-1266
17;17;0;Vila Jardim;12775;11710;1065;246;1272;-1026
17;17;0;Vila João Pessoa;12388;11444;944;452;1340;-888
17;17;0;Vila Nova;33310;30811;2499;-1374;1030;-2404
17;17;0;Vila São José;27046;24789;2257;-798;1182;-1980
18;18;0;Aberta dos Morros;6832;6411;421;49;-41;90
18;18;0;Agronomia;1854;1789;65;109;54;55
18;18;0;Anchieta;1539;1523;16;45;29;16
18;18;0;Arquipélago;8265;7753;512;-27;-34;7
18;18;0;Auxiliadora;8996;8573;423;139;-45;184
18;18;0;Azenha;13246;12595;651;260;-76;336
18;18;0;Bela Vista;11087;10538;549;99;-66;165
18;18;0;Belém Novo;10207;9488;719;37;-80;117
18;18;0;Belém Velho;10802;10045;757;-57;-47;-10
18;18;0;Boa Vista;9415;8951;464;100;-25;125
18;18;0;Boa Vista do Sul;2116;1947;169;181;64;117
18;18;0;Bom Fim;10953;10417;536;57;-100;157
18;18;0;Bom Jesus;29270;27214;2056;-524;-143;-381
18;18;0;Camaquã;17910;16735;1175;-211;-178;-33
18;18;0;Campo Novo;8518;7950;568;-12;-49;37
18;18;0;Cascata;12913;12031;882;-67;-28;-39
18;18;0;Cavalhada;30161;28089;2072;-160;-91;-69
18;18;0;Centro;41002;37957;3045;-704;-231;-473
18;18;0;Chácara das Pedras;5874;5610;264;195;-1;196
18;18;0;Chapéu do Sol;2457;2338;119;116;32;84
18;18;0;Cidade Baixa;15110;14151;959;-100;-106;6
18;18;0;Coronel Aparício Borges;19235;17891;1344;-24;0;-24
18;18;0;Costa e Silva;15403;14492;911;-82;-95;13
18;18;0;Cristal;32803;30253;2550;-748;-255;-493
18;18;0;Cristo Redentor;16324;15441;883;148;-4;152
18;18;0;Espírito Santo;5054;4754;300;108;4;104
18;18;0;Extrema;1793;1681;112;121;95;26
18;18;0;Farrapos;19477;18011;1466;-182;-142;-40
18;18;0;Farroupilha;330;330;0;-8;-8;0
18;18;0;Floresta;11180;10520;660;16;-69;85
18;18;0;Glória;16853;15679;1174;-181;-77;-104
18;18;0;Guarujá;4352;4065;287;110;2;108
18;18;0;Higienópolis;10139;9574;565;56;-52;108
18;18;0;Hípica;18905;17492;1413;-22;-86;64
18;18;0;Humaitá;11494;10656;838;-59;-76;17
18;18;0;Independência;7451;7068;383;246;-2;248
18;18;0;Ipanema;13727;12690;1037;109;49;60
18;18;0;Jardim Botânico;11924;11305;619;260;41;219
18;18;0;Jardim Carvalho;25846;23811;2035;-303;-73;-230
18;18;0;Jardim do Salso;3460;3327;133;180;67;113
18;18;0;Jardim Dona Leopoldina;17453;16379;1074;-34;-16;-18
18;18;0;Jardim Europa;1380;1379;1;-26;44;-70
18;18;0;Jardim Floresta;2598;2523;75;112;40;72
18;18;0;Jardim Isabel;2254;2141;113;91;27;64
18;18;0;Jardim Itu;17523;16355;1168;-50;-29;-21
18;18;0;Jardim Lindóia;6911;6580;331;257;53;204
18;18;0;Jardim Sabará;13017;12165;852;-65;-15;-50
18;18;0;Jardim São Pedro;3195;3059;136;149;44;105
18;18;0;Lageado;4170;3860;310;236;78;158
18;18;0;Lami;4126;3858;268;218;110;108
18;18;0;Lomba do Pinheiro;62195;56807;5388;-502;-47;-455
18;18;0;Mário Quintana;39178;36148;3030;-838;-310;-528
18;18;0;Medianeira;10499;9830;669;8;-66;74
18;18;0;Menino Deus;32601;29961;2640;-582;-211;-371
18;18;0;Moinhos de Vento;11470;10824;646;149;-15;164
18;18;0;MontSerrat;10583;9896;687;-6;-53;47
18;18;0;Morro Santana;19475;17987;1488;-7;30;-37
18;18;0;Navegantes;3771;3592;179;12;37;-25
18;18;0;Nonoai;25351;23379;1972;-242;-140;-102
18;18;0;Parque Santa Fé;5447;5165;282;177;42;135
18;18;0;Partenon;50100;45583;4517;-1232;-471;-761
18;18;0;Passo DAreia;22261;20447;1814;-111;-111;0
18;18;0;Passo das Pedras;15640;14482;1158;-15;-7;-8
18;18;0;Pedra Redonda;77;35;42;29;-13;42
18;18;0;Petrópolis;38763;35434;3329;-369;-140;-229
18;18;0;Pitinga;4072;3803;269;172;83;89
18;18;0;Ponta Grossa;8542;7960;582;136;82;54
18;18;0;Praia de Belas;1582;1500;82;77;56;21
18;18;0;Restinga;56266;52154;4112;-90;26;-116
18;18;0;Rio Branco;17358;15917;1441;-138;-157;19
18;18;0;Rubem Berta;34100;31202;2898;81;-132;213
18;18;0;Santa Cecília;4774;4409;365;199;-16;215
18;18;0;Santa Maria Goretti;2870;2622;248;265;64;201
18;18;0;Santa Rosa de Lima;36626;33699;2927;-340;-132;-208
18;18;0;Santa Tereza;40760;37247;3513;-709;-235;-474
18;18;0;Santana;20998;19046;1952;57;-21;78
18;18;0;Santo Antônio;12931;11722;1209;226;38;188
18;18;0;São Caetano;565;477;88;-55;76;-131
18;18;0;São Geraldo;8420;7686;734;164;40;124
18;18;0;São João;12284;11294;990;243;76;167
18;18;0;São Sebastião;6504;6104;400;294;63;231
18;18;0;Sarandi;63779;58070;5709;-494;-81;-413
18;18;0;Serraria;5966;5523;443;144;141;3
18;18;0;Sétimo Céu;730;661;69;33;1;32
18;18;0;Teresópolis;14599;13215;1384;193;30;163
18;18;0;Três Figueiras;3347;3041;306;359;78;281
18;18;0;Tristeza;16727;15378;1349;118;-13;131
18;18;0;Vila Assunção;4021;3645;376;266;77;189
18;18;0;Vila Conceição;946;811;135;102;104;-2
18;18;0;Vila Ipiranga;19031;17215;1816;349;149;200
18;18;0;Vila Jardim;13130;11847;1283;355;137;218
18;18;0;Vila João Pessoa;12682;11532;1150;294;88;206
18;18;0;Vila Nova;33890;30912;2978;580;101;479
18;18;0;Vila São José;27536;25040;2496;490;251;239
19;19;0;Aberta dos Morros;6822;6428;394;-10;17;-27
19;19;0;Agronomia;1837;1795;42;-17;6;-23
19;19;0;Anchieta;1547;1543;4;8;20;-12
19;19;0;Arquipélago;8290;7774;516;25;21;4
19;19;0;Auxiliadora;8981;8633;348;-15;60;-75
19;19;0;Azenha;13096;12634;462;-150;39;-189
19;19;0;Bela Vista;11041;10590;451;-46;52;-98
19;19;0;Belém Novo;10242;9509;733;35;21;14
19;19;0;Belém Velho;10852;10070;782;50;25;25
19;19;0;Boa Vista;9395;9007;388;-20;56;-76
19;19;0;Boa Vista do Sul;2127;1965;162;11;18;-7
19;19;0;Bom Fim;10910;10478;432;-43;61;-104
19;19;0;Bom Jesus;29407;27289;2118;137;75;62
19;19;0;Camaquã;17985;16808;1177;75;73;2
19;19;0;Campo Novo;8524;7966;558;6;16;-10
19;19;0;Cascata;12961;12057;904;48;26;22
19;19;0;Cavalhada;30090;28098;1992;-71;9;-80
19;19;0;Centro;41086;38051;3035;84;94;-10
19;19;0;Chácara das Pedras;5812;5638;174;-62;28;-90
19;19;0;Chapéu do Sol;2442;2349;93;-15;11;-26
19;19;0;Cidade Baixa;15141;14194;947;31;43;-12
19;19;0;Coronel Aparício Borges;19230;17939;1291;-5;48;-53
19;19;0;Costa e Silva;15493;14553;940;90;61;29
19;19;0;Cristal;33050;30343;2707;247;90;157
19;19;0;Cristo Redentor;16297;15498;799;-27;57;-84
19;19;0;Espírito Santo;5069;4781;288;15;27;-12
19;19;0;Extrema;1800;1688;112;7;7;0
19;19;0;Farrapos;19621;18102;1519;144;91;53
19;19;0;Farroupilha;400;400;0;70;70;0
19;19;0;Floresta;11155;10559;596;-25;39;-64
19;19;0;Glória;16923;15719;1204;70;40;30
19;19;0;Guarujá;4382;4102;280;30;37;-7
19;19;0;Higienópolis;10173;9642;531;34;68;-34
19;19;0;Hípica;19002;17517;1485;97;25;72
19;19;0;Humaitá;11527;10725;802;33;69;-36
19;19;0;Independência;7348;7096;252;-103;28;-131
19;19;0;Ipanema;13832;12732;1100;105;42;63
19;19;0;Jardim Botânico;11833;11336;497;-91;31;-122
19;19;0;Jardim Carvalho;26035;23898;2137;189;87;102
19;19;0;Jardim do Salso;3400;3359;41;-60;32;-92
19;19;0;Jardim Dona Leopoldina;17539;16446;1093;86;67;19
19;19;0;Jardim Europa;1436;1436;0;56;57;-1
19;19;0;Jardim Floresta;2569;2569;0;-29;46;-75
19;19;0;Jardim Isabel;2208;2156;52;-46;15;-61
19;19;0;Jardim Itu;17662;16451;1211;139;96;43
19;19;0;Jardim Lindóia;6852;6615;237;-59;35;-94
19;19;0;Jardim Sabará;13123;12225;898;106;60;46
19;19;0;Jardim São Pedro;3164;3105;59;-31;46;-77
19;19;0;Lageado;4179;3883;296;9;23;-14
19;19;0;Lami;4142;3872;270;16;14;2
19;19;0;Lomba do Pinheiro;62069;56818;5251;-126;11;-137
19;19;0;Mário Quintana;39442;36288;3154;264;140;124
19;19;0;Medianeira;10553;9903;650;54;73;-19
19;19;0;Menino Deus;32786;30070;2716;185;109;76
19;19;0;Moinhos de Vento;11469;10861;608;-1;37;-38
19;19;0;MontSerrat;10571;9945;626;-12;49;-61
19;19;0;Morro Santana;19631;18025;1606;156;38;118
19;19;0;Navegantes;3715;3621;94;-56;29;-85
19;19;0;Nonoai;25426;23399;2027;75;20;55
19;19;0;Parque Santa Fé;5429;5220;209;-18;55;-73
19;19;0;Partenon;50377;45720;4657;277;137;140
19;19;0;Passo DAreia;22360;20507;1853;99;60;39
19;19;0;Passo das Pedras;15662;14569;1093;22;87;-65
19;19;0;Pedra Redonda;59;56;3;-18;21;-39
19;19;0;Petrópolis;38914;35540;3374;151;106;45
19;19;0;Pitinga;4097;3807;290;25;4;21
19;19;0;Ponta Grossa;8560;7951;609;18;-9;27
19;19;0;Praia de Belas;1517;1517;0;-65;17;-82
19;19;0;Restinga;55915;52124;3791;-351;-30;-321
19;19;0;Rio Branco;17465;16037;1428;107;120;-13
19;19;0;Rubem Berta;33941;31197;2744;-159;-5;-154
19;19;0;Santa Cecília;4714;4471;243;-60;62;-122
19;19;0;Santa Maria Goretti;2808;2663;145;-62;41;-103
19;19;0;Santa Rosa de Lima;36576;33761;2815;-50;62;-112
19;19;0;Santa Tereza;40812;37334;3478;52;87;-35
19;19;0;Santana;21018;19096;1922;20;50;-30
19;19;0;Santo Antônio;12872;11742;1130;-59;20;-79
19;19;0;São Caetano;573;481;92;8;4;4
19;19;0;São Geraldo;8382;7707;675;-38;21;-59
19;19;0;São João;12257;11321;936;-27;27;-54
19;19;0;São Sebastião;6453;6143;310;-51;39;-90
19;19;0;Sarandi;63368;58062;5306;-411;-8;-403
19;19;0;Serraria;5967;5495;472;1;-28;29
19;19;0;Sétimo Céu;721;663;58;-9;2;-11
19;19;0;Teresópolis;14507;13202;1305;-92;-13;-79
19;19;0;Três Figueiras;3213;3059;154;-134;18;-152
19;19;0;Tristeza;16721;15349;1372;-6;-29;23
19;19;0;Vila Assunção;4024;3648;376;3;3;0
19;19;0;Vila Conceição;945;807;138;-1;-4;3
19;19;0;Vila Ipiranga;18834;17120;1714;-197;-95;-102
19;19;0;Vila Jardim;12961;11772;1189;-169;-75;-94
19;19;0;Vila João Pessoa;12695;11539;1156;13;7;6
19;19;0;Vila Nova;33573;30856;2717;-317;-56;-261
19;19;0;Vila São José;27367;24946;2421;-169;-94;-75
20;20;0;Aberta dos Morros;7124;6902;222;302;474;-172
20;20;0;Agronomia;2532;2226;306;695;431;264
20;20;0;Anchieta;2146;1933;213;599;390;209
20;20;0;Arquipélago;8506;8248;258;216;474;-258
20;20;0;Auxiliadora;9501;9452;49;520;819;-299
20;20;0;Azenha;13524;13524;0;428;890;-462
20;20;0;Bela Vista;11569;11523;46;528;933;-405
20;20;0;Belém Novo;10261;9904;357;19;395;-376
20;20;0;Belém Velho;10961;10642;319;109;572;-463
20;20;0;Boa Vista;9887;9820;67;492;813;-321
20;20;0;Boa Vista do Sul;2440;2125;315;313;160;153
20;20;0;Bom Fim;11408;11354;54;498;876;-378
20;20;0;Bom Jesus;28563;28347;216;-844;1058;-1902
20;20;0;Camaquã;17817;17606;211;-168;798;-966
20;20;0;Campo Novo;8747;8511;236;223;545;-322
20;20;0;Cascata;13069;12782;287;108;725;-617
20;20;0;Cavalhada;29174;28995;179;-916;897;-1813
20;20;0;Centro;39178;38957;221;-1908;906;-2814
20;20;0;Chácara das Pedras;6532;6438;94;720;800;-80
20;20;0;Chapéu do Sol;2925;2685;240;483;336;147
20;20;0;Cidade Baixa;15285;15151;134;144;957;-813
20;20;0;Coronel Aparício Borges;19201;18977;224;-29;1038;-1067
20;20;0;Costa e Silva;15699;15538;161;206;985;-779
20;20;0;Cristal;32130;31504;626;-920;1161;-2081
20;20;0;Cristo Redentor;16218;16214;4;-79;716;-795
20;20;0;Espírito Santo;5429;5259;170;360;478;-118
20;20;0;Extrema;2130;1846;284;330;158;172
20;20;0;Farrapos;19230;18806;424;-391;704;-1095
20;20;0;Farroupilha;996;833;163;596;433;163
20;20;0;Floresta;11495;11374;121;340;815;-475
20;20;0;Glória;16913;16719;194;-10;1000;-1010
20;20;0;Guarujá;4803;4539;264;421;437;-16
20;20;0;Higienópolis;10549;10451;98;376;809;-433
20;20;0;Hípica;18626;18194;432;-376;677;-1053
20;20;0;Humaitá;11632;11328;304;105;603;-498
20;20;0;Independência;7962;7903;59;614;807;-193
20;20;0;Ipanema;13702;13354;348;-130;622;-752
20;20;0;Jardim Botânico;12235;12209;26;402;873;-471
20;20;0;Jardim Carvalho;25443;25038;405;-592;1140;-1732
20;20;0;Jardim do Salso;4363;4169;194;963;810;153
20;20;0;Jardim Dona Leopoldina;17800;17605;195;261;1159;-898
20;20;0;Jardim Europa;2179;2051;128;743;615;128
20;20;0;Jardim Floresta;3270;3102;168;701;533;168
20;20;0;Jardim Isabel;2786;2577;209;578;421;157
20;20;0;Jardim Itu;17637;17470;167;-25;1019;-1044
20;20;0;Jardim Lindóia;7289;7205;84;437;590;-153
20;20;0;Jardim Sabará;13348;13189;159;225;964;-739
20;20;0;Jardim São Pedro;3940;3748;192;776;643;133
20;20;0;Lageado;4542;4236;306;363;353;10
20;20;0;Lami;4376;4094;282;234;222;12
20;20;0;Lomba do Pinheiro;59021;57846;1175;-3048;1028;-4076
20;20;0;Mário Quintana;38297;37582;715;-1145;1294;-2439
20;20;0;Medianeira;11004;10881;123;451;978;-527
20;20;0;Menino Deus;31606;31258;348;-1180;1188;-2368
20;20;0;Moinhos de Vento;11754;11672;82;285;811;-526
20;20;0;MontSerrat;11092;10918;174;521;973;-452
20;20;0;Morro Santana;19427;18978;449;-204;953;-1157
20;20;0;Navegantes;4348;4155;193;633;534;99
20;20;0;Nonoai;25114;24658;456;-312;1259;-1571
20;20;0;Parque Santa Fé;6239;6059;180;810;839;-29
20;20;0;Partenon;48464;47351;1113;-1913;1631;-3544
20;20;0;Passo DAreia;21893;21582;311;-467;1075;-1542
20;20;0;Passo das Pedras;15793;15554;239;131;985;-854
20;20;0;Pedra Redonda;336;105;231;277;49;228
20;20;0;Petrópolis;37541;36891;650;-1373;1351;-2724
20;20;0;Pitinga;4540;4183;357;443;376;67
20;20;0;Ponta Grossa;8732;8351;381;172;400;-228
20;20;0;Praia de Belas;2401;2134;267;884;617;267
20;20;0;Restinga;53596;52859;737;-2319;735;-3054
20;20;0;Rio Branco;17302;17076;226;-163;1039;-1202
20;20;0;Rubem Berta;33417;32626;791;-524;1429;-1953
20;20;0;Santa Cecília;5712;5419;293;998;948;50
20;20;0;Santa Maria Goretti;3571;3270;301;763;607;156
20;20;0;Santa Rosa de Lima;35763;34874;889;-813;1113;-1926
20;20;0;Santa Tereza;39834;38809;1025;-978;1475;-2453
20;20;0;Santana;20542;20228;314;-476;1132;-1608
20;20;0;Santo Antônio;13000;12701;299;128;959;-831
20;20;0;São Caetano;883;595;288;310;114;196
20;20;0;São Geraldo;8744;8434;310;362;727;-365
20;20;0;São João;12176;11969;207;-81;648;-729
20;20;0;São Sebastião;6978;6793;185;525;650;-125
20;20;0;Sarandi;60211;59076;1135;-3157;1014;-4171
20;20;0;Serraria;6278;5851;427;311;356;-45
20;20;0;Sétimo Céu;1219;1028;191;498;365;133
20;20;0;Teresópolis;14617;14196;421;110;994;-884
20;20;0;Três Figueiras;4025;3756;269;812;697;115
20;20;0;Tristeza;16596;16120;476;-125;771;-896
20;20;0;Vila Assunção;4588;4137;451;564;489;75
20;20;0;Vila Conceição;1488;1121;367;543;314;229
20;20;0;Vila Ipiranga;18673;18195;478;-161;1075;-1236
20;20;0;Vila Jardim;13197;12738;459;236;966;-730
20;20;0;Vila João Pessoa;12945;12580;365;250;1041;-791
20;20;0;Vila Nova;32543;31667;876;-1030;811;-1841
20;20;0;Vila São José;26779;25947;832;-588;1001;-1589
21;21;0;Aberta dos Morros;7121;6961;160;-3;59;-62
21;21;0;Agronomia;2488;2251;237;-44;25;-69
21;21;0;Anchieta;2132;1976;156;-14;43;-57
21;21;0;Arquipélago;8443;8275;168;-63;27;-90
21;21;0;Auxiliadora;9571;9560;11;70;108;-38
21;21;0;Azenha;13623;13623;0;99;99;0
21;21;0;Bela Vista;11635;11619;16;66;96;-30
21;21;0;Belém Novo;10179;9952;227;-82;48;-130
21;21;0;Belém Velho;10889;10688;201;-72;46;-118
21;21;0;Boa Vista;9919;9910;9;32;90;-58
21;21;0;Boa Vista do Sul;2438;2153;285;-2;28;-30
21;21;0;Bom Fim;11442;11436;6;34;82;-48
21;21;0;Bom Jesus;28765;28462;303;202;115;87
21;21;0;Camaquã;17833;17686;147;16;80;-64
21;21;0;Campo Novo;8725;8561;164;-22;50;-72
21;21;0;Cascata;13044;12858;186;-25;76;-101
21;21;0;Cavalhada;29200;29083;117;26;88;-62
21;21;0;Centro;39352;39035;317;174;78;96
21;21;0;Chácara das Pedras;6516;6506;10;-16;68;-84
21;21;0;Chapéu do Sol;2925;2739;186;0;54;-54
21;21;0;Cidade Baixa;15293;15226;67;8;75;-67
21;21;0;Coronel Aparício Borges;19247;19066;181;46;89;-43
21;21;0;Costa e Silva;15710;15642;68;11;104;-93
21;21;0;Cristal;31976;31666;310;-154;162;-316
21;21;0;Cristo Redentor;16344;16318;26;126;104;22
21;21;0;Espírito Santo;5482;5340;142;53;81;-28
21;21;0;Extrema;2146;1864;282;16;18;-2
21;21;0;Farrapos;19121;18894;227;-109;88;-197
21;21;0;Farroupilha;921;856;65;-75;23;-98
21;21;0;Floresta;11484;11454;30;-11;80;-91
21;21;0;Glória;16990;16834;156;77;115;-38
21;21;0;Guarujá;4828;4618;210;25;79;-54
21;21;0;Higienópolis;10606;10569;37;57;118;-61
21;21;0;Hípica;18585;18317;268;-41;123;-164
21;21;0;Humaitá;11583;11408;175;-49;80;-129
21;21;0;Independência;7980;7979;1;18;76;-58
21;21;0;Ipanema;13725;13473;252;23;119;-96
21;21;0;Jardim Botânico;12329;12328;1;94;119;-25
21;21;0;Jardim Carvalho;25460;25168;292;17;130;-113
21;21;0;Jardim do Salso;4345;4246;99;-18;77;-95
21;21;0;Jardim Dona Leopoldina;17842;17746;96;42;141;-99
21;21;0;Jardim Europa;2226;2154;72;47;103;-56
21;21;0;Jardim Floresta;3298;3198;100;28;96;-68
21;21;0;Jardim Isabel;2780;2624;156;-6;47;-53
21;21;0;Jardim Itu;17764;17637;127;127;167;-40
21;21;0;Jardim Lindóia;7303;7296;7;14;91;-77
21;21;0;Jardim Sabará;13456;13339;117;108;150;-42
21;21;0;Jardim São Pedro;3928;3830;98;-12;82;-94
21;21;0;Lageado;4536;4290;246;-6;54;-60
21;21;0;Lami;4382;4122;260;6;28;-22
21;21;0;Lomba do Pinheiro;58727;57927;800;-294;81;-375
21;21;0;Mário Quintana;38300;37811;489;3;229;-226
21;21;0;Medianeira;11065;10995;70;61;114;-53
21;21;0;Menino Deus;31796;31398;398;190;140;50
21;21;0;Moinhos de Vento;11805;11765;40;51;93;-42
21;21;0;MontSerrat;11074;11033;41;-18;115;-133
21;21;0;Morro Santana;19408;19138;270;-19;160;-179
21;21;0;Navegantes;4302;4208;94;-46;53;-99
21;21;0;Nonoai;25100;24834;266;-14;176;-190
21;21;0;Parque Santa Fé;6294;6192;102;55;133;-78
21;21;0;Partenon;48440;47725;715;-24;374;-398
21;21;0;Passo DAreia;21992;21762;230;99;180;-81
21;21;0;Passo das Pedras;15842;15706;136;49;152;-103
21;21;0;Pedra Redonda;334;130;204;-2;25;-27
21;21;0;Petrópolis;37589;37149;440;48;258;-210
21;21;0;Pitinga;4522;4216;306;-18;33;-51
21;21;0;Ponta Grossa;8722;8455;267;-10;104;-114
21;21;0;Praia de Belas;2293;2177;116;-108;43;-151
21;21;0;Restinga;53546;53054;492;-50;195;-245
21;21;0;Rio Branco;17524;17275;249;222;199;23
21;21;0;Rubem Berta;33309;32835;474;-108;209;-317
21;21;0;Santa Cecília;5620;5534;86;-92;115;-207
21;21;0;Santa Maria Goretti;3539;3375;164;-32;105;-137
21;21;0;Santa Rosa de Lima;35592;35086;506;-171;212;-383
21;21;0;Santa Tereza;39780;39108;672;-54;299;-353
21;21;0;Santana;20731;20426;305;189;198;-9
21;21;0;Santo Antônio;12981;12868;113;-19;167;-186
21;21;0;São Caetano;909;619;290;26;24;2
21;21;0;São Geraldo;8671;8528;143;-73;94;-167
21;21;0;São João;12151;12088;63;-25;119;-144
21;21;0;São Sebastião;6922;6886;36;-56;93;-149
21;21;0;Sarandi;59945;59367;578;-266;291;-557
21;21;0;Serraria;6308;5968;340;30;117;-87
21;21;0;Sétimo Céu;1232;1073;159;13;45;-32
21;21;0;Teresópolis;14602;14385;217;-15;189;-204
21;21;0;Três Figueiras;3967;3874;93;-58;118;-176
21;21;0;Tristeza;16644;16314;330;48;194;-146
21;21;0;Vila Assunção;4542;4211;331;-46;74;-120
21;21;0;Vila Conceição;1508;1162;346;20;41;-21
21;21;0;Vila Ipiranga;18630;18382;248;-43;187;-230
21;21;0;Vila Jardim;13169;12945;224;-28;207;-235
21;21;0;Vila João Pessoa;12888;12721;167;-57;141;-198
21;21;0;Vila Nova;32461;31951;510;-82;284;-366
21;21;0;Vila São José;26665;26142;523;-114;195;-309
22;22;0;Aberta dos Morros;7147;6964;183;26;3;23
22;22;0;Agronomia;2555;2264;291;67;13;54
22;22;0;Anchieta;2177;1958;219;45;-18;63
22;22;0;Arquipélago;8420;8248;172;-23;-27;4
22;22;0;Auxiliadora;9631;9480;151;60;-80;140
22;22;0;Azenha;13726;13576;150;103;-47;150
22;22;0;Bela Vista;11713;11553;160;78;-66;144
22;22;0;Belém Novo;10197;9954;243;18;2;16
22;22;0;Belém Velho;10885;10685;200;-4;-3;-1
22;22;0;Boa Vista;10008;9847;161;89;-63;152
22;22;0;Boa Vista do Sul;2472;2154;318;34;1;33
22;22;0;Bom Fim;11504;11362;142;62;-74;136
22;22;0;Bom Jesus;28628;28446;182;-137;-16;-121
22;22;0;Camaquã;17823;17662;161;-10;-24;14
22;22;0;Campo Novo;8740;8576;164;15;15;0
22;22;0;Cascata;13010;12842;168;-34;-16;-18
22;22;0;Cavalhada;29271;29066;205;71;-17;88
22;22;0;Centro;39298;38985;313;-54;-50;-4
22;22;0;Chácara das Pedras;6634;6479;155;118;-27;145
22;22;0;Chapéu do Sol;2970;2745;225;45;6;39
22;22;0;Cidade Baixa;15369;15192;177;76;-34;110
22;22;0;Coronel Aparício Borges;19250;19071;179;3;5;-2
22;22;0;Costa e Silva;15796;15639;157;86;-3;89
22;22;0;Cristal;31914;31686;228;-62;20;-82
22;22;0;Cristo Redentor;16410;16243;167;66;-75;141
22;22;0;Espírito Santo;5506;5354;152;24;14;10
22;22;0;Extrema;2159;1858;301;13;-6;19
22;22;0;Farrapos;19050;18859;191;-71;-35;-36
22;22;0;Farroupilha;933;779;154;12;-77;89
22;22;0;Floresta;11557;11394;163;73;-60;133
22;22;0;Glória;17054;16848;206;64;14;50
22;22;0;Guarujá;4855;4630;225;27;12;15
22;22;0;Higienópolis;10687;10521;166;81;-48;129
22;22;0;Hípica;18616;18388;228;31;71;-40
22;22;0;Humaitá;11574;11388;186;-9;-20;11
22;22;0;Independência;8085;7914;171;105;-65;170
22;22;0;Ipanema;13671;13473;198;-54;0;-54
22;22;0;Jardim Botânico;12475;12304;171;146;-24;170
22;22;0;Jardim Carvalho;25419;25187;232;-41;19;-60
22;22;0;Jardim do Salso;4392;4244;148;47;-2;49
22;22;0;Jardim Dona Leopoldina;17929;17792;137;87;46;41
22;22;0;Jardim Europa;2253;2106;147;27;-48;75
22;22;0;Jardim Floresta;3296;3149;147;-2;-49;47
22;22;0;Jardim Isabel;2797;2617;180;17;-7;24
22;22;0;Jardim Itu;17788;17618;170;24;-19;43
22;22;0;Jardim Lindóia;7403;7252;151;100;-44;144
22;22;0;Jardim Sabará;13488;13323;165;32;-16;48
22;22;0;Jardim São Pedro;3928;3781;147;0;-49;49
22;22;0;Lageado;4550;4294;256;14;4;10
22;22;0;Lami;4385;4099;286;3;-23;26
22;22;0;Lomba do Pinheiro;58465;57949;516;-262;22;-284
22;22;0;Mário Quintana;38166;37881;285;-134;70;-204
22;22;0;Medianeira;11157;10991;166;92;-4;96
22;22;0;Menino Deus;31620;31366;254;-176;-32;-144
22;22;0;Moinhos de Vento;11873;11689;184;68;-76;144
22;22;0;MontSerrat;11163;11002;161;89;-31;120
22;22;0;Morro Santana;19387;19165;222;-21;27;-48
22;22;0;Navegantes;4322;4176;146;20;-32;52
22;22;0;Nonoai;25081;24866;215;-19;32;-51
22;22;0;Parque Santa Fé;6360;6222;138;66;30;36
22;22;0;Partenon;48170;47743;427;-270;18;-288
22;22;0;Passo DAreia;21915;21713;202;-77;-49;-28
22;22;0;Passo das Pedras;15906;15734;172;64;28;36
22;22;0;Pedra Redonda;407;139;268;73;9;64
22;22;0;Petrópolis;37407;37142;265;-182;-7;-175
22;22;0;Pitinga;4539;4231;308;17;15;2
22;22;0;Ponta Grossa;8767;8481;286;45;26;19
22;22;0;Praia de Belas;2338;2167;171;45;-10;55
22;22;0;Restinga;53297;53092;205;-249;38;-287
22;22;0;Rio Branco;17422;17207;215;-102;-68;-34
22;22;0;Rubem Berta;33201;32886;315;-108;51;-159
22;22;0;Santa Cecília;5663;5501;162;43;-33;76
22;22;0;Santa Maria Goretti;3511;3340;171;-28;-35;7
22;22;0;Santa Rosa de Lima;35424;35095;329;-168;9;-177
22;22;0;Santa Tereza;39612;39145;467;-168;37;-205
22;22;0;Santana;20641;20382;259;-90;-44;-46
22;22;0;Santo Antônio;13074;12887;187;93;19;74
22;22;0;São Caetano;885;580;305;-24;-39;15
22;22;0;São Geraldo;8642;8484;158;-29;-44;15
22;22;0;São João;12221;12039;182;70;-49;119
22;22;0;São Sebastião;6992;6853;139;70;-33;103
22;22;0;Sarandi;59761;59392;369;-184;25;-209
22;22;0;Serraria;6321;5992;329;13;24;-11
22;22;0;Sétimo Céu;1263;1077;186;31;4;27
22;22;0;Teresópolis;14630;14403;227;28;18;10
22;22;0;Três Figueiras;4021;3866;155;54;-8;62
22;22;0;Tristeza;16623;16320;303;-21;6;-27
22;22;0;Vila Assunção;4489;4222;267;-53;11;-64
22;22;0;Vila Conceição;1501;1145;356;-7;-17;10
22;22;0;Vila Ipiranga;18577;18368;209;-53;-14;-39
22;22;0;Vila Jardim;13158;12954;204;-11;9;-20
22;22;0;Vila João Pessoa;12946;12766;180;58;45;13
22;22;0;Vila Nova;32360;31989;371;-101;38;-139
22;22;0;Vila São José;26675;26221;454;10;79;-69
23;23;0;Aberta dos Morros;7146;7146;0;-1;182;-183
23;23;0;Agronomia;2331;2331;0;-224;67;-291
23;23;0;Anchieta;2024;2024;0;-153;66;-219
23;23;0;Arquipélago;8330;8330;0;-90;82;-172
23;23;0;Auxiliadora;9683;9683;0;52;203;-151
23;23;0;Azenha;13804;13804;0;78;228;-150
23;23;0;Bela Vista;11787;11787;0;74;234;-160
23;23;0;Belém Novo;10100;10100;0;-97;146;-243
23;23;0;Belém Velho;10835;10835;0;-50;150;-200
23;23;0;Boa Vista;10053;10053;0;45;206;-161
23;23;0;Boa Vista do Sul;2309;2309;0;-163;155;-318
23;23;0;Bom Fim;11593;11593;0;89;231;-142
23;23;0;Bom Jesus;28675;28675;0;47;229;-182
23;23;0;Camaquã;17938;17938;0;115;276;-161
23;23;0;Campo Novo;8766;8766;0;26;190;-164
23;23;0;Cascata;13013;13013;0;3;171;-168
23;23;0;Cavalhada;29299;29299;0;28;233;-205
23;23;0;Centro;39154;39154;0;-144;169;-313
23;23;0;Chácara das Pedras;6668;6668;0;34;189;-155
23;23;0;Chapéu do Sol;2913;2913;0;-57;168;-225
23;23;0;Cidade Baixa;15379;15379;0;10;187;-177
23;23;0;Coronel Aparício Borges;19303;19303;0;53;232;-179
23;23;0;Costa e Silva;15842;15842;0;46;203;-157
23;23;0;Cristal;31946;31946;0;32;260;-228
23;23;0;Cristo Redentor;16455;16455;0;45;212;-167
23;23;0;Espírito Santo;5606;5606;0;100;252;-152
23;23;0;Extrema;1981;1981;0;-178;123;-301
23;23;0;Farrapos;18986;18986;0;-64;127;-191
23;23;0;Farroupilha;961;961;0;28;182;-154
23;23;0;Floresta;11596;11596;0;39;202;-163
23;23;0;Glória;17067;17067;0;13;219;-206
23;23;0;Guarujá;4811;4811;0;-44;181;-225
23;23;0;Higienópolis;10724;10724;0;37;203;-166
23;23;0;Hípica;18645;18645;0;29;257;-228
23;23;0;Humaitá;11502;11502;0;-72;114;-186
23;23;0;Independência;8112;8112;0;27;198;-171
23;23;0;Ipanema;13728;13728;0;57;255;-198
23;23;0;Jardim Botânico;12521;12521;0;46;217;-171
23;23;0;Jardim Carvalho;25386;25386;0;-33;199;-232
23;23;0;Jardim do Salso;4405;4405;0;13;161;-148
23;23;0;Jardim Dona Leopoldina;18016;18016;0;87;224;-137
23;23;0;Jardim Europa;2299;2299;0;46;193;-147
23;23;0;Jardim Floresta;3307;3307;0;11;158;-147
23;23;0;Jardim Isabel;2835;2835;0;38;218;-180
23;23;0;Jardim Itu;17853;17853;0;65;235;-170
23;23;0;Jardim Lindóia;7417;7417;0;14;165;-151
23;23;0;Jardim Sabará;13530;13530;0;42;207;-165
23;23;0;Jardim São Pedro;3967;3967;0;39;186;-147
23;23;0;Lageado;4481;4481;0;-69;187;-256
23;23;0;Lami;4289;4289;0;-96;190;-286
23;23;0;Lomba do Pinheiro;58106;58106;0;-359;157;-516
23;23;0;Mário Quintana;38116;38116;0;-50;235;-285
23;23;0;Medianeira;11223;11223;0;66;232;-166
23;23;0;Menino Deus;31650;31650;0;30;284;-254
23;23;0;Moinhos de Vento;11937;11937;0;64;248;-184
23;23;0;MontSerrat;11236;11236;0;73;234;-161
23;23;0;Morro Santana;19338;19338;0;-49;173;-222
23;23;0;Navegantes;4327;4327;0;5;151;-146
23;23;0;Nonoai;25160;25160;0;79;294;-215
23;23;0;Parque Santa Fé;6376;6376;0;16;154;-138
23;23;0;Partenon;48160;48160;0;-10;417;-427
23;23;0;Passo DAreia;21968;21968;0;53;255;-202
23;23;0;Passo das Pedras;15902;15902;0;-4;168;-172
23;23;0;Pedra Redonda;274;274;0;-133;135;-268
23;23;0;Petrópolis;37496;37496;0;89;354;-265
23;23;0;Pitinga;4352;4352;0;-187;121;-308
23;23;0;Ponta Grossa;8722;8722;0;-45;241;-286
23;23;0;Praia de Belas;2281;2281;0;-57;114;-171
23;23;0;Restinga;53508;53508;0;211;416;-205
23;23;0;Rio Branco;17531;17531;0;109;324;-215
23;23;0;Rubem Berta;33168;33168;0;-33;282;-315
23;23;0;Santa Cecília;5768;5768;0;105;267;-162
23;23;0;Santa Maria Goretti;3509;3509;0;-2;169;-171
23;23;0;Santa Rosa de Lima;35333;35333;0;-91;238;-329
23;23;0;Santa Tereza;39577;39577;0;-35;432;-467
23;23;0;Santana;20723;20723;0;82;341;-259
23;23;0;Santo Antônio;13161;13161;0;87;274;-187
23;23;0;São Caetano;757;757;0;-128;177;-305
23;23;0;São Geraldo;8681;8681;0;39;197;-158
23;23;0;São João;12226;12226;0;5;187;-182
23;23;0;São Sebastião;7019;7019;0;27;166;-139
23;23;0;Sarandi;59711;59711;0;-50;319;-369
23;23;0;Serraria;6239;6239;0;-82;247;-329
23;23;0;Sétimo Céu;1329;1329;0;66;252;-186
23;23;0;Teresópolis;14707;14707;0;77;304;-227
23;23;0;Três Figueiras;4070;4070;0;49;204;-155
23;23;0;Tristeza;16692;16692;0;69;372;-303
23;23;0;Vila Assunção;4418;4418;0;-71;196;-267
23;23;0;Vila Conceição;1349;1349;0;-152;204;-356
23;23;0;Vila Ipiranga;18659;18659;0;82;291;-209
23;23;0;Vila Jardim;13189;13189;0;31;235;-204
23;23;0;Vila João Pessoa;13041;13041;0;95;275;-180
23;23;0;Vila Nova;32469;32469;0;109;480;-371
23;23;0;Vila São José;26522;26522;0;-153;301;-454
24;0;1;Aberta dos Morros;7116;7084;32;-30;-62;32
24;0;1;Agronomia;2336;2300;36;5;-31;36
24;0;1;Anchieta;2022;1976;46;-2;-48;46
24;0;1;Arquipélago;8335;8292;43;5;-38;43
24;0;1;Auxiliadora;9616;9555;61;-67;-128;61
24;0;1;Azenha;13733;13636;97;-71;-168;97
24;0;1;Bela Vista;11713;11651;62;-74;-136;62
24;0;1;Belém Novo;10085;10070;15;-15;-30;15
24;0;1;Belém Velho;10833;10793;40;-2;-42;40
24;0;1;Boa Vista;9999;9936;63;-54;-117;63
24;0;1;Boa Vista do Sul;2284;2269;15;-25;-40;15
24;0;1;Bom Fim;11470;11429;41;-123;-164;41
24;0;1;Bom Jesus;28646;28588;58;-29;-87;58
24;0;1;Camaquã;17902;17854;48;-36;-84;48
24;0;1;Campo Novo;8751;8710;41;-15;-56;41
24;0;1;Cascata;13004;12955;49;-9;-58;49
24;0;1;Cavalhada;29269;29217;52;-30;-82;52
24;0;1;Centro;39192;39075;117;38;-79;117
24;0;1;Chácara das Pedras;6637;6573;64;-31;-95;64
24;0;1;Chapéu do Sol;2900;2870;30;-13;-43;30
24;0;1;Cidade Baixa;15305;15243;62;-74;-136;62
24;0;1;Coronel Aparício Borges;19271;19212;59;-32;-91;59
24;0;1;Costa e Silva;15834;15779;55;-8;-63;55
24;0;1;Cristal;31929;31879;50;-17;-67;50
24;0;1;Cristo Redentor;16468;16320;148;13;-135;148
24;0;1;Espírito Santo;5584;5537;47;-22;-69;47
24;0;1;Extrema;1977;1968;9;-4;-13;9
24;0;1;Farrapos;19003;18948;55;17;-38;55
24;0;1;Farroupilha;957;811;146;-4;-150;146
24;0;1;Floresta;11545;11481;64;-51;-115;64
24;0;1;Glória;17106;16979;127;39;-88;127
24;0;1;Guarujá;4796;4747;49;-15;-64;49
24;0;1;Higienópolis;10692;10627;65;-32;-97;65
24;0;1;Hípica;18635;18592;43;-10;-53;43
24;0;1;Humaitá;11525;11465;60;23;-37;60
24;0;1;Independência;8139;7984;155;27;-128;155
24;0;1;Ipanema;13712;13663;49;-16;-65;49
24;0;1;Jardim Botânico;12551;12406;145;30;-115;145
24;0;1;Jardim Carvalho;25466;25327;139;80;-59;139
24;0;1;Jardim do Salso;4395;4329;66;-10;-76;66
24;0;1;Jardim Dona Leopoldina;18004;17947;57;-12;-69;57
24;0;1;Jardim Europa;2274;2204;70;-25;-95;70
24;0;1;Jardim Floresta;3290;3225;65;-17;-82;65
24;0;1;Jardim Isabel;2809;2756;53;-26;-79;53
24;0;1;Jardim Itu;17840;17777;63;-13;-76;63
24;0;1;Jardim Lindóia;7402;7332;70;-15;-85;70
24;0;1;Jardim Sabará;13521;13454;67;-9;-76;67
24;0;1;Jardim São Pedro;3948;3879;69;-19;-88;69
24;0;1;Lageado;4485;4451;34;4;-30;34
24;0;1;Lami;4284;4262;22;-5;-27;22
24;0;1;Lomba do Pinheiro;58134;58086;48;28;-20;48
24;0;1;Mário Quintana;38124;38066;58;8;-50;58
24;0;1;Medianeira;11183;11119;64;-40;-104;64
24;0;1;Menino Deus;31704;31545;159;54;-105;159
24;0;1;Moinhos de Vento;11995;11823;172;58;-114;172
24;0;1;MontSerrat;11189;11119;70;-47;-117;70
24;0;1;Morro Santana;19351;19289;62;13;-49;62
24;0;1;Navegantes;4337;4271;66;10;-56;66
24;0;1;Nonoai;25140;25080;60;-20;-80;60
24;0;1;Parque Santa Fé;6374;6312;62;-2;-64;62
24;0;1;Partenon;48146;48078;68;-14;-82;68
24;0;1;Passo DAreia;21949;21875;74;-19;-93;74
24;0;1;Passo das Pedras;15907;15840;67;5;-62;67
24;0;1;Pedra Redonda;251;195;56;-23;-79;56
24;0;1;Petrópolis;37468;37397;71;-28;-99;71
24;0;1;Pitinga;4373;4337;36;21;-15;36
24;0;1;Ponta Grossa;8735;8695;40;13;-27;40
24;0;1;Praia de Belas;2270;2202;68;-11;-79;68
24;0;1;Restinga;53594;53489;105;86;-19;105
24;0;1;Rio Branco;17588;17401;187;57;-130;187
24;0;1;Rubem Berta;33182;33113;69;14;-55;69
24;0;1;Santa Cecília;5837;5650;187;69;-118;187
24;0;1;Santa Maria Goretti;3513;3440;73;4;-69;73
24;0;1;Santa Rosa de Lima;35364;35305;59;31;-28;59
24;0;1;Santa Tereza;39573;39510;63;-4;-67;63
24;0;1;Santana;20803;20610;193;80;-113;193
24;0;1;Santo Antônio;13150;13071;79;-11;-90;79
24;0;1;São Caetano;774;738;36;17;-19;36
24;0;1;São Geraldo;8691;8613;78;10;-68;78
24;0;1;São João;12244;12162;82;18;-64;82
24;0;1;São Sebastião;7027;6953;74;8;-66;74
24;0;1;Sarandi;59734;59664;70;23;-47;70
24;0;1;Serraria;6255;6202;53;16;-37;53
24;0;1;Sétimo Céu;1308;1252;56;-21;-77;56
24;0;1;Teresópolis;14817;14641;176;110;-66;176
24;0;1;Três Figueiras;4070;3991;79;0;-79;79
24;0;1;Tristeza;16670;16614;56;-22;-78;56
24;0;1;Vila Assunção;4531;4381;150;113;-37;150
24;0;1;Vila Conceição;1366;1305;61;17;-44;61
24;0;1;Vila Ipiranga;18661;18582;79;2;-77;79
24;0;1;Vila Jardim;13196;13116;80;7;-73;80
24;0;1;Vila João Pessoa;13054;12978;76;13;-63;76
24;0;1;Vila Nova;32581;32426;155;112;-43;155
24;0;1;Vila São José;26548;26475;73;26;-47;73
25;1;1;Aberta dos Morros;7111;7074;37;-5;-10;5
25;1;1;Agronomia;2324;2286;38;-12;-14;2
25;1;1;Anchieta;2019;1972;47;-3;-4;1
25;1;1;Arquipélago;8341;8286;55;6;-6;12
25;1;1;Auxiliadora;9602;9535;67;-14;-20;6
25;1;1;Azenha;13740;13606;134;7;-30;37
25;1;1;Bela Vista;11705;11633;72;-8;-18;10
25;1;1;Belém Novo;10085;10066;19;0;-4;4
25;1;1;Belém Velho;10829;10778;51;-4;-15;11
25;1;1;Boa Vista;9993;9918;75;-6;-18;12
25;1;1;Boa Vista do Sul;2281;2264;17;-3;-5;2
25;1;1;Bom Fim;11443;11403;40;-27;-26;-1
25;1;1;Bom Jesus;28663;28568;95;17;-20;37
25;1;1;Camaquã;17906;17833;73;4;-21;25
25;1;1;Campo Novo;8745;8697;48;-6;-13;7
25;1;1;Cascata;13001;12933;68;-3;-22;19
25;1;1;Cavalhada;29279;29195;84;10;-22;32
25;1;1;Centro;39285;39069;216;93;-6;99
25;1;1;Chácara das Pedras;6615;6545;70;-22;-28;6
25;1;1;Chapéu do Sol;2890;2857;33;-10;-13;3
25;1;1;Cidade Baixa;15299;15226;73;-6;-17;11
25;1;1;Coronel Aparício Borges;19258;19183;75;-13;-29;16
25;1;1;Costa e Silva;15820;15749;71;-14;-30;16
25;1;1;Cristal;31954;31866;88;25;-13;38
25;1;1;Cristo Redentor;16494;16306;188;26;-14;40
25;1;1;Espírito Santo;5567;5515;52;-17;-22;5
25;1;1;Extrema;1975;1965;10;-2;-3;1
25;1;1;Farrapos;19022;18942;80;19;-6;25
25;1;1;Farroupilha;907;778;129;-50;-33;-17
25;1;1;Floresta;11533;11461;72;-12;-20;8
25;1;1;Glória;17096;16947;149;-10;-32;22
25;1;1;Guarujá;4792;4738;54;-4;-9;5
25;1;1;Higienópolis;10693;10610;83;1;-17;18
25;1;1;Hípica;18633;18575;58;-2;-17;15
25;1;1;Humaitá;11528;11456;72;3;-9;12
25;1;1;Independência;8115;7957;158;-24;-27;3
25;1;1;Ipanema;13714;13650;64;2;-13;15
25;1;1;Jardim Botânico;12540;12376;164;-11;-30;19
25;1;1;Jardim Carvalho;25500;25309;191;34;-18;52
25;1;1;Jardim do Salso;4368;4298;70;-27;-31;4
25;1;1;Jardim Dona Leopoldina;17996;17913;83;-8;-34;26
25;1;1;Jardim Europa;2249;2179;70;-25;-25;0
25;1;1;Jardim Floresta;3276;3208;68;-14;-17;3
25;1;1;Jardim Isabel;2797;2740;57;-12;-16;4
25;1;1;Jardim Itu;17827;17740;87;-13;-37;24
25;1;1;Jardim Lindóia;7391;7311;80;-11;-21;10
25;1;1;Jardim Sabará;13513;13425;88;-8;-29;21
25;1;1;Jardim São Pedro;3930;3856;74;-18;-23;5
25;1;1;Lageado;4480;4444;36;-5;-7;2
25;1;1;Lami;4281;4258;23;-3;-4;1
25;1;1;Lomba do Pinheiro;58180;58081;99;46;-5;51
25;1;1;Mário Quintana;38151;38045;106;27;-21;48
25;1;1;Medianeira;11160;11089;71;-23;-30;7
25;1;1;Menino Deus;31757;31523;234;53;-22;75
25;1;1;Moinhos de Vento;11996;11800;196;1;-23;24
25;1;1;MontSerrat;11177;11094;83;-12;-25;13
25;1;1;Morro Santana;19355;19269;86;4;-20;24
25;1;1;Navegantes;4327;4256;71;-10;-15;5
25;1;1;Nonoai;25142;25055;87;2;-25;27
25;1;1;Parque Santa Fé;6343;6276;67;-31;-36;5
25;1;1;Partenon;48198;48055;143;52;-23;75
25;1;1;Passo DAreia;21969;21858;111;20;-17;37
25;1;1;Passo das Pedras;15901;15813;88;-6;-27;21
25;1;1;Pedra Redonda;236;180;56;-15;-15;0
25;1;1;Petrópolis;37510;37382;128;42;-15;57
25;1;1;Pitinga;4366;4328;38;-7;-9;2
25;1;1;Ponta Grossa;8730;8687;43;-5;-8;3
25;1;1;Praia de Belas;2240;2172;68;-30;-30;0
25;1;1;Restinga;53673;53484;189;79;-5;84
25;1;1;Rio Branco;17593;17372;221;5;-29;34
25;1;1;Rubem Berta;33196;33084;112;14;-29;43
25;1;1;Santa Cecília;5809;5622;187;-28;-28;0
25;1;1;Santa Maria Goretti;3499;3422;77;-14;-18;4
25;1;1;Santa Rosa de Lima;35385;35291;94;21;-14;35
25;1;1;Santa Tereza;39602;39491;111;29;-19;48
25;1;1;Santana;20816;20584;232;13;-26;39
25;1;1;Santo Antônio;13126;13034;92;-24;-37;13
25;1;1;São Caetano;768;732;36;-6;-6;0
25;1;1;São Geraldo;8681;8591;90;-10;-22;12
25;1;1;São João;12249;12146;103;5;-16;21
25;1;1;São Sebastião;7013;6929;84;-14;-24;10
25;1;1;Sarandi;59794;59648;146;60;-16;76
25;1;1;Serraria;6248;6190;58;-7;-12;5
25;1;1;Sétimo Céu;1292;1237;55;-16;-15;-1
25;1;1;Teresópolis;14809;14614;195;-8;-27;19
25;1;1;Três Figueiras;4056;3972;84;-14;-19;5
25;1;1;Tristeza;16675;16599;76;5;-15;20
25;1;1;Vila Assunção;4518;4368;150;-13;-13;0
25;1;1;Vila Conceição;1360;1299;61;-6;-6;0
25;1;1;Vila Ipiranga;18654;18548;106;-7;-34;27
25;1;1;Vila Jardim;13179;13085;94;-17;-31;14
25;1;1;Vila João Pessoa;13032;12944;88;-22;-34;12
25;1;1;Vila Nova;32627;32414;213;46;-12;58
25;1;1;Vila São José;26554;26450;104;6;-25;31
26;2;1;Aberta dos Morros;7108;7071;37;-3;-3;0
26;2;1;Agronomia;2337;2299;38;13;13;0
26;2;1;Anchieta;2026;1977;49;7;5;2
26;2;1;Arquipélago;8337;8285;52;-4;-1;-3
26;2;1;Auxiliadora;9610;9555;55;8;20;-12
26;2;1;Azenha;13780;13647;133;40;41;-1
26;2;1;Bela Vista;11701;11645;56;-4;12;-16
26;2;1;Belém Novo;10088;10067;21;3;1;2
26;2;1;Belém Velho;10831;10781;50;2;3;-1
26;2;1;Boa Vista;10001;9934;67;8;16;-8
26;2;1;Boa Vista do Sul;2282;2266;16;1;2;-1
26;2;1;Bom Fim;11448;11427;21;5;24;-19
26;2;1;Bom Jesus;28660;28586;74;-3;18;-21
26;2;1;Camaquã;17920;17852;68;14;19;-5
26;2;1;Campo Novo;8749;8698;51;4;1;3
26;2;1;Cascata;12998;12937;61;-3;4;-7
26;2;1;Cavalhada;29282;29206;76;3;11;-8
26;2;1;Centro;39315;39082;233;30;13;17
26;2;1;Chácara das Pedras;6618;6561;57;3;16;-13
26;2;1;Chapéu do Sol;2898;2865;33;8;8;0
26;2;1;Cidade Baixa;15301;15244;57;2;18;-16
26;2;1;Coronel Aparício Borges;19264;19197;67;6;14;-8
26;2;1;Costa e Silva;15837;15770;67;17;21;-4
26;2;1;Cristal;31958;31874;84;4;8;-4
26;2;1;Cristo Redentor;16473;16319;154;-21;13;-34
26;2;1;Espírito Santo;5568;5517;51;1;2;-1
26;2;1;Extrema;1974;1963;11;-1;-2;1
26;2;1;Farrapos;19022;18942;80;0;0;0
26;2;1;Farroupilha;922;807;115;15;29;-14
26;2;1;Floresta;11531;11474;57;-2;13;-15
26;2;1;Glória;17108;16947;161;12;0;12
26;2;1;Guarujá;4791;4738;53;-1;0;-1
26;2;1;Higienópolis;10689;10613;76;-4;3;-7
26;2;1;Hípica;18644;18587;57;11;12;-1
26;2;1;Humaitá;11528;11456;72;0;0;0
26;2;1;Independência;8124;7975;149;9;18;-9
26;2;1;Ipanema;13717;13651;66;3;1;2
26;2;1;Jardim Botânico;12549;12400;149;9;24;-15
26;2;1;Jardim Carvalho;25486;25309;177;-14;0;-14
26;2;1;Jardim do Salso;4375;4312;63;7;14;-7
26;2;1;Jardim Dona Leopoldina;18010;17943;67;14;30;-16
26;2;1;Jardim Europa;2255;2191;64;6;12;-6
26;2;1;Jardim Floresta;3286;3218;68;10;10;0
26;2;1;Jardim Isabel;2797;2742;55;0;2;-2
26;2;1;Jardim Itu;17839;17760;79;12;20;-8
26;2;1;Jardim Lindóia;7390;7323;67;-1;12;-13
26;2;1;Jardim Sabará;13516;13436;80;3;11;-8
26;2;1;Jardim São Pedro;3939;3873;66;9;17;-8
26;2;1;Lageado;4483;4447;36;3;3;0
26;2;1;Lami;4284;4259;25;3;1;2
26;2;1;Lomba do Pinheiro;58158;58080;78;-22;-1;-21
26;2;1;Mário Quintana;38143;38058;85;-8;13;-21
26;2;1;Medianeira;11156;11102;54;-4;13;-17
26;2;1;Menino Deus;31741;31538;203;-16;15;-31
26;2;1;Moinhos de Vento;11988;11817;171;-8;17;-25
26;2;1;MontSerrat;11184;11113;71;7;19;-12
26;2;1;Morro Santana;19357;19269;88;2;0;2
26;2;1;Navegantes;4328;4255;73;1;-1;2
26;2;1;Nonoai;25145;25062;83;3;7;-4
26;2;1;Parque Santa Fé;6351;6292;59;8;16;-8
26;2;1;Partenon;48172;48067;105;-26;12;-38
26;2;1;Passo DAreia;21973;21867;106;4;9;-5
26;2;1;Passo das Pedras;15901;15823;78;0;10;-10
26;2;1;Pedra Redonda;240;186;54;4;6;-2
26;2;1;Petrópolis;37491;37388;103;-19;6;-25
26;2;1;Pitinga;4374;4333;41;8;5;3
26;2;1;Ponta Grossa;8733;8686;47;3;-1;4
26;2;1;Praia de Belas;2246;2187;59;6;15;-9
26;2;1;Restinga;53644;53482;162;-29;-2;-27
26;2;1;Rio Branco;17573;17376;197;-20;4;-24
26;2;1;Rubem Berta;33183;33103;80;-13;19;-32
26;2;1;Santa Cecília;5796;5623;173;-13;1;-14
26;2;1;Santa Maria Goretti;3502;3423;79;3;1;2
26;2;1;Santa Rosa de Lima;35387;35293;94;2;2;0
26;2;1;Santa Tereza;39587;39491;96;-15;0;-15
26;2;1;Santana;20804;20582;222;-12;-2;-10
26;2;1;Santo Antônio;13110;13042;68;-16;8;-24
26;2;1;São Caetano;765;729;36;-3;-3;0
26;2;1;São Geraldo;8679;8595;84;-2;4;-6
26;2;1;São João;12242;12145;97;-7;-1;-6
26;2;1;São Sebastião;7017;6939;78;4;10;-6
26;2;1;Sarandi;59765;59651;114;-29;3;-32
26;2;1;Serraria;6250;6192;58;2;2;0
26;2;1;Sétimo Céu;1300;1245;55;8;8;0
26;2;1;Teresópolis;14799;14613;186;-10;-1;-9
26;2;1;Três Figueiras;4059;3974;85;3;2;1
26;2;1;Tristeza;16677;16604;73;2;5;-3
26;2;1;Vila Assunção;4507;4362;145;-11;-6;-5
26;2;1;Vila Conceição;1361;1299;62;1;0;1
26;2;1;Vila Ipiranga;18646;18552;94;-8;4;-12
26;2;1;Vila Jardim;13176;13089;87;-3;4;-7
26;2;1;Vila João Pessoa;13034;12959;75;2;15;-13
26;2;1;Vila Nova;32604;32412;192;-23;-2;-21
26;2;1;Vila São José;26554;26455;99;0;5;-5
27;3;1;Aberta dos Morros;7108;7070;38;0;-1;1
27;3;1;Agronomia;2336;2299;37;-1;0;-1
27;3;1;Anchieta;2029;1980;49;3;3;0
27;3;1;Arquipélago;8340;8287;53;3;2;1
27;3;1;Auxiliadora;9613;9571;42;3;16;-13
27;3;1;Azenha;13815;13691;124;35;44;-9
27;3;1;Bela Vista;11702;11667;35;1;22;-21
27;3;1;Belém Novo;10088;10068;20;0;1;-1
27;3;1;Belém Velho;10839;10788;51;8;7;1
27;3;1;Boa Vista;10004;9951;53;3;17;-14
27;3;1;Boa Vista do Sul;2281;2266;15;-1;0;-1
27;3;1;Bom Fim;11463;11446;17;15;19;-4
27;3;1;Bom Jesus;28673;28605;68;13;19;-6
27;3;1;Camaquã;17923;17871;52;3;19;-16
27;3;1;Campo Novo;8751;8702;49;2;4;-2
27;3;1;Cascata;13000;12949;51;2;12;-10
27;3;1;Cavalhada;29294;29228;66;12;22;-10
27;3;1;Centro;39281;39082;199;-34;0;-34
27;3;1;Chácara das Pedras;6628;6581;47;10;20;-10
27;3;1;Chapéu do Sol;2901;2868;33;3;3;0
27;3;1;Cidade Baixa;15284;15252;32;-17;8;-25
27;3;1;Coronel Aparício Borges;19257;19222;35;-7;25;-32
27;3;1;Costa e Silva;15839;15791;48;2;21;-19
27;3;1;Cristal;31943;31885;58;-15;11;-26
27;3;1;Cristo Redentor;16499;16351;148;26;32;-6
27;3;1;Espírito Santo;5571;5523;48;3;6;-3
27;3;1;Extrema;1975;1963;12;1;0;1
27;3;1;Farrapos;19018;18943;75;-4;1;-5
27;3;1;Farroupilha;946;838;108;24;31;-7
27;3;1;Floresta;11538;11495;43;7;21;-14
27;3;1;Glória;17122;16974;148;14;27;-13
27;3;1;Guarujá;4792;4740;52;1;2;-1
27;3;1;Higienópolis;10690;10622;68;1;9;-8
27;3;1;Hípica;18639;18589;50;-5;2;-7
27;3;1;Humaitá;11529;11458;71;1;2;-1
27;3;1;Independência;8136;7993;143;12;18;-6
27;3;1;Ipanema;13721;13657;64;4;6;-2
27;3;1;Jardim Botânico;12552;12421;131;3;21;-18
27;3;1;Jardim Carvalho;25523;25333;190;37;24;13
27;3;1;Jardim do Salso;4375;4325;50;0;13;-13
27;3;1;Jardim Dona Leopoldina;18010;17967;43;0;24;-24
27;3;1;Jardim Europa;2262;2212;50;7;21;-14
27;3;1;Jardim Floresta;3296;3234;62;10;16;-6
27;3;1;Jardim Isabel;2801;2746;55;4;4;0
27;3;1;Jardim Itu;17820;17771;49;-19;11;-30
27;3;1;Jardim Lindóia;7400;7339;61;10;16;-6
27;3;1;Jardim Sabará;13516;13461;55;0;25;-25
27;3;1;Jardim São Pedro;3944;3884;60;5;11;-6
27;3;1;Lageado;4486;4450;36;3;3;0
27;3;1;Lami;4282;4258;24;-2;-1;-1
27;3;1;Lomba do Pinheiro;58164;58081;83;6;1;5
27;3;1;Mário Quintana;38143;38078;65;0;20;-20
27;3;1;Medianeira;11149;11115;34;-7;13;-20
27;3;1;Menino Deus;31749;31554;195;8;16;-8
27;3;1;Moinhos de Vento;11989;11828;161;1;11;-10
27;3;1;MontSerrat;11177;11124;53;-7;11;-18
27;3;1;Morro Santana;19350;19282;68;-7;13;-20
27;3;1;Navegantes;4328;4257;71;0;2;-2
27;3;1;Nonoai;25123;25076;47;-22;14;-36
27;3;1;Parque Santa Fé;6375;6328;47;24;36;-12
27;3;1;Partenon;48168;48082;86;-4;15;-19
27;3;1;Passo DAreia;21964;21881;83;-9;14;-23
27;3;1;Passo das Pedras;15892;15839;53;-9;16;-25
27;3;1;Pedra Redonda;239;189;50;-1;3;-4
27;3;1;Petrópolis;37480;37395;85;-11;7;-18
27;3;1;Pitinga;4378;4335;43;4;2;2
27;3;1;Ponta Grossa;8732;8685;47;-1;-1;0
27;3;1;Praia de Belas;2254;2207;47;8;20;-12
27;3;1;Restinga;53636;53482;154;-8;0;-8
27;3;1;Rio Branco;17578;17395;183;5;19;-14
27;3;1;Rubem Berta;33159;33112;47;-24;9;-33
27;3;1;Santa Cecília;5796;5645;151;0;22;-22
27;3;1;Santa Maria Goretti;3504;3432;72;2;9;-7
27;3;1;Santa Rosa de Lima;35367;35298;69;-20;5;-25
27;3;1;Santa Tereza;39577;39507;70;-10;16;-26
27;3;1;Santana;20795;20596;199;-9;14;-23
27;3;1;Santo Antônio;13101;13061;40;-9;19;-28
27;3;1;São Caetano;769;733;36;4;4;0
27;3;1;São Geraldo;8675;8602;73;-4;7;-11
27;3;1;São João;12243;12156;87;1;11;-10
27;3;1;São Sebastião;7013;6952;61;-4;13;-17
27;3;1;Sarandi;59751;59660;91;-14;9;-23
27;3;1;Serraria;6249;6191;58;-1;-1;0
27;3;1;Sétimo Céu;1306;1252;54;6;7;-1
27;3;1;Teresópolis;14794;14624;170;-5;11;-16
27;3;1;Três Figueiras;4054;3979;75;-5;5;-10
27;3;1;Tristeza;16670;16613;57;-7;9;-16
27;3;1;Vila Assunção;4511;4370;141;4;8;-4
27;3;1;Vila Conceição;1360;1297;63;-1;-2;1
27;3;1;Vila Ipiranga;18635;18572;63;-11;20;-31
27;3;1;Vila Jardim;13175;13105;70;-1;16;-17
27;3;1;Vila João Pessoa;13025;12968;57;-9;9;-18
27;3;1;Vila Nova;32593;32417;176;-11;5;-16
27;3;1;Vila São José;26526;26459;67;-28;4;-32
28;4;1;Aberta dos Morros;6814;6449;365;-294;-621;327
28;4;1;Agronomia;1736;1671;65;-600;-628;28
28;4;1;Anchieta;1398;1364;34;-631;-616;-15
28;4;1;Arquipélago;8150;7666;484;-190;-621;431
28;4;1;Auxiliadora;9173;8642;531;-440;-929;489
28;4;1;Azenha;13459;12654;805;-356;-1037;681
28;4;1;Bela Vista;11310;10622;688;-392;-1045;653
28;4;1;Belém Novo;10046;9574;472;-42;-494;452
28;4;1;Belém Velho;10701;10070;631;-138;-718;580
28;4;1;Boa Vista;9551;8983;568;-453;-968;515
28;4;1;Boa Vista do Sul;1814;1773;41;-467;-493;26
28;4;1;Bom Fim;10991;10363;628;-472;-1083;611
28;4;1;Bom Jesus;29342;27557;1785;669;-1048;1717
28;4;1;Camaquã;18017;16981;1036;94;-890;984
28;4;1;Campo Novo;8429;7982;447;-322;-720;398
28;4;1;Cascata;12864;12132;732;-136;-817;681
28;4;1;Cavalhada;30027;28325;1702;733;-903;1636
28;4;1;Centro;40517;38245;2272;1236;-837;2073
28;4;1;Chácara das Pedras;5840;5532;308;-788;-1049;261
28;4;1;Chapéu do Sol;2330;2273;57;-571;-595;24
28;4;1;Cidade Baixa;15116;14229;887;-168;-1023;855
28;4;1;Coronel Aparício Borges;19323;18197;1126;66;-1025;1091
28;4;1;Costa e Silva;15651;14797;854;-188;-994;806
28;4;1;Cristal;32924;31067;1857;981;-818;1799
28;4;1;Cristo Redentor;16251;15304;947;-248;-1047;799
28;4;1;Espírito Santo;5052;4802;250;-519;-721;202
28;4;1;Extrema;1580;1545;35;-395;-418;23
28;4;1;Farrapos;19323;18266;1057;305;-677;982
28;4;1;Farroupilha;443;443;0;-503;-395;-108
28;4;1;Floresta;11218;10552;666;-320;-943;623
28;4;1;Glória;16972;15953;1019;-150;-1021;871
28;4;1;Guarujá;4267;4065;202;-525;-675;150
28;4;1;Higienópolis;10271;9636;635;-419;-986;567
28;4;1;Hípica;18929;17935;994;290;-654;944
28;4;1;Humaitá;11406;10765;641;-123;-693;570
28;4;1;Independência;7392;6945;447;-744;-1048;304
28;4;1;Ipanema;13687;12942;745;-34;-715;681
28;4;1;Jardim Botânico;12028;11282;746;-524;-1139;615
28;4;1;Jardim Carvalho;25987;24395;1592;464;-938;1402
28;4;1;Jardim do Salso;3472;3287;185;-903;-1038;135
28;4;1;Jardim Dona Leopoldina;17930;16895;1035;-80;-1072;992
28;4;1;Jardim Europa;1312;1291;21;-950;-921;-29
28;4;1;Jardim Floresta;2480;2386;94;-816;-848;32
28;4;1;Jardim Isabel;2064;2028;36;-737;-718;-19
28;4;1;Jardim Itu;17878;16792;1086;58;-979;1037
28;4;1;Jardim Lindóia;6810;6413;397;-590;-926;336
28;4;1;Jardim Sabará;13297;12495;802;-219;-966;747
28;4;1;Jardim São Pedro;3166;2985;181;-778;-899;121
28;4;1;Lageado;4050;3853;197;-436;-597;161
28;4;1;Lami;3989;3780;209;-293;-478;185
28;4;1;Lomba do Pinheiro;60683;57422;3261;2519;-659;3178
28;4;1;Mário Quintana;39423;37261;2162;1280;-817;2097
28;4;1;Medianeira;10751;10108;643;-398;-1007;609
28;4;1;Menino Deus;32651;30628;2023;902;-926;1828
28;4;1;Moinhos de Vento;11563;10829;734;-426;-999;573
28;4;1;MontSerrat;10781;10111;670;-396;-1013;617
28;4;1;Morro Santana;19618;18473;1145;268;-809;1077
28;4;1;Navegantes;3673;3474;199;-655;-783;128
28;4;1;Nonoai;25654;24170;1484;531;-906;1437
28;4;1;Parque Santa Fé;5683;5370;313;-692;-958;266
28;4;1;Partenon;49931;47091;2840;1763;-991;2754
28;4;1;Passo DAreia;22309;20964;1345;345;-917;1262
28;4;1;Passo das Pedras;15824;14914;910;-68;-925;857
28;4;1;Pedra Redonda;156;129;27;-83;-60;-23
28;4;1;Petrópolis;38764;36407;2357;1284;-988;2272
28;4;1;Pitinga;3960;3749;211;-418;-586;168
28;4;1;Ponta Grossa;8605;8165;440;-127;-520;393
28;4;1;Praia de Belas;1520;1397;123;-734;-810;76
28;4;1;Restinga;55918;52990;2928;2282;-492;2774
28;4;1;Rio Branco;17509;16371;1138;-69;-1024;955
28;4;1;Rubem Berta;34200;32277;1923;1041;-835;1876
28;4;1;Santa Cecília;4886;4576;310;-910;-1069;159
28;4;1;Santa Maria Goretti;2828;2597;231;-676;-835;159
28;4;1;Santa Rosa de Lima;36637;34590;2047;1270;-708;1978
28;4;1;Santa Tereza;41025;38646;2379;1448;-861;2309
28;4;1;Santana;21052;19638;1414;257;-958;1215
28;4;1;Santo Antônio;13013;12117;896;-88;-944;856
28;4;1;São Caetano;605;413;192;-164;-320;156
28;4;1;São Geraldo;8406;7814;592;-269;-788;519
28;4;1;São João;12259;11380;879;16;-776;792
28;4;1;São Sebastião;6489;6064;425;-524;-888;364
28;4;1;Sarandi;62632;58985;3647;2881;-675;3556
28;4;1;Serraria;6093;5711;382;-156;-480;324
28;4;1;Sétimo Céu;757;659;98;-549;-593;44
28;4;1;Teresópolis;14796;13737;1059;2;-887;889
28;4;1;Três Figueiras;3428;3040;388;-626;-939;313
28;4;1;Tristeza;16917;15903;1014;247;-710;957
28;4;1;Vila Assunção;4065;3710;355;-446;-660;214
28;4;1;Vila Conceição;934;760;174;-426;-537;111
28;4;1;Vila Ipiranga;19004;17703;1301;369;-869;1238
28;4;1;Vila Jardim;13224;12228;996;49;-877;926
28;4;1;Vila João Pessoa;12911;12020;891;-114;-948;834
28;4;1;Vila Nova;33906;31863;2043;1313;-554;1867
28;4;1;Vila São José;27531;25773;1758;1005;-686;1691
29;5;1;Aberta dos Morros;6811;6443;368;-3;-6;3
29;5;1;Agronomia;1732;1671;61;-4;0;-4
29;5;1;Anchieta;1390;1359;31;-8;-5;-3
29;5;1;Arquipélago;8161;7663;498;11;-3;14
29;5;1;Auxiliadora;9175;8641;534;2;-1;3
29;5;1;Azenha;13438;12630;808;-21;-24;3
29;5;1;Bela Vista;11302;10614;688;-8;-8;0
29;5;1;Belém Novo;10054;9574;480;8;0;8
29;5;1;Belém Velho;10699;10056;643;-2;-14;12
29;5;1;Boa Vista;9551;8978;573;0;-5;5
29;5;1;Boa Vista do Sul;1813;1774;39;-1;1;-2
29;5;1;Bom Fim;10969;10353;616;-22;-10;-12
29;5;1;Bom Jesus;29370;27533;1837;28;-24;52
29;5;1;Camaquã;18021;16959;1062;4;-22;26
29;5;1;Campo Novo;8422;7965;457;-7;-17;10
29;5;1;Cascata;12878;12122;756;14;-10;24
29;5;1;Cavalhada;30070;28310;1760;43;-15;58
29;5;1;Centro;40573;38233;2340;56;-12;68
29;5;1;Chácara das Pedras;5821;5521;300;-19;-11;-8
29;5;1;Chapéu do Sol;2316;2267;49;-14;-6;-8
29;5;1;Cidade Baixa;15129;14213;916;13;-16;29
29;5;1;Coronel Aparício Borges;19341;18178;1163;18;-19;37
29;5;1;Costa e Silva;15642;14768;874;-9;-29;20
29;5;1;Cristal;32970;31053;1917;46;-14;60
29;5;1;Cristo Redentor;16251;15284;967;0;-20;20
29;5;1;Espírito Santo;5042;4797;245;-10;-5;-5
29;5;1;Extrema;1580;1546;34;0;1;-1
29;5;1;Farrapos;19344;18260;1084;21;-6;27
29;5;1;Farroupilha;437;437;0;-6;-6;0
29;5;1;Floresta;11217;10532;685;-1;-20;19
29;5;1;Glória;16979;15922;1057;7;-31;38
29;5;1;Guarujá;4266;4063;203;-1;-2;1
29;5;1;Higienópolis;10273;9629;644;2;-7;9
29;5;1;Hípica;18942;17920;1022;13;-15;28
29;5;1;Humaitá;11420;10759;661;14;-6;20
29;5;1;Independência;7386;6941;445;-6;-4;-2
29;5;1;Ipanema;13705;12939;766;18;-3;21
29;5;1;Jardim Botânico;12033;11267;766;5;-15;20
29;5;1;Jardim Carvalho;26014;24376;1638;27;-19;46
29;5;1;Jardim do Salso;3458;3281;177;-14;-6;-8
29;5;1;Jardim Dona Leopoldina;17923;16861;1062;-7;-34;27
29;5;1;Jardim Europa;1294;1288;6;-18;-3;-15
29;5;1;Jardim Floresta;2466;2380;86;-14;-6;-8
29;5;1;Jardim Isabel;2050;2022;28;-14;-6;-8
29;5;1;Jardim Itu;17881;16765;1116;3;-27;30
29;5;1;Jardim Lindóia;6814;6411;403;4;-2;6
29;5;1;Jardim Sabará;13299;12473;826;2;-22;24
29;5;1;Jardim São Pedro;3160;2981;179;-6;-4;-2
29;5;1;Lageado;4048;3855;193;-2;2;-4
29;5;1;Lami;3993;3784;209;4;4;0
29;5;1;Lomba do Pinheiro;60745;57418;3327;62;-4;66
29;5;1;Mário Quintana;39467;37246;2221;44;-15;59
29;5;1;Medianeira;10739;10078;661;-12;-30;18
29;5;1;Menino Deus;32678;30599;2079;27;-29;56
29;5;1;Moinhos de Vento;11546;10797;749;-17;-32;15
29;5;1;MontSerrat;10780;10089;691;-1;-22;21
29;5;1;Morro Santana;19640;18457;1183;22;-16;38
29;5;1;Navegantes;3670;3473;197;-3;-1;-2
29;5;1;Nonoai;25676;24156;1520;22;-14;36
29;5;1;Parque Santa Fé;5671;5351;320;-12;-19;7
29;5;1;Partenon;49993;47063;2930;62;-28;90
29;5;1;Passo DAreia;22337;20952;1385;28;-12;40
29;5;1;Passo das Pedras;15830;14892;938;6;-22;28
29;5;1;Pedra Redonda;144;125;19;-12;-4;-8
29;5;1;Petrópolis;38827;36397;2430;63;-10;73
29;5;1;Pitinga;3948;3743;205;-12;-6;-6
29;5;1;Ponta Grossa;8586;8147;439;-19;-18;-1
29;5;1;Praia de Belas;1476;1388;88;-44;-9;-35
29;5;1;Restinga;55947;52980;2967;29;-10;39
29;5;1;Rio Branco;17486;16331;1155;-23;-40;17
29;5;1;Rubem Berta;34206;32253;1953;6;-24;30
29;5;1;Santa Cecília;4871;4573;298;-15;-3;-12
29;5;1;Santa Maria Goretti;2813;2592;221;-15;-5;-10
29;5;1;Santa Rosa de Lima;36643;34576;2067;6;-14;20
29;5;1;Santa Tereza;41045;38630;2415;20;-16;36
29;5;1;Santana;21034;19598;1436;-18;-40;22
29;5;1;Santo Antônio;12972;12084;888;-41;-33;-8
29;5;1;São Caetano;599;411;188;-6;-2;-4
29;5;1;São Geraldo;8395;7794;601;-11;-20;9
29;5;1;São João;12241;11355;886;-18;-25;7
29;5;1;São Sebastião;6473;6051;422;-16;-13;-3
29;5;1;Sarandi;62629;58961;3668;-3;-24;21
29;5;1;Serraria;6091;5703;388;-2;-8;6
29;5;1;Sétimo Céu;747;657;90;-10;-2;-8
29;5;1;Teresópolis;14760;13707;1053;-36;-30;-6
29;5;1;Três Figueiras;3394;3018;376;-34;-22;-12
29;5;1;Tristeza;16921;15894;1027;4;-9;13
29;5;1;Vila Assunção;4032;3697;335;-33;-13;-20
29;5;1;Vila Conceição;922;750;172;-12;-10;-2
29;5;1;Vila Ipiranga;18981;17666;1315;-23;-37;14
29;5;1;Vila Jardim;13181;12176;1005;-43;-52;9
29;5;1;Vila João Pessoa;12883;11987;896;-28;-33;5
29;5;1;Vila Nova;33899;31840;2059;-7;-23;16
29;5;1;Vila São José;27510;25737;1773;-21;-36;15
30;6;1;Aberta dos Morros;6638;5878;760;-173;-565;392
30;6;1;Agronomia;1345;1169;176;-387;-502;115
30;6;1;Anchieta;1124;1006;118;-266;-353;87
30;6;1;Arquipélago;8085;7100;985;-76;-563;487
30;6;1;Auxiliadora;8835;7722;1113;-340;-919;579
30;6;1;Azenha;13224;11593;1631;-214;-1037;823
30;6;1;Bela Vista;10981;9594;1387;-321;-1020;699
30;6;1;Belém Novo;10139;9170;969;85;-404;489
30;6;1;Belém Velho;10608;9401;1207;-91;-655;564
30;6;1;Boa Vista;9175;8020;1155;-376;-958;582
30;6;1;Boa Vista do Sul;1494;1407;87;-319;-367;48
30;6;1;Bom Fim;10608;9324;1284;-361;-1029;668
30;6;1;Bom Jesus;30053;26573;3480;683;-960;1643
30;6;1;Camaquã;18141;16143;1998;120;-816;936
30;6;1;Campo Novo;8187;7310;877;-235;-655;420
30;6;1;Cascata;12826;11361;1465;-52;-761;709
30;6;1;Cavalhada;30717;27435;3282;647;-875;1522
30;6;1;Centro;41712;37390;4322;1139;-843;1982
30;6;1;Chácara das Pedras;5162;4518;644;-659;-1003;344
30;6;1;Chapéu do Sol;1888;1756;132;-428;-511;83
30;6;1;Cidade Baixa;15069;13264;1805;-60;-949;889
30;6;1;Coronel Aparício Borges;19442;17196;2246;101;-982;1083
30;6;1;Costa e Silva;15566;13829;1737;-76;-939;863
30;6;1;Cristal;33866;30263;3603;896;-790;1686
30;6;1;Cristo Redentor;16235;14320;1915;-16;-964;948
30;6;1;Espírito Santo;4672;4176;496;-370;-621;251
30;6;1;Extrema;1224;1175;49;-356;-371;15
30;6;1;Farrapos;19734;17642;2092;390;-618;1008
30;6;1;Farroupilha;445;441;4;8;4;4
30;6;1;Floresta;10950;9657;1293;-267;-875;608
30;6;1;Glória;16973;14988;1985;-6;-934;928
30;6;1;Guarujá;3864;3490;374;-402;-573;171
30;6;1;Higienópolis;9915;8705;1210;-358;-924;566
30;6;1;Hípica;19299;17336;1963;357;-584;941
30;6;1;Humaitá;11328;10101;1227;-92;-658;566
30;6;1;Independência;6790;5958;832;-596;-983;387
30;6;1;Ipanema;13710;12252;1458;5;-687;692
30;6;1;Jardim Botânico;11631;10214;1417;-402;-1053;651
30;6;1;Jardim Carvalho;26468;23442;3026;454;-934;1388
30;6;1;Jardim do Salso;2629;2260;369;-829;-1021;192
30;6;1;Jardim Dona Leopoldina;17865;15824;2041;-58;-1037;979
30;6;1;Jardim Europa;1207;1121;86;-87;-167;80
30;6;1;Jardim Floresta;1869;1657;212;-597;-723;126
30;6;1;Jardim Isabel;1530;1431;99;-520;-591;71
30;6;1;Jardim Itu;17889;15777;2112;8;-988;996
30;6;1;Jardim Lindóia;6295;5537;758;-519;-874;355
30;6;1;Jardim Sabará;13047;11504;1543;-252;-969;717
30;6;1;Jardim São Pedro;2433;2096;337;-727;-885;158
30;6;1;Lageado;3683;3364;319;-365;-491;126
30;6;1;Lami;3691;3389;302;-302;-395;93
30;6;1;Lomba do Pinheiro;62929;56731;6198;2184;-687;2871
30;6;1;Mário Quintana;40719;36400;4319;1252;-846;2098
30;6;1;Medianeira;10369;9111;1258;-370;-967;597
30;6;1;Menino Deus;33459;29635;3824;781;-964;1745
30;6;1;Moinhos de Vento;11247;9867;1380;-299;-930;631
30;6;1;MontSerrat;10384;9088;1296;-396;-1001;605
30;6;1;Morro Santana;19868;17615;2253;228;-842;1070
30;6;1;Navegantes;3106;2733;373;-564;-740;176
30;6;1;Nonoai;26127;23240;2887;451;-916;1367
30;6;1;Parque Santa Fé;4995;4397;598;-676;-954;278
30;6;1;Partenon;51597;46025;5572;1604;-1038;2642
30;6;1;Passo DAreia;22674;19998;2676;337;-954;1291
30;6;1;Passo das Pedras;15729;13912;1817;-101;-980;879
30;6;1;Pedra Redonda;126;126;0;-18;1;-19
30;6;1;Petrópolis;40002;35371;4631;1175;-1026;2201
30;6;1;Pitinga;3545;3203;342;-403;-540;137
30;6;1;Ponta Grossa;8398;7602;796;-188;-545;357
30;6;1;Praia de Belas;1251;1124;127;-225;-264;39
30;6;1;Restinga;57512;52214;5298;1565;-766;2331
30;6;1;Rio Branco;17424;15292;2132;-62;-1039;977
30;6;1;Rubem Berta;35011;31344;3667;805;-909;1714
30;6;1;Santa Cecília;4094;3568;526;-777;-1005;228
30;6;1;Santa Maria Goretti;2093;1803;290;-720;-789;69
30;6;1;Santa Rosa de Lima;37646;33810;3836;1003;-766;1769
30;6;1;Santa Tereza;42294;37716;4578;1249;-914;2163
30;6;1;Santana;21089;18544;2545;55;-1054;1109
30;6;1;Santo Antônio;12635;11066;1569;-337;-1018;681
30;6;1;São Caetano;534;374;160;-65;-37;-28
30;6;1;São Geraldo;7988;6979;1009;-407;-815;408
30;6;1;São João;11999;10516;1483;-242;-839;597
30;6;1;São Sebastião;5887;5165;722;-586;-886;300
30;6;1;Sarandi;64712;58108;6604;2083;-853;2936
30;6;1;Serraria;5675;5083;592;-416;-620;204
30;6;1;Sétimo Céu;720;654;66;-27;-3;-24
30;6;1;Teresópolis;14452;12698;1754;-308;-1009;701
30;6;1;Três Figueiras;2553;2107;446;-841;-911;70
30;6;1;Tristeza;16998;15171;1827;77;-723;800
30;6;1;Vila Assunção;3361;2957;404;-671;-740;69
30;6;1;Vila Conceição;826;668;158;-96;-82;-14
30;6;1;Vila Ipiranga;18982;16677;2305;1;-989;990
30;6;1;Vila Jardim;12819;11189;1630;-362;-987;625
30;6;1;Vila João Pessoa;12527;10952;1575;-356;-1035;679
30;6;1;Vila Nova;34745;31066;3679;846;-774;1620
30;6;1;Vila São José;27989;24854;3135;479;-883;1362
31;7;1;Aberta dos Morros;6264;4907;1357;-374;-971;597
31;7;1;Agronomia;1261;926;335;-84;-243;159
31;7;1;Anchieta;1022;768;254;-102;-238;136
31;7;1;Arquipélago;7657;5951;1706;-428;-1149;721
31;7;1;Auxiliadora;8226;6159;2067;-609;-1563;954
31;7;1;Azenha;12508;9341;3167;-716;-2252;1536
31;7;1;Bela Vista;10280;7696;2584;-701;-1898;1197
31;7;1;Belém Novo;10072;8422;1650;-67;-748;681
31;7;1;Belém Velho;10058;7903;2155;-550;-1498;948
31;7;1;Boa Vista;8564;6368;2196;-611;-1652;1041
31;7;1;Boa Vista do Sul;1439;1249;190;-55;-158;103
31;7;1;Bom Fim;9894;7443;2451;-714;-1881;1167
31;7;1;Bom Jesus;30697;24170;6527;644;-2403;3047
31;7;1;Camaquã;17969;14220;3749;-172;-1923;1751
31;7;1;Campo Novo;7696;6085;1611;-491;-1225;734
31;7;1;Cascata;12225;9541;2684;-601;-1820;1219
31;7;1;Cavalhada;31686;25519;6167;969;-1916;2885
31;7;1;Centro;43981;35607;8374;2269;-1783;4052
31;7;1;Chácara das Pedras;4793;3529;1264;-369;-989;620
31;7;1;Chapéu do Sol;1800;1487;313;-88;-269;181
31;7;1;Cidade Baixa;14348;11106;3242;-721;-2158;1437
31;7;1;Coronel Aparício Borges;19022;14811;4211;-420;-2385;1965
31;7;1;Costa e Silva;14858;11584;3274;-708;-2245;1537
31;7;1;Cristal;35183;28551;6632;1317;-1712;3029
31;7;1;Cristo Redentor;15790;11997;3793;-445;-2323;1878
31;7;1;Espírito Santo;4421;3471;950;-251;-705;454
31;7;1;Extrema;1215;1052;163;-9;-123;114
31;7;1;Farrapos;20006;16233;3773;272;-1409;1681
31;7;1;Farroupilha;320;224;96;-125;-217;92
31;7;1;Floresta;10300;7925;2375;-650;-1732;1082
31;7;1;Glória;16454;12770;3684;-519;-2218;1699
31;7;1;Guarujá;3660;2916;744;-204;-574;370
31;7;1;Higienópolis;9306;7000;2306;-609;-1705;1096
31;7;1;Hípica;19551;16108;3443;252;-1228;1480
31;7;1;Humaitá;10870;8642;2228;-458;-1459;1001
31;7;1;Independência;6573;4736;1837;-217;-1222;1005
31;7;1;Ipanema;13502;10867;2635;-208;-1385;1177
31;7;1;Jardim Botânico;11096;8273;2823;-535;-1941;1406
31;7;1;Jardim Carvalho;26843;21353;5490;375;-2089;2464
31;7;1;Jardim do Salso;2424;1527;897;-205;-733;528
31;7;1;Jardim Dona Leopoldina;17111;13379;3732;-754;-2445;1691
31;7;1;Jardim Europa;1229;677;552;22;-444;466
31;7;1;Jardim Floresta;1702;1117;585;-167;-540;373
31;7;1;Jardim Isabel;1452;1002;450;-78;-429;351
31;7;1;Jardim Itu;17223;13437;3786;-666;-2340;1674
31;7;1;Jardim Lindóia;6084;4454;1630;-211;-1083;872
31;7;1;Jardim Sabará;12278;9473;2805;-769;-2031;1262
31;7;1;Jardim São Pedro;2251;1451;800;-182;-645;463
31;7;1;Lageado;3478;2900;578;-205;-464;259
31;7;1;Lami;3550;3051;499;-141;-338;197
31;7;1;Lomba do Pinheiro;66340;55449;10891;3411;-1282;4693
31;7;1;Mário Quintana;42495;34544;7951;1776;-1856;3632
31;7;1;Medianeira;9726;7392;2334;-643;-1719;1076
31;7;1;Menino Deus;34360;27472;6888;901;-2163;3064
31;7;1;Moinhos de Vento;10749;7954;2795;-498;-1913;1415
31;7;1;MontSerrat;9770;7391;2379;-614;-1697;1083
31;7;1;Morro Santana;19674;15683;3991;-194;-1932;1738
31;7;1;Navegantes;3114;1970;1144;8;-763;771
31;7;1;Nonoai;26487;21209;5278;360;-2031;2391
31;7;1;Parque Santa Fé;4653;3286;1367;-342;-1111;769
31;7;1;Partenon;54123;43622;10501;2526;-2403;4929
31;7;1;Passo DAreia;22726;17771;4955;52;-2227;2279
31;7;1;Passo das Pedras;14997;11680;3317;-732;-2232;1500
31;7;1;Pedra Redonda;87;58;29;-39;-68;29
31;7;1;Petrópolis;41343;33003;8340;1341;-2368;3709
31;7;1;Pitinga;3333;2599;734;-212;-604;392
31;7;1;Ponta Grossa;8019;6677;1342;-379;-925;546
31;7;1;Praia de Belas;1316;692;624;65;-432;497
31;7;1;Restinga;60062;51122;8940;2550;-1092;3642
31;7;1;Rio Branco;16756;12887;3869;-668;-2405;1737
31;7;1;Rubem Berta;36072;29337;6735;1061;-2007;3068
31;7;1;Santa Cecília;3836;2562;1274;-258;-1006;748
31;7;1;Santa Maria Goretti;1969;1238;731;-124;-565;441
31;7;1;Santa Rosa de Lima;38851;32202;6649;1205;-1608;2813
31;7;1;Santa Tereza;44068;35761;8307;1774;-1955;3729
31;7;1;Santana;20782;16148;4634;-307;-2396;2089
31;7;1;Santo Antônio;11909;9114;2795;-726;-1952;1226
31;7;1;São Caetano;506;264;242;-28;-110;82
31;7;1;São Geraldo;7461;5421;2040;-527;-1558;1031
31;7;1;São João;11482;8836;2646;-517;-1680;1163
31;7;1;São Sebastião;5713;3888;1825;-174;-1277;1103
31;7;1;Sarandi;67563;56283;11280;2851;-1825;4676
31;7;1;Serraria;5396;4179;1217;-279;-904;625
31;7;1;Sétimo Céu;581;389;192;-139;-265;126
31;7;1;Teresópolis;13680;10671;3009;-772;-2027;1255
31;7;1;Três Figueiras;2590;1428;1162;37;-679;716
31;7;1;Tristeza;16670;13631;3039;-328;-1540;1212
31;7;1;Vila Assunção;3224;2247;977;-137;-710;573
31;7;1;Vila Conceição;761;456;305;-65;-212;147
31;7;1;Vila Ipiranga;18256;14367;3889;-726;-2310;1584
31;7;1;Vila Jardim;12086;9009;3077;-733;-2180;1447
31;7;1;Vila João Pessoa;11802;8809;2993;-725;-2143;1418
31;7;1;Vila Nova;35626;29474;6152;881;-1592;2473
31;7;1;Vila São José;28145;22700;5445;156;-2154;2310
32;8;1;Aberta dos Morros;6280;5087;1193;16;180;-164
32;8;1;Agronomia;1313;1113;200;52;187;-135
32;8;1;Anchieta;1057;891;166;35;123;-88
32;8;1;Arquipélago;7784;6168;1616;127;217;-90
32;8;1;Auxiliadora;8210;6382;1828;-16;223;-239
32;8;1;Azenha;12355;9715;2640;-153;374;-527
32;8;1;Bela Vista;10288;7975;2313;8;279;-271
32;8;1;Belém Novo;10115;8445;1670;43;23;20
32;8;1;Belém Velho;10162;8044;2118;104;141;-37
32;8;1;Boa Vista;8580;6646;1934;16;278;-262
32;8;1;Boa Vista do Sul;1454;1319;135;15;70;-55
32;8;1;Bom Fim;9951;7797;2154;57;354;-297
32;8;1;Bom Jesus;30902;24348;6554;205;178;27
32;8;1;Camaquã;18061;14396;3665;92;176;-84
32;8;1;Campo Novo;7712;6191;1521;16;106;-90
32;8;1;Cascata;12285;9657;2628;60;116;-56
32;8;1;Cavalhada;31618;25643;5975;-68;124;-192
32;8;1;Centro;44190;35872;8318;209;265;-56
32;8;1;Chácara das Pedras;4804;3814;990;11;285;-274
32;8;1;Chapéu do Sol;1792;1584;208;-8;97;-105
32;8;1;Cidade Baixa;14526;11424;3102;178;318;-140
32;8;1;Coronel Aparício Borges;19141;14970;4171;119;159;-40
32;8;1;Costa e Silva;14977;11773;3204;119;189;-70
32;8;1;Cristal;35317;28654;6663;134;103;31
32;8;1;Cristo Redentor;15646;12257;3389;-144;260;-404
32;8;1;Espírito Santo;4298;3580;718;-123;109;-232
32;8;1;Extrema;1326;1154;172;111;102;9
32;8;1;Farrapos;20265;16451;3814;259;218;41
32;8;1;Farroupilha;196;169;27;-124;-55;-69
32;8;1;Floresta;10363;8152;2211;63;227;-164
32;8;1;Glória;16471;12988;3483;17;218;-201
32;8;1;Guarujá;3565;3010;555;-95;94;-189
32;8;1;Higienópolis;9339;7244;2095;33;244;-211
32;8;1;Hípica;19545;16164;3381;-6;56;-62
32;8;1;Humaitá;11017;8831;2186;147;189;-42
32;8;1;Independência;6300;4983;1317;-273;247;-520
32;8;1;Ipanema;13478;10906;2572;-24;39;-63
32;8;1;Jardim Botânico;10833;8480;2353;-263;207;-470
32;8;1;Jardim Carvalho;26991;21560;5431;148;207;-59
32;8;1;Jardim do Salso;2444;1820;624;20;293;-273
32;8;1;Jardim Dona Leopoldina;17133;13539;3594;22;160;-138
32;8;1;Jardim Europa;872;637;235;-357;-40;-317
32;8;1;Jardim Floresta;1710;1283;427;8;166;-158
32;8;1;Jardim Isabel;1486;1153;333;34;151;-117
32;8;1;Jardim Itu;17283;13627;3656;60;190;-130
32;8;1;Jardim Lindóia;5773;4597;1176;-311;143;-454
32;8;1;Jardim Sabará;12311;9614;2697;33;141;-108
32;8;1;Jardim São Pedro;2290;1721;569;39;270;-231
32;8;1;Lageado;3388;2937;451;-90;37;-127
32;8;1;Lami;3458;3083;375;-92;32;-124
32;8;1;Lomba do Pinheiro;66093;55410;10683;-247;-39;-208
32;8;1;Mário Quintana;42519;34624;7895;24;80;-56
32;8;1;Medianeira;9672;7567;2105;-54;175;-229
32;8;1;Menino Deus;34463;27679;6784;103;207;-104
32;8;1;Moinhos de Vento;10460;8129;2331;-289;175;-464
32;8;1;MontSerrat;9733;7582;2151;-37;191;-228
32;8;1;Morro Santana;19733;15791;3942;59;108;-49
32;8;1;Navegantes;2858;2151;707;-256;181;-437
32;8;1;Nonoai;26542;21314;5228;55;105;-50
32;8;1;Parque Santa Fé;4581;3517;1064;-72;231;-303
32;8;1;Partenon;54175;43702;10473;52;80;-28
32;8;1;Passo DAreia;22784;17904;4880;58;133;-75
32;8;1;Passo das Pedras;15010;11823;3187;13;143;-130
32;8;1;Pedra Redonda;58;33;25;-29;-25;-4
32;8;1;Petrópolis;41371;33085;8286;28;82;-54
32;8;1;Pitinga;3293;2708;585;-40;109;-149
32;8;1;Ponta Grossa;7986;6698;1288;-33;21;-54
32;8;1;Praia de Belas;1036;710;326;-280;18;-298
32;8;1;Restinga;60277;51157;9120;215;35;180
32;8;1;Rio Branco;16694;13056;3638;-62;169;-231
32;8;1;Rubem Berta;36004;29407;6597;-68;70;-138
32;8;1;Santa Cecília;3785;2853;932;-51;291;-342
32;8;1;Santa Maria Goretti;2049;1477;572;80;239;-159
32;8;1;Santa Rosa de Lima;38961;32327;6634;110;125;-15
32;8;1;Santa Tereza;44069;35871;8198;1;110;-109
32;8;1;Santana;20720;16316;4404;-62;168;-230
32;8;1;Santo Antônio;11898;9305;2593;-11;191;-202
32;8;1;São Caetano;606;277;329;100;13;87
32;8;1;São Geraldo;7522;5575;1947;61;154;-93
32;8;1;São João;11334;8883;2451;-148;47;-195
32;8;1;São Sebastião;5358;4010;1348;-355;122;-477
32;8;1;Sarandi;67676;56249;11427;113;-34;147
32;8;1;Serraria;5365;4218;1147;-31;39;-70
32;8;1;Sétimo Céu;570;355;215;-11;-34;23
32;8;1;Teresópolis;13700;10774;2926;20;103;-83
32;8;1;Três Figueiras;2520;1720;800;-70;292;-362
32;8;1;Tristeza;16661;13662;2999;-9;31;-40
32;8;1;Vila Assunção;3280;2413;867;56;166;-110
32;8;1;Vila Conceição;908;476;432;147;20;127
32;8;1;Vila Ipiranga;18265;14443;3822;9;76;-67
32;8;1;Vila Jardim;12213;9142;3071;127;133;-6
32;8;1;Vila João Pessoa;11804;8895;2909;2;86;-84
32;8;1;Vila Nova;35708;29439;6269;82;-35;117
32;8;1;Vila São José;28382;22766;5616;237;66;171
33;9;1;Aberta dos Morros;6253;5072;1181;-27;-15;-12
33;9;1;Agronomia;1279;1099;180;-34;-14;-20
33;9;1;Anchieta;1068;894;174;11;3;8
33;9;1;Arquipélago;7774;6140;1634;-10;-28;18
33;9;1;Auxiliadora;8150;6342;1808;-60;-40;-20
33;9;1;Azenha;12304;9620;2684;-51;-95;44
33;9;1;Bela Vista;10220;7931;2289;-68;-44;-24
33;9;1;Belém Novo;10098;8448;1650;-17;3;-20
33;9;1;Belém Velho;10186;8048;2138;24;4;20
33;9;1;Boa Vista;8539;6616;1923;-41;-30;-11
33;9;1;Boa Vista do Sul;1471;1326;145;17;7;10
33;9;1;Bom Fim;9860;7730;2130;-91;-67;-24
33;9;1;Bom Jesus;30994;24255;6739;92;-93;185
33;9;1;Camaquã;18074;14352;3722;13;-44;57
33;9;1;Campo Novo;7702;6179;1523;-10;-12;2
33;9;1;Cascata;12317;9628;2689;32;-29;61
33;9;1;Cavalhada;31648;25596;6052;30;-47;77
33;9;1;Centro;44424;35813;8611;234;-59;293
33;9;1;Chácara das Pedras;4757;3792;965;-47;-22;-25
33;9;1;Chapéu do Sol;1769;1566;203;-23;-18;-5
33;9;1;Cidade Baixa;14489;11329;3160;-37;-95;58
33;9;1;Coronel Aparício Borges;19206;14907;4299;65;-63;128
33;9;1;Costa e Silva;14971;11693;3278;-6;-80;74
33;9;1;Cristal;35362;28600;6762;45;-54;99
33;9;1;Cristo Redentor;15772;12265;3507;126;8;118
33;9;1;Espírito Santo;4301;3575;726;3;-5;8
33;9;1;Extrema;1343;1165;178;17;11;6
33;9;1;Farrapos;20275;16431;3844;10;-20;30
33;9;1;Farroupilha;193;193;0;-3;24;-27
33;9;1;Floresta;10384;8091;2293;21;-61;82
33;9;1;Glória;16571;12929;3642;100;-59;159
33;9;1;Guarujá;3587;3007;580;22;-3;25
33;9;1;Higienópolis;9353;7208;2145;14;-36;50
33;9;1;Hípica;19580;16132;3448;35;-32;67
33;9;1;Humaitá;11068;8814;2254;51;-17;68
33;9;1;Independência;6247;4902;1345;-53;-81;28
33;9;1;Ipanema;13530;10899;2631;52;-7;59
33;9;1;Jardim Botânico;10843;8419;2424;10;-61;71
33;9;1;Jardim Carvalho;27144;21524;5620;153;-36;189
33;9;1;Jardim do Salso;2330;1799;531;-114;-21;-93
33;9;1;Jardim Dona Leopoldina;17098;13432;3666;-35;-107;72
33;9;1;Jardim Europa;839;654;185;-33;17;-50
33;9;1;Jardim Floresta;1676;1309;367;-34;26;-60
33;9;1;Jardim Isabel;1507;1187;320;21;34;-13
33;9;1;Jardim Itu;17312;13554;3758;29;-73;102
33;9;1;Jardim Lindóia;5788;4588;1200;15;-9;24
33;9;1;Jardim Sabará;12285;9565;2720;-26;-49;23
33;9;1;Jardim São Pedro;2246;1712;534;-44;-9;-35
33;9;1;Lageado;3380;2944;436;-8;7;-15
33;9;1;Lami;3456;3091;365;-2;8;-10
33;9;1;Lomba do Pinheiro;66291;55399;10892;198;-11;209
33;9;1;Mário Quintana;42545;34538;8007;26;-86;112
33;9;1;Medianeira;9676;7516;2160;4;-51;55
33;9;1;Menino Deus;34540;27572;6968;77;-107;184
33;9;1;Moinhos de Vento;10478;8067;2411;18;-62;80
33;9;1;MontSerrat;9715;7521;2194;-18;-61;43
33;9;1;Morro Santana;19727;15698;4029;-6;-93;87
33;9;1;Navegantes;2851;2160;691;-7;9;-16
33;9;1;Nonoai;26580;21226;5354;38;-88;126
33;9;1;Parque Santa Fé;4446;3473;973;-135;-44;-91
33;9;1;Partenon;54448;43616;10832;273;-86;359
33;9;1;Passo DAreia;22828;17871;4957;44;-33;77
33;9;1;Passo das Pedras;15056;11728;3328;46;-95;141
33;9;1;Pedra Redonda;55;44;11;-3;11;-14
33;9;1;Petrópolis;41532;32961;8571;161;-124;285
33;9;1;Pitinga;3295;2706;589;2;-2;4
33;9;1;Ponta Grossa;7982;6681;1301;-4;-17;13
33;9;1;Praia de Belas;943;689;254;-93;-21;-72
33;9;1;Restinga;60211;51146;9065;-66;-11;-55
33;9;1;Rio Branco;16726;12941;3785;32;-115;147
33;9;1;Rubem Berta;36165;29335;6830;161;-72;233
33;9;1;Santa Cecília;3679;2806;873;-106;-47;-59
33;9;1;Santa Maria Goretti;1991;1442;549;-58;-35;-23
33;9;1;Santa Rosa de Lima;39028;32270;6758;67;-57;124
33;9;1;Santa Tereza;44141;35776;8365;72;-95;167
33;9;1;Santana;20751;16180;4571;31;-136;167
33;9;1;Santo Antônio;11852;9208;2644;-46;-97;51
33;9;1;São Caetano;597;285;312;-9;8;-17
33;9;1;São Geraldo;7451;5533;1918;-71;-42;-29
33;9;1;São João;11336;8861;2475;2;-22;24
33;9;1;São Sebastião;5279;3984;1295;-79;-26;-53
33;9;1;Sarandi;67659;56178;11481;-17;-71;54
33;9;1;Serraria;5355;4192;1163;-10;-26;16
33;9;1;Sétimo Céu;530;370;160;-40;15;-55
33;9;1;Teresópolis;13595;10668;2927;-105;-106;1
33;9;1;Três Figueiras;2439;1675;764;-81;-45;-36
33;9;1;Tristeza;16687;13689;2998;26;27;-1
33;9;1;Vila Assunção;3195;2394;801;-85;-19;-66
33;9;1;Vila Conceição;858;482;376;-50;6;-56
33;9;1;Vila Ipiranga;18145;14342;3803;-120;-101;-19
33;9;1;Vila Jardim;12107;9054;3053;-106;-88;-18
33;9;1;Vila João Pessoa;11767;8847;2920;-37;-48;11
33;9;1;Vila Nova;35597;29392;6205;-111;-47;-64
33;9;1;Vila São José;28199;22644;5555;-183;-122;-61
34;10;1;Aberta dos Morros;6302;5260;1042;49;188;-139
34;10;1;Agronomia;1472;1191;281;193;92;101
34;10;1;Anchieta;1236;988;248;168;94;74
34;10;1;Arquipélago;7821;6321;1500;47;181;-134
34;10;1;Auxiliadora;8202;6624;1578;52;282;-230
34;10;1;Azenha;12332;9900;2432;28;280;-252
34;10;1;Bela Vista;10282;8240;2042;62;309;-247
34;10;1;Belém Novo;10072;8628;1444;-26;180;-206
34;10;1;Belém Velho;10218;8266;1952;32;218;-186
34;10;1;Boa Vista;8626;6920;1706;87;304;-217
34;10;1;Boa Vista do Sul;1743;1529;214;272;203;69
34;10;1;Bom Fim;9932;8035;1897;72;305;-233
34;10;1;Bom Jesus;30954;24569;6385;-40;314;-354
34;10;1;Camaquã;18012;14579;3433;-62;227;-289
34;10;1;Campo Novo;7769;6457;1312;67;278;-211
34;10;1;Cascata;12280;9880;2400;-37;252;-289
34;10;1;Cavalhada;31716;25752;5964;68;156;-88
34;10;1;Centro;44291;35732;8559;-133;-81;-52
34;10;1;Chácara das Pedras;5171;4187;984;414;395;19
34;10;1;Chapéu do Sol;2092;1791;301;323;225;98
34;10;1;Cidade Baixa;14448;11635;2813;-41;306;-347
34;10;1;Coronel Aparício Borges;19039;15172;3867;-167;265;-432
34;10;1;Costa e Silva;14842;11939;2903;-129;246;-375
34;10;1;Cristal;35176;28719;6457;-186;119;-305
34;10;1;Cristo Redentor;15659;12539;3120;-113;274;-387
34;10;1;Espírito Santo;4533;3801;732;232;226;6
34;10;1;Extrema;1499;1304;195;156;139;17
34;10;1;Farrapos;20189;16539;3650;-86;108;-194
34;10;1;Farroupilha;188;188;0;-5;-5;0
34;10;1;Floresta;10324;8398;1926;-60;307;-367
34;10;1;Glória;16363;13177;3186;-208;248;-456
34;10;1;Guarujá;3859;3243;616;272;236;36
34;10;1;Higienópolis;9346;7518;1828;-7;310;-317
34;10;1;Hípica;19385;16208;3177;-195;76;-271
34;10;1;Humaitá;11033;8997;2036;-35;183;-218
34;10;1;Independência;6673;5226;1447;426;324;102
34;10;1;Ipanema;13411;11089;2322;-119;190;-309
34;10;1;Jardim Botânico;10931;8775;2156;88;356;-268
34;10;1;Jardim Carvalho;26851;21659;5192;-293;135;-428
34;10;1;Jardim do Salso;2754;2186;568;424;387;37
34;10;1;Jardim Dona Leopoldina;16900;13694;3206;-198;262;-460
34;10;1;Jardim Europa;1001;679;322;162;25;137
34;10;1;Jardim Floresta;1963;1550;413;287;241;46
34;10;1;Jardim Isabel;1782;1423;359;275;236;39
34;10;1;Jardim Itu;17171;13792;3379;-141;238;-379
34;10;1;Jardim Lindóia;6091;4842;1249;303;254;49
34;10;1;Jardim Sabará;12308;9916;2392;23;351;-328
34;10;1;Jardim São Pedro;2543;2016;527;297;304;-7
34;10;1;Lageado;3581;3138;443;201;194;7
34;10;1;Lami;3667;3263;404;211;172;39
34;10;1;Lomba do Pinheiro;65903;55315;10588;-388;-84;-304
34;10;1;Mário Quintana;42105;34654;7451;-440;116;-556
34;10;1;Medianeira;9667;7878;1789;-9;362;-371
34;10;1;Menino Deus;34198;27662;6536;-342;90;-432
34;10;1;Moinhos de Vento;10455;8338;2117;-23;271;-294
34;10;1;MontSerrat;9697;7841;1856;-18;320;-338
34;10;1;Morro Santana;19569;15835;3734;-158;137;-295
34;10;1;Navegantes;3270;2420;850;419;260;159
34;10;1;Nonoai;26396;21394;5002;-184;168;-352
34;10;1;Parque Santa Fé;4631;3721;910;185;248;-63
34;10;1;Partenon;54178;43760;10418;-270;144;-414
34;10;1;Passo DAreia;22689;18100;4589;-139;229;-368
34;10;1;Passo das Pedras;14880;11931;2949;-176;203;-379
34;10;1;Pedra Redonda;41;39;2;-14;-5;-9
34;10;1;Petrópolis;41264;33119;8145;-268;158;-426
34;10;1;Pitinga;3466;2842;624;171;136;35
34;10;1;Ponta Grossa;7902;6859;1043;-80;178;-258
34;10;1;Praia de Belas;1171;773;398;228;84;144
34;10;1;Restinga;59246;50996;8250;-965;-150;-815
34;10;1;Rio Branco;16561;13231;3330;-165;290;-455
34;10;1;Rubem Berta;35808;29373;6435;-357;38;-395
34;10;1;Santa Cecília;4083;3207;876;404;401;3
34;10;1;Santa Maria Goretti;2236;1731;505;245;289;-44
34;10;1;Santa Rosa de Lima;38721;32211;6510;-307;-59;-248
34;10;1;Santa Tereza;43800;35825;7975;-341;49;-390
34;10;1;Santana;20529;16434;4095;-222;254;-476
34;10;1;Santo Antônio;11854;9514;2340;2;306;-304
34;10;1;São Caetano;498;293;205;-99;8;-107
34;10;1;São Geraldo;7416;5811;1605;-35;278;-313
34;10;1;São João;11481;9166;2315;145;305;-160
34;10;1;São Sebastião;5583;4272;1311;304;288;16
34;10;1;Sarandi;67617;56224;11393;-42;46;-88
34;10;1;Serraria;5410;4411;999;55;219;-164
34;10;1;Sétimo Céu;496;360;136;-34;-10;-24
34;10;1;Teresópolis;13474;10942;2532;-121;274;-395
34;10;1;Três Figueiras;2826;1988;838;387;313;74
34;10;1;Tristeza;16592;13877;2715;-95;188;-283
34;10;1;Vila Assunção;3429;2652;777;234;258;-24
34;10;1;Vila Conceição;760;518;242;-98;36;-134
34;10;1;Vila Ipiranga;18078;14552;3526;-67;210;-277
34;10;1;Vila Jardim;12149;9451;2698;42;397;-355
34;10;1;Vila João Pessoa;11673;9196;2477;-94;349;-443
34;10;1;Vila Nova;35338;29486;5852;-259;94;-353
34;10;1;Vila São José;28178;22883;5295;-21;239;-260
35;11;1;Aberta dos Morros;6640;6101;539;338;841;-503
35;11;1;Agronomia;1436;1320;116;-36;129;-165
35;11;1;Anchieta;1169;1080;89;-67;92;-159
35;11;1;Arquipélago;8220;7305;915;399;984;-585
35;11;1;Auxiliadora;8579;7917;662;377;1293;-916
35;11;1;Azenha;13002;11871;1131;670;1971;-1301
35;11;1;Bela Vista;10770;9794;976;488;1554;-1066
35;11;1;Belém Novo;10128;9295;833;56;667;-611
35;11;1;Belém Velho;10727;9580;1147;509;1314;-805
35;11;1;Boa Vista;8955;8238;717;329;1318;-989
35;11;1;Boa Vista do Sul;1740;1628;112;-3;99;-102
35;11;1;Bom Fim;10323;9540;783;391;1505;-1114
35;11;1;Bom Jesus;30478;26538;3940;-476;1969;-2445
35;11;1;Camaquã;18175;16187;1988;163;1608;-1445
35;11;1;Campo Novo;8174;7484;690;405;1027;-622
35;11;1;Cascata;12844;11419;1425;564;1539;-975
35;11;1;Cavalhada;31058;27362;3696;-658;1610;-2268
35;11;1;Centro;42556;37273;5283;-1735;1541;-3276
35;11;1;Chácara das Pedras;5213;4833;380;42;646;-604
35;11;1;Chapéu do Sol;2089;1957;132;-3;166;-169
35;11;1;Cidade Baixa;14954;13415;1539;506;1780;-1274
35;11;1;Coronel Aparício Borges;19347;17096;2251;308;1924;-1616
35;11;1;Costa e Silva;15400;13774;1626;558;1835;-1277
35;11;1;Cristal;34237;30152;4085;-939;1433;-2372
35;11;1;Cristo Redentor;16195;14413;1782;536;1874;-1338
35;11;1;Espírito Santo;4679;4332;347;146;531;-385
35;11;1;Extrema;1489;1401;88;-10;97;-107
35;11;1;Farrapos;20052;17755;2297;-137;1216;-1353
35;11;1;Farroupilha;267;267;0;79;79;0
35;11;1;Floresta;10783;9746;1037;459;1348;-889
35;11;1;Glória;16818;15013;1805;455;1836;-1381
35;11;1;Guarujá;3972;3681;291;113;438;-325
35;11;1;Higienópolis;9721;8842;879;375;1324;-949
35;11;1;Hípica;19276;17231;2045;-109;1023;-1132
35;11;1;Humaitá;11421;10224;1197;388;1227;-839
35;11;1;Independência;6867;6141;726;194;915;-721
35;11;1;Ipanema;13567;12239;1328;156;1150;-994
35;11;1;Jardim Botânico;11388;10349;1039;457;1574;-1117
35;11;1;Jardim Carvalho;26641;23362;3279;-210;1703;-1913
35;11;1;Jardim do Salso;2775;2571;204;21;385;-364
35;11;1;Jardim Dona Leopoldina;17461;15603;1858;561;1909;-1348
35;11;1;Jardim Europa;1192;871;321;191;192;-1
35;11;1;Jardim Floresta;1973;1874;99;10;324;-314
35;11;1;Jardim Isabel;1797;1689;108;15;266;-251
35;11;1;Jardim Itu;17716;15675;2041;545;1883;-1338
35;11;1;Jardim Lindóia;6307;5629;678;216;787;-571
35;11;1;Jardim Sabará;12904;11512;1392;596;1596;-1000
35;11;1;Jardim São Pedro;2561;2371;190;18;355;-337
35;11;1;Lageado;3697;3482;215;116;344;-228
35;11;1;Lami;3777;3559;218;110;296;-186
35;11;1;Lomba do Pinheiro;63364;56477;6887;-2539;1162;-3701
35;11;1;Mário Quintana;40827;36188;4639;-1278;1534;-2812
35;11;1;Medianeira;10116;9194;922;449;1316;-867
35;11;1;Menino Deus;33537;29420;4117;-661;1758;-2419
35;11;1;Moinhos de Vento;10951;9835;1116;496;1497;-1001
35;11;1;MontSerrat;10089;9117;972;392;1276;-884
35;11;1;Morro Santana;19819;17425;2394;250;1590;-1340
35;11;1;Navegantes;3419;2922;497;149;502;-353
35;11;1;Nonoai;26112;23052;3060;-284;1658;-1942
35;11;1;Parque Santa Fé;4811;4460;351;180;739;-559
35;11;1;Partenon;52270;45745;6525;-1908;1985;-3893
35;11;1;Passo DAreia;22598;19833;2765;-91;1733;-1824
35;11;1;Passo das Pedras;15456;13712;1744;576;1781;-1205
35;11;1;Pedra Redonda;66;66;0;25;27;-2
35;11;1;Petrópolis;40177;35018;5159;-1087;1899;-2986
35;11;1;Pitinga;3591;3329;262;125;487;-362
35;11;1;Ponta Grossa;8225;7651;574;323;792;-469
35;11;1;Praia de Belas;1333;961;372;162;188;-26
35;11;1;Restinga;57310;51938;5372;-1936;942;-2878
35;11;1;Rio Branco;17011;15083;1928;450;1852;-1402
35;11;1;Rubem Berta;35031;30960;4071;-777;1587;-2364
35;11;1;Santa Cecília;4169;3789;380;86;582;-496
35;11;1;Santa Maria Goretti;2183;1985;198;-53;254;-307
35;11;1;Santa Rosa de Lima;37832;33547;4285;-889;1336;-2225
35;11;1;Santa Tereza;42516;37442;5074;-1284;1617;-2901
35;11;1;Santana;20804;18331;2473;275;1897;-1622
35;11;1;Santo Antônio;12358;11010;1348;504;1496;-992
35;11;1;São Caetano;506;347;159;8;54;-46
35;11;1;São Geraldo;7748;6997;751;332;1186;-854
35;11;1;São João;12000;10420;1580;519;1254;-735
35;11;1;São Sebastião;5869;5206;663;286;934;-648
35;11;1;Sarandi;65339;57595;7744;-2278;1371;-3649
35;11;1;Serraria;5580;5134;446;170;723;-553
35;11;1;Sétimo Céu;547;493;54;51;133;-82
35;11;1;Teresópolis;14130;12570;1560;656;1628;-972
35;11;1;Três Figueiras;2857;2267;590;31;279;-248
35;11;1;Tristeza;16797;15043;1754;205;1166;-961
35;11;1;Vila Assunção;3532;3148;384;103;496;-393
35;11;1;Vila Conceição;762;600;162;2;82;-80
35;11;1;Vila Ipiranga;18614;16308;2306;536;1756;-1220
35;11;1;Vila Jardim;12740;11168;1572;591;1717;-1126
35;11;1;Vila João Pessoa;12281;10911;1370;608;1715;-1107
35;11;1;Vila Nova;34606;30735;3871;-732;1249;-1981
35;11;1;Vila São José;27958;24587;3371;-220;1704;-1924
36;12;1;Aberta dos Morros;6550;5569;981;-90;-532;442
36;12;1;Agronomia;1377;1157;220;-59;-163;104
36;12;1;Anchieta;1112;939;173;-57;-141;84
36;12;1;Arquipélago;8062;6720;1342;-158;-585;427
36;12;1;Auxiliadora;8374;7012;1362;-205;-905;700
36;12;1;Azenha;12859;10872;1987;-143;-999;856
36;12;1;Bela Vista;10447;8758;1689;-323;-1036;713
36;12;1;Belém Novo;10238;8960;1278;110;-335;445
36;12;1;Belém Velho;10626;8933;1693;-101;-647;546
36;12;1;Boa Vista;8709;7338;1371;-246;-900;654
36;12;1;Boa Vista do Sul;1576;1461;115;-164;-167;3
36;12;1;Bom Fim;10161;8576;1585;-162;-964;802
36;12;1;Bom Jesus;31158;25599;5559;680;-939;1619
36;12;1;Camaquã;18318;15514;2804;143;-673;816
36;12;1;Campo Novo;7987;6860;1127;-187;-624;437
36;12;1;Cascata;12650;10637;2013;-194;-782;588
36;12;1;Cavalhada;31806;26747;5059;748;-615;1363
36;12;1;Centro;44130;36664;7466;1574;-609;2183
36;12;1;Chácara das Pedras;5076;4282;794;-137;-551;414
36;12;1;Chapéu do Sol;1917;1769;148;-172;-188;16
36;12;1;Cidade Baixa;14744;12571;2173;-210;-844;634
36;12;1;Coronel Aparício Borges;19360;16169;3191;13;-927;940
36;12;1;Costa e Silva;15101;12820;2281;-299;-954;655
36;12;1;Cristal;34939;29392;5547;702;-760;1462
36;12;1;Cristo Redentor;15900;13595;2305;-295;-818;523
36;12;1;Espírito Santo;4386;3849;537;-293;-483;190
36;12;1;Extrema;1324;1234;90;-165;-167;2
36;12;1;Farrapos;20440;17150;3290;388;-605;993
36;12;1;Farroupilha;216;165;51;-51;-102;51
36;12;1;Floresta;10481;8913;1568;-302;-833;531
36;12;1;Glória;16630;14116;2514;-188;-897;709
36;12;1;Guarujá;3711;3247;464;-261;-434;173
36;12;1;Higienópolis;9373;7898;1475;-348;-944;596
36;12;1;Hípica;19432;16685;2747;156;-546;702
36;12;1;Humaitá;11202;9557;1645;-219;-667;448
36;12;1;Independência;6542;5469;1073;-325;-672;347
36;12;1;Ipanema;13432;11588;1844;-135;-651;516
36;12;1;Jardim Botânico;11026;9330;1696;-362;-1019;657
36;12;1;Jardim Carvalho;26891;22492;4399;250;-870;1120
36;12;1;Jardim do Salso;2792;2227;565;17;-344;361
36;12;1;Jardim Dona Leopoldina;17172;14602;2570;-289;-1001;712
36;12;1;Jardim Europa;964;715;249;-228;-156;-72
36;12;1;Jardim Floresta;1909;1562;347;-64;-312;248
36;12;1;Jardim Isabel;1619;1359;260;-178;-330;152
36;12;1;Jardim Itu;17329;14625;2704;-387;-1050;663
36;12;1;Jardim Lindóia;5954;5021;933;-353;-608;255
36;12;1;Jardim Sabará;12344;10462;1882;-560;-1050;490
36;12;1;Jardim São Pedro;2546;2045;501;-15;-326;311
36;12;1;Lageado;3426;3089;337;-271;-393;122
36;12;1;Lami;3548;3230;318;-229;-329;100
36;12;1;Lomba do Pinheiro;65216;55672;9544;1852;-805;2657
36;12;1;Mário Quintana;41836;35247;6589;1009;-941;1950
36;12;1;Medianeira;9753;8249;1504;-363;-945;582
36;12;1;Menino Deus;34060;28572;5488;523;-848;1371
36;12;1;Moinhos de Vento;10638;8991;1647;-313;-844;531
36;12;1;MontSerrat;9749;8206;1543;-340;-911;571
36;12;1;Morro Santana;19766;16604;3162;-53;-821;768
36;12;1;Navegantes;3154;2502;652;-265;-420;155
36;12;1;Nonoai;26395;22158;4237;283;-894;1177
36;12;1;Parque Santa Fé;4632;3875;757;-179;-585;406
36;12;1;Partenon;53706;44647;9059;1436;-1098;2534
36;12;1;Passo DAreia;22551;18869;3682;-47;-964;917
36;12;1;Passo das Pedras;15005;12776;2229;-451;-936;485
36;12;1;Pedra Redonda;59;24;35;-7;-42;35
36;12;1;Petrópolis;40894;33917;6977;717;-1101;1818
36;12;1;Pitinga;3345;2965;380;-246;-364;118
36;12;1;Ponta Grossa;8093;7147;946;-132;-504;372
36;12;1;Praia de Belas;1093;740;353;-240;-221;-19
36;12;1;Restinga;58403;51034;7369;1093;-904;1997
36;12;1;Rio Branco;16625;14076;2549;-386;-1007;621
36;12;1;Rubem Berta;35393;30045;5348;362;-915;1277
36;12;1;Santa Cecília;4037;3216;821;-132;-573;441
36;12;1;Santa Maria Goretti;2134;1623;511;-49;-362;313
36;12;1;Santa Rosa de Lima;38484;32700;5784;652;-847;1499
36;12;1;Santa Tereza;43452;36422;7030;936;-1020;1956
36;12;1;Santana;20365;17250;3115;-439;-1081;642
36;12;1;Santo Antônio;11890;10033;1857;-468;-977;509
36;12;1;São Caetano;573;273;300;67;-74;141
36;12;1;São Geraldo;7510;6272;1238;-238;-725;487
36;12;1;São João;11362;9599;1763;-638;-821;183
36;12;1;São Sebastião;5581;4513;1068;-288;-693;405
36;12;1;Sarandi;67109;56732;10377;1770;-863;2633
36;12;1;Serraria;5364;4596;768;-216;-538;322
36;12;1;Sétimo Céu;554;353;201;7;-140;147
36;12;1;Teresópolis;13615;11573;2042;-515;-997;482
36;12;1;Três Figueiras;2628;1914;714;-229;-353;124
36;12;1;Tristeza;16532;14253;2279;-265;-790;525
36;12;1;Vila Assunção;3427;2661;766;-105;-487;382
36;12;1;Vila Conceição;834;436;398;72;-164;236
36;12;1;Vila Ipiranga;18250;15331;2919;-364;-977;613
36;12;1;Vila Jardim;12193;10176;2017;-547;-992;445
36;12;1;Vila João Pessoa;11740;9903;1837;-541;-1008;467
36;12;1;Vila Nova;35164;29837;5327;558;-898;1456
36;12;1;Vila São José;28321;23618;4703;363;-969;1332
37;13;1;Aberta dos Morros;6491;5533;958;-59;-36;-23
37;13;1;Agronomia;1321;1146;175;-56;-11;-45
37;13;1;Anchieta;1080;933;147;-32;-6;-26
37;13;1;Arquipélago;8063;6703;1360;1;-17;18
37;13;1;Auxiliadora;8279;7011;1268;-95;-1;-94
37;13;1;Azenha;12695;10815;1880;-164;-57;-107
37;13;1;Bela Vista;10268;8712;1556;-179;-46;-133
37;13;1;Belém Novo;10256;8957;1299;18;-3;21
37;13;1;Belém Velho;10604;8876;1728;-22;-57;35
37;13;1;Boa Vista;8554;7297;1257;-155;-41;-114
37;13;1;Boa Vista do Sul;1570;1450;120;-6;-11;5
37;13;1;Bom Fim;9949;8494;1455;-212;-82;-130
37;13;1;Bom Jesus;31277;25474;5803;119;-125;244
37;13;1;Camaquã;18320;15442;2878;2;-72;74
37;13;1;Campo Novo;7934;6803;1131;-53;-57;4
37;13;1;Cascata;12592;10534;2058;-58;-103;45
37;13;1;Cavalhada;32033;26645;5388;227;-102;329
37;13;1;Centro;44472;36606;7866;342;-58;400
37;13;1;Chácara das Pedras;4913;4219;694;-163;-63;-100
37;13;1;Chapéu do Sol;1869;1734;135;-48;-35;-13
37;13;1;Cidade Baixa;14695;12442;2253;-49;-129;80
37;13;1;Coronel Aparício Borges;19284;15993;3291;-76;-176;100
37;13;1;Costa e Silva;15019;12694;2325;-82;-126;44
37;13;1;Cristal;35106;29267;5839;167;-125;292
37;13;1;Cristo Redentor;15925;13596;2329;25;1;24
37;13;1;Espírito Santo;4354;3807;547;-32;-42;10
37;13;1;Extrema;1324;1232;92;0;-2;2
37;13;1;Farrapos;20515;17112;3403;75;-38;113
37;13;1;Farroupilha;158;158;0;-58;-7;-51
37;13;1;Floresta;10425;8837;1588;-56;-76;20
37;13;1;Glória;16627;13986;2641;-3;-130;127
37;13;1;Guarujá;3683;3222;461;-28;-25;-3
37;13;1;Higienópolis;9283;7832;1451;-90;-66;-24
37;13;1;Hípica;19518;16658;2860;86;-27;113
37;13;1;Humaitá;11288;9546;1742;86;-11;97
37;13;1;Independência;6460;5396;1064;-82;-73;-9
37;13;1;Ipanema;13478;11550;1928;46;-38;84
37;13;1;Jardim Botânico;10828;9193;1635;-198;-137;-61
37;13;1;Jardim Carvalho;27062;22360;4702;171;-132;303
37;13;1;Jardim do Salso;2601;2168;433;-191;-59;-132
37;13;1;Jardim Dona Leopoldina;17044;14419;2625;-128;-183;55
37;13;1;Jardim Europa;981;725;256;17;10;7
37;13;1;Jardim Floresta;1804;1564;240;-105;2;-107
37;13;1;Jardim Isabel;1597;1319;278;-22;-40;18
37;13;1;Jardim Itu;17350;14495;2855;21;-130;151
37;13;1;Jardim Lindóia;5901;4995;906;-53;-26;-27
37;13;1;Jardim Sabará;12328;10356;1972;-16;-106;90
37;13;1;Jardim São Pedro;2388;2011;377;-158;-34;-124
37;13;1;Lageado;3411;3072;339;-15;-17;2
37;13;1;Lami;3534;3227;307;-14;-3;-11
37;13;1;Lomba do Pinheiro;65486;55654;9832;270;-18;288
37;13;1;Mário Quintana;41904;35096;6808;68;-151;219
37;13;1;Medianeira;9643;8090;1553;-110;-159;49
37;13;1;Menino Deus;34372;28445;5927;312;-127;439
37;13;1;Moinhos de Vento;10588;8925;1663;-50;-66;16
37;13;1;MontSerrat;9716;8105;1611;-33;-101;68
37;13;1;Morro Santana;19808;16475;3333;42;-129;171
37;13;1;Navegantes;3104;2475;629;-50;-27;-23
37;13;1;Nonoai;26466;21968;4498;71;-190;261
37;13;1;Parque Santa Fé;4457;3728;729;-175;-147;-28
37;13;1;Partenon;54243;44520;9723;537;-127;664
37;13;1;Passo DAreia;22736;18771;3965;185;-98;283
37;13;1;Passo das Pedras;14963;12582;2381;-42;-194;152
37;13;1;Pedra Redonda;28;24;4;-31;0;-31
37;13;1;Petrópolis;41198;33761;7437;304;-156;460
37;13;1;Pitinga;3314;2937;377;-31;-28;-3
37;13;1;Ponta Grossa;8062;7132;930;-31;-15;-16
37;13;1;Praia de Belas;1024;712;312;-69;-28;-41
37;13;1;Restinga;58584;50997;7587;181;-37;218
37;13;1;Rio Branco;16797;13996;2801;172;-80;252
37;13;1;Rubem Berta;35565;29914;5651;172;-131;303
37;13;1;Santa Cecília;3818;3101;717;-219;-115;-104
37;13;1;Santa Maria Goretti;1989;1582;407;-145;-41;-104
37;13;1;Santa Rosa de Lima;38684;32638;6046;200;-62;262
37;13;1;Santa Tereza;43678;36318;7360;226;-104;330
37;13;1;Santana;20471;17085;3386;106;-165;271
37;13;1;Santo Antônio;11853;9861;1992;-37;-172;135
37;13;1;São Caetano;559;273;286;-14;0;-14
37;13;1;São Geraldo;7491;6196;1295;-19;-76;57
37;13;1;São João;11348;9560;1788;-14;-39;25
37;13;1;São Sebastião;5512;4484;1028;-69;-29;-40
37;13;1;Sarandi;67482;56647;10835;373;-85;458
37;13;1;Serraria;5362;4576;786;-2;-20;18
37;13;1;Sétimo Céu;501;363;138;-53;10;-63
37;13;1;Teresópolis;13632;11431;2201;17;-142;159
37;13;1;Três Figueiras;2377;1826;551;-251;-88;-163
37;13;1;Tristeza;16584;14246;2338;52;-7;59
37;13;1;Vila Assunção;3295;2615;680;-132;-46;-86
37;13;1;Vila Conceição;797;446;351;-37;10;-47
37;13;1;Vila Ipiranga;18255;15201;3054;5;-130;135
37;13;1;Vila Jardim;12123;10027;2096;-70;-149;79
37;13;1;Vila João Pessoa;11661;9732;1929;-79;-171;92
37;13;1;Vila Nova;35096;29742;5354;-68;-95;27
37;13;1;Vila São José;28214;23427;4787;-107;-191;84
38;14;1;Aberta dos Morros;6591;5588;1003;100;55;45
38;14;1;Agronomia;1479;1237;242;158;91;67
38;14;1;Anchieta;1250;1048;202;170;115;55
38;14;1;Arquipélago;8034;6754;1280;-29;51;-80
38;14;1;Auxiliadora;8454;7099;1355;175;88;87
38;14;1;Azenha;12764;10948;1816;69;133;-64
38;14;1;Bela Vista;10521;8837;1684;253;125;128
38;14;1;Belém Novo;10317;9043;1274;61;86;-25
38;14;1;Belém Velho;10594;8944;1650;-10;68;-78
38;14;1;Boa Vista;8813;7426;1387;259;129;130
38;14;1;Boa Vista do Sul;1736;1541;195;166;91;75
38;14;1;Bom Fim;10293;8670;1623;344;176;168
38;14;1;Bom Jesus;30960;25648;5312;-317;174;-491
38;14;1;Camaquã;18160;15506;2654;-160;64;-224
38;14;1;Campo Novo;8150;6921;1229;216;118;98
38;14;1;Cascata;12618;10648;1970;26;114;-88
38;14;1;Cavalhada;31580;26852;4728;-453;207;-660
38;14;1;Centro;43923;36689;7234;-549;83;-632
38;14;1;Chácara das Pedras;5165;4354;811;252;135;117
38;14;1;Chapéu do Sol;2109;1867;242;240;133;107
38;14;1;Cidade Baixa;14840;12575;2265;145;133;12
38;14;1;Coronel Aparício Borges;19138;16158;2980;-146;165;-311
38;14;1;Costa e Silva;15084;12856;2228;65;162;-97
38;14;1;Cristal;34670;29268;5402;-436;1;-437
38;14;1;Cristo Redentor;16330;13847;2483;405;251;154
38;14;1;Espírito Santo;4554;3908;646;200;101;99
38;14;1;Extrema;1501;1380;121;177;148;29
38;14;1;Farrapos;20113;17107;3006;-402;-5;-397
38;14;1;Farroupilha;166;166;0;8;8;0
38;14;1;Floresta;10677;9023;1654;252;186;66
38;14;1;Glória;16654;14050;2604;27;64;-37
38;14;1;Guarujá;3905;3347;558;222;125;97
38;14;1;Higienópolis;9512;7979;1533;229;147;82
38;14;1;Hípica;19077;16645;2432;-441;-13;-428
38;14;1;Humaitá;11163;9611;1552;-125;65;-190
38;14;1;Independência;6769;5632;1137;309;236;73
38;14;1;Ipanema;13538;11671;1867;60;121;-61
38;14;1;Jardim Botânico;11158;9471;1687;330;278;52
38;14;1;Jardim Carvalho;26477;22370;4107;-585;10;-595
38;14;1;Jardim do Salso;2822;2345;477;221;177;44
38;14;1;Jardim Dona Leopoldina;17129;14598;2531;85;179;-94
38;14;1;Jardim Europa;993;810;183;12;85;-73
38;14;1;Jardim Floresta;2002;1715;287;198;151;47
38;14;1;Jardim Isabel;1840;1513;327;243;194;49
38;14;1;Jardim Itu;17305;14675;2630;-45;180;-225
38;14;1;Jardim Lindóia;6159;5216;943;258;221;37
38;14;1;Jardim Sabará;12493;10518;1975;165;162;3
38;14;1;Jardim São Pedro;2572;2166;406;184;155;29
38;14;1;Lageado;3640;3243;397;229;171;58
38;14;1;Lami;3761;3393;368;227;166;61
38;14;1;Lomba do Pinheiro;64855;55638;9217;-631;-16;-615
38;14;1;Mário Quintana;41350;35085;6265;-554;-11;-543
38;14;1;Medianeira;9798;8231;1567;155;141;14
38;14;1;Menino Deus;33802;28398;5404;-570;-47;-523
38;14;1;Moinhos de Vento;10875;9139;1736;287;214;73
38;14;1;MontSerrat;9873;8283;1590;157;178;-21
38;14;1;Morro Santana;19446;16564;2882;-362;89;-451
38;14;1;Navegantes;3352;2670;682;248;195;53
38;14;1;Nonoai;25900;21976;3924;-566;8;-574
38;14;1;Parque Santa Fé;4678;3911;767;221;183;38
38;14;1;Partenon;53461;44450;9011;-782;-70;-712
38;14;1;Passo DAreia;22437;18968;3469;-299;197;-496
38;14;1;Passo das Pedras;14919;12704;2215;-44;122;-166
38;14;1;Pedra Redonda;22;19;3;-6;-5;-1
38;14;1;Petrópolis;40646;33849;6797;-552;88;-640
38;14;1;Pitinga;3541;3082;459;227;145;82
38;14;1;Ponta Grossa;8266;7293;973;204;161;43
38;14;1;Praia de Belas;1091;890;201;67;178;-111
38;14;1;Restinga;58347;50918;7429;-237;-79;-158
38;14;1;Rio Branco;16891;14187;2704;94;191;-97
38;14;1;Rubem Berta;35174;29899;5275;-391;-15;-376
38;14;1;Santa Cecília;3985;3247;738;167;146;21
38;14;1;Santa Maria Goretti;2198;1782;416;209;200;9
38;14;1;Santa Rosa de Lima;38250;32654;5596;-434;16;-450
38;14;1;Santa Tereza;43044;36264;6780;-634;-54;-580
38;14;1;Santana;20492;17200;3292;21;115;-94
38;14;1;Santo Antônio;12036;10008;2028;183;147;36
38;14;1;São Caetano;488;301;187;-71;28;-99
38;14;1;São Geraldo;7667;6369;1298;176;173;3
38;14;1;São João;11666;9812;1854;318;252;66
38;14;1;São Sebastião;5740;4777;963;228;293;-65
38;14;1;Sarandi;67040;56816;10224;-442;169;-611
38;14;1;Serraria;5543;4794;749;181;218;-37
38;14;1;Sétimo Céu;499;392;107;-2;29;-31
38;14;1;Teresópolis;13724;11521;2203;92;90;2
38;14;1;Três Figueiras;2574;2070;504;197;244;-47
38;14;1;Tristeza;16465;14290;2175;-119;44;-163
38;14;1;Vila Assunção;3498;2785;713;203;170;33
38;14;1;Vila Conceição;784;545;239;-13;99;-112
38;14;1;Vila Ipiranga;18238;15382;2856;-17;181;-198
38;14;1;Vila Jardim;12299;10192;2107;176;165;11
38;14;1;Vila João Pessoa;11812;9890;1922;151;158;-7
38;14;1;Vila Nova;34954;29957;4997;-142;215;-357
38;14;1;Vila São José;28078;23569;4509;-136;142;-278
39;15;1;Aberta dos Morros;6549;5566;983;-42;-22;-20
39;15;1;Agronomia;1410;1227;183;-69;-10;-59
39;15;1;Anchieta;1160;1044;116;-90;-4;-86
39;15;1;Arquipélago;8115;6771;1344;81;17;64
39;15;1;Auxiliadora;8316;7176;1140;-138;77;-215
39;15;1;Azenha;12296;10939;1357;-468;-9;-459
39;15;1;Bela Vista;10375;8902;1473;-146;65;-211
39;15;1;Belém Novo;10299;9019;1280;-18;-24;6
39;15;1;Belém Velho;10641;8949;1692;47;5;42
39;15;1;Boa Vista;8651;7449;1202;-162;23;-185
39;15;1;Boa Vista do Sul;1722;1535;187;-14;-6;-8
39;15;1;Bom Fim;10167;8764;1403;-126;94;-220
39;15;1;Bom Jesus;31159;25641;5518;199;-7;206
39;15;1;Camaquã;18154;15579;2575;-6;73;-79
39;15;1;Campo Novo;8131;6922;1209;-19;1;-20
39;15;1;Cascata;12611;10643;1968;-7;-5;-2
39;15;1;Cavalhada;31598;26839;4759;18;-13;31
39;15;1;Centro;44165;36801;7364;242;112;130
39;15;1;Chácara das Pedras;4995;4380;615;-170;26;-196
39;15;1;Chapéu do Sol;2071;1860;211;-38;-7;-31
39;15;1;Cidade Baixa;14891;12604;2287;51;29;22
39;15;1;Coronel Aparício Borges;19151;16140;3011;13;-18;31
39;15;1;Costa e Silva;15052;12861;2191;-32;5;-37
39;15;1;Cristal;34846;29182;5664;176;-86;262
39;15;1;Cristo Redentor;16034;13899;2135;-296;52;-348
39;15;1;Espírito Santo;4537;3889;648;-17;-19;2
39;15;1;Extrema;1489;1372;117;-12;-8;-4
39;15;1;Farrapos;20311;17116;3195;198;9;189
39;15;1;Farroupilha;179;179;0;13;13;0
39;15;1;Floresta;10744;9103;1641;67;80;-13
39;15;1;Glória;16659;13999;2660;5;-51;56
39;15;1;Guarujá;3871;3323;548;-34;-24;-10
39;15;1;Higienópolis;9538;8055;1483;26;76;-50
39;15;1;Hípica;19152;16606;2546;75;-39;114
39;15;1;Humaitá;11247;9611;1636;84;0;84
39;15;1;Independência;6456;5680;776;-313;48;-361
39;15;1;Ipanema;13546;11621;1925;8;-50;58
39;15;1;Jardim Botânico;10819;9471;1348;-339;0;-339
39;15;1;Jardim Carvalho;26716;22286;4430;239;-84;323
39;15;1;Jardim do Salso;2649;2331;318;-173;-14;-159
39;15;1;Jardim Dona Leopoldina;17061;14563;2498;-68;-35;-33
39;15;1;Jardim Europa;1021;834;187;28;24;4
39;15;1;Jardim Floresta;1909;1781;128;-93;66;-159
39;15;1;Jardim Isabel;1733;1488;245;-107;-25;-82
39;15;1;Jardim Itu;17319;14709;2610;14;34;-20
39;15;1;Jardim Lindóia;5882;5311;571;-277;95;-372
39;15;1;Jardim Sabará;12439;10479;1960;-54;-39;-15
39;15;1;Jardim São Pedro;2468;2221;247;-104;55;-159
39;15;1;Lageado;3637;3219;418;-3;-24;21
39;15;1;Lami;3737;3371;366;-24;-22;-2
39;15;1;Lomba do Pinheiro;65256;55623;9633;401;-15;416
39;15;1;Mário Quintana;41592;35007;6585;242;-78;320
39;15;1;Medianeira;9709;8195;1514;-89;-36;-53
39;15;1;Menino Deus;34012;28397;5615;210;-1;211
39;15;1;Moinhos de Vento;10651;9196;1455;-224;57;-281
39;15;1;MontSerrat;9876;8327;1549;3;44;-41
39;15;1;Morro Santana;19557;16498;3059;111;-66;177
39;15;1;Navegantes;3110;2682;428;-242;12;-254
39;15;1;Nonoai;25948;21870;4078;48;-106;154
39;15;1;Parque Santa Fé;4523;3886;637;-155;-25;-130
39;15;1;Partenon;53772;44382;9390;311;-68;379
39;15;1;Passo DAreia;22703;19028;3675;266;60;206
39;15;1;Passo das Pedras;14960;12646;2314;41;-58;99
39;15;1;Pedra Redonda;9;9;0;-13;-10;-3
39;15;1;Petrópolis;41124;33852;7272;478;3;475
39;15;1;Pitinga;3557;3079;478;16;-3;19
39;15;1;Ponta Grossa;8271;7255;1016;5;-38;43
39;15;1;Praia de Belas;1043;864;179;-48;-26;-22
39;15;1;Restinga;58355;50891;7464;8;-27;35
39;15;1;Rio Branco;17136;14250;2886;245;63;182
39;15;1;Rubem Berta;35400;29850;5550;226;-49;275
39;15;1;Santa Cecília;3774;3221;553;-211;-26;-185
39;15;1;Santa Maria Goretti;2081;1770;311;-117;-12;-105
39;15;1;Santa Rosa de Lima;38381;32624;5757;131;-30;161
39;15;1;Santa Tereza;43287;36111;7176;243;-153;396
39;15;1;Santana;20762;17250;3512;270;50;220
39;15;1;Santo Antônio;12000;9971;2029;-36;-37;1
39;15;1;São Caetano;479;279;200;-9;-22;13
39;15;1;São Geraldo;7757;6432;1325;90;63;27
39;15;1;São João;11634;9823;1811;-32;11;-43
39;15;1;São Sebastião;5513;4828;685;-227;51;-278
39;15;1;Sarandi;67246;56811;10435;206;-5;211
39;15;1;Serraria;5546;4748;798;3;-46;49
39;15;1;Sétimo Céu;450;375;75;-49;-17;-32
39;15;1;Teresópolis;13811;11456;2355;87;-65;152
39;15;1;Três Figueiras;2183;2006;177;-391;-64;-327
39;15;1;Tristeza;16541;14280;2261;76;-10;86
39;15;1;Vila Assunção;3462;2742;720;-36;-43;7
39;15;1;Vila Conceição;718;486;232;-66;-59;-7
39;15;1;Vila Ipiranga;18354;15368;2986;116;-14;130
39;15;1;Vila Jardim;12268;10116;2152;-31;-76;45
39;15;1;Vila João Pessoa;11801;9817;1984;-11;-73;62
39;15;1;Vila Nova;35062;29875;5187;108;-82;190
39;15;1;Vila São José;27999;23436;4563;-79;-133;54
40;16;1;Aberta dos Morros;6517;5674;843;-32;108;-140
40;16;1;Agronomia;1471;1362;109;61;135;-74
40;16;1;Anchieta;1225;1171;54;65;127;-62
40;16;1;Arquipélago;8189;6989;1200;74;218;-144
40;16;1;Auxiliadora;8332;7470;862;16;294;-278
40;16;1;Azenha;12417;11316;1101;121;377;-256
40;16;1;Bela Vista;10433;9254;1179;58;352;-294
40;16;1;Belém Novo;10316;9070;1246;17;51;-34
40;16;1;Belém Velho;10679;9138;1541;38;189;-151
40;16;1;Boa Vista;8786;7789;997;135;340;-205
40;16;1;Boa Vista do Sul;1699;1570;129;-23;35;-58
40;16;1;Bom Fim;10248;9173;1075;81;409;-328
40;16;1;Bom Jesus;30639;25965;4674;-520;324;-844
40;16;1;Camaquã;18157;15782;2375;3;203;-200
40;16;1;Campo Novo;8214;7144;1070;83;222;-139
40;16;1;Cascata;12750;10949;1801;139;306;-167
40;16;1;Cavalhada;31199;27086;4113;-399;247;-646
40;16;1;Centro;43687;37071;6616;-478;270;-748
40;16;1;Chácara das Pedras;5159;4708;451;164;328;-164
40;16;1;Chapéu do Sol;2056;1951;105;-15;91;-106
40;16;1;Cidade Baixa;14982;12972;2010;91;368;-277
40;16;1;Coronel Aparício Borges;19247;16521;2726;96;381;-285
40;16;1;Costa e Silva;15233;13227;2006;181;366;-185
40;16;1;Cristal;34419;29347;5072;-427;165;-592
40;16;1;Cristo Redentor;16035;14224;1811;1;325;-324
40;16;1;Espírito Santo;4547;4026;521;10;137;-127
40;16;1;Extrema;1504;1401;103;15;29;-14
40;16;1;Farrapos;20117;17237;2880;-194;121;-315
40;16;1;Farroupilha;148;148;0;-31;-31;0
40;16;1;Floresta;10805;9404;1401;61;301;-240
40;16;1;Glória;16790;14369;2421;131;370;-239
40;16;1;Guarujá;3892;3440;452;21;117;-96
40;16;1;Higienópolis;9634;8401;1233;96;346;-250
40;16;1;Hípica;19239;16719;2520;87;113;-26
40;16;1;Humaitá;11387;9790;1597;140;179;-39
40;16;1;Independência;6523;6067;456;67;387;-320
40;16;1;Ipanema;13587;11704;1883;41;83;-42
40;16;1;Jardim Botânico;10942;9836;1106;123;365;-242
40;16;1;Jardim Carvalho;26432;22530;3902;-284;244;-528
40;16;1;Jardim do Salso;2823;2569;254;174;238;-64
40;16;1;Jardim Dona Leopoldina;17212;14991;2221;151;428;-277
40;16;1;Jardim Europa;1060;926;134;39;92;-53
40;16;1;Jardim Floresta;1984;1939;45;75;158;-83
40;16;1;Jardim Isabel;1777;1613;164;44;125;-81
40;16;1;Jardim Itu;17384;15010;2374;65;301;-236
40;16;1;Jardim Lindóia;5955;5580;375;73;269;-196
40;16;1;Jardim Sabará;12559;10793;1766;120;314;-194
40;16;1;Jardim São Pedro;2604;2428;176;136;207;-71
40;16;1;Lageado;3644;3265;379;7;46;-39
40;16;1;Lami;3672;3356;316;-65;-15;-50
40;16;1;Lomba do Pinheiro;65199;55809;9390;-57;186;-243
40;16;1;Mário Quintana;41300;35269;6031;-292;262;-554
40;16;1;Medianeira;9911;8534;1377;202;339;-137
40;16;1;Menino Deus;33885;28840;5045;-127;443;-570
40;16;1;Moinhos de Vento;10758;9552;1206;107;356;-249
40;16;1;MontSerrat;10073;8702;1371;197;375;-178
40;16;1;Morro Santana;19521;16714;2807;-36;216;-252
40;16;1;Navegantes;3155;2850;305;45;168;-123
40;16;1;Nonoai;25866;22247;3619;-82;377;-459
40;16;1;Parque Santa Fé;4782;4244;538;259;358;-99
40;16;1;Partenon;53054;44612;8442;-718;230;-948
40;16;1;Passo DAreia;22628;19357;3271;-75;329;-404
40;16;1;Passo das Pedras;15171;13028;2143;211;382;-171
40;16;1;Pedra Redonda;35;1;34;26;-8;34
40;16;1;Petrópolis;40464;34106;6358;-660;254;-914
40;16;1;Pitinga;3583;3195;388;26;116;-90
40;16;1;Ponta Grossa;8290;7258;1032;19;3;16
40;16;1;Praia de Belas;1091;1019;72;48;155;-107
40;16;1;Restinga;58332;51072;7260;-23;181;-204
40;16;1;Rio Branco;17296;14641;2655;160;391;-231
40;16;1;Rubem Berta;34794;30092;4702;-606;242;-848
40;16;1;Santa Cecília;4001;3562;439;227;341;-114
40;16;1;Santa Maria Goretti;2218;1977;241;137;207;-70
40;16;1;Santa Rosa de Lima;37994;32746;5248;-387;122;-509
40;16;1;Santa Tereza;42985;36251;6734;-302;140;-442
40;16;1;Santana;20900;17655;3245;138;405;-267
40;16;1;Santo Antônio;12234;10302;1932;234;331;-97
40;16;1;São Caetano;575;287;288;96;8;88
40;16;1;São Geraldo;7894;6668;1226;137;236;-99
40;16;1;São João;11567;10051;1516;-67;228;-295
40;16;1;São Sebastião;5497;5035;462;-16;207;-223
40;16;1;Sarandi;66891;57048;9843;-355;237;-592
40;16;1;Serraria;5582;4765;817;36;17;19
40;16;1;Sétimo Céu;492;384;108;42;9;33
40;16;1;Teresópolis;13915;11835;2080;104;379;-275
40;16;1;Três Figueiras;2479;2278;201;296;272;24
40;16;1;Tristeza;16671;14421;2250;130;141;-11
40;16;1;Vila Assunção;3604;2928;676;142;186;-44
40;16;1;Vila Conceição;766;503;263;48;17;31
40;16;1;Vila Ipiranga;18599;15715;2884;245;347;-102
40;16;1;Vila Jardim;12543;10423;2120;275;307;-32
40;16;1;Vila João Pessoa;11934;10118;1816;133;301;-168
40;16;1;Vila Nova;34687;29793;4894;-375;-82;-293
40;16;1;Vila São José;27825;23598;4227;-174;162;-336
41;17;1;Aberta dos Morros;6786;6445;341;269;771;-502
41;17;1;Agronomia;1758;1746;12;287;384;-97
41;17;1;Anchieta;1498;1497;1;273;326;-53
41;17;1;Arquipélago;8309;7803;506;120;814;-694
41;17;1;Auxiliadora;8872;8630;242;540;1160;-620
41;17;1;Azenha;13021;12696;325;604;1380;-776
41;17;1;Bela Vista;10993;10608;385;560;1354;-794
41;17;1;Belém Novo;10180;9565;615;-136;495;-631
41;17;1;Belém Velho;10852;10084;768;173;946;-773
41;17;1;Boa Vista;9334;8995;339;548;1206;-658
41;17;1;Boa Vista do Sul;1913;1862;51;214;292;-78
41;17;1;Bom Fim;10892;10506;386;644;1333;-689
41;17;1;Bom Jesus;29774;27344;2430;-865;1379;-2244
41;17;1;Camaquã;18112;16897;1215;-45;1115;-1160
41;17;1;Campo Novo;8526;8000;526;312;856;-544
41;17;1;Cascata;12997;12065;932;247;1116;-869
41;17;1;Cavalhada;30321;28188;2133;-878;1102;-1980
41;17;1;Centro;41670;38175;3495;-2017;1104;-3121
41;17;1;Chácara das Pedras;5699;5630;69;540;922;-382
41;17;1;Chapéu do Sol;2346;2308;38;290;357;-67
41;17;1;Cidade Baixa;15171;14218;953;189;1246;-1057
41;17;1;Coronel Aparício Borges;19303;17936;1367;56;1415;-1359
41;17;1;Costa e Silva;15474;14574;900;241;1347;-1106
41;17;1;Cristal;33569;30508;3061;-850;1161;-2011
41;17;1;Cristo Redentor;16198;15463;735;163;1239;-1076
41;17;1;Espírito Santo;4937;4734;203;390;708;-318
41;17;1;Extrema;1674;1594;80;170;193;-23
41;17;1;Farrapos;19660;18145;1515;-457;908;-1365
41;17;1;Farroupilha;348;348;0;200;200;0
41;17;1;Floresta;11156;10581;575;351;1177;-826
41;17;1;Glória;17014;15735;1279;224;1366;-1142
41;17;1;Guarujá;4241;4068;173;349;628;-279
41;17;1;Higienópolis;10098;9641;457;464;1240;-776
41;17;1;Hípica;18925;17567;1358;-314;848;-1162
41;17;1;Humaitá;11587;10760;827;200;970;-770
41;17;1;Independência;7227;7090;137;704;1023;-319
41;17;1;Ipanema;13593;12623;970;6;919;-913
41;17;1;Jardim Botânico;11672;11285;387;730;1449;-719
41;17;1;Jardim Carvalho;26126;23878;2248;-306;1348;-1654
41;17;1;Jardim do Salso;3295;3275;20;472;706;-234
41;17;1;Jardim Dona Leopoldina;17503;16409;1094;291;1418;-1127
41;17;1;Jardim Europa;1391;1320;71;331;394;-63
41;17;1;Jardim Floresta;2486;2479;7;502;540;-38
41;17;1;Jardim Isabel;2137;2089;48;360;476;-116
41;17;1;Jardim Itu;17578;16385;1193;194;1375;-1181
41;17;1;Jardim Lindóia;6654;6527;127;699;947;-248
41;17;1;Jardim Sabará;13071;12170;901;512;1377;-865
41;17;1;Jardim São Pedro;3061;3030;31;457;602;-145
41;17;1;Lageado;3907;3756;151;263;491;-228
41;17;1;Lami;3914;3748;166;242;392;-150
41;17;1;Lomba do Pinheiro;62700;56850;5850;-2499;1041;-3540
41;17;1;Mário Quintana;40026;36464;3562;-1274;1195;-2469
41;17;1;Medianeira;10473;9872;601;562;1338;-776
41;17;1;Menino Deus;33188;30173;3015;-697;1333;-2030
41;17;1;Moinhos de Vento;11293;10813;480;535;1261;-726
41;17;1;MontSerrat;10603;9953;650;530;1251;-721
41;17;1;Morro Santana;19461;17940;1521;-60;1226;-1286
41;17;1;Navegantes;3800;3587;213;645;737;-92
41;17;1;Nonoai;25614;23513;2101;-252;1266;-1518
41;17;1;Parque Santa Fé;5242;5099;143;460;855;-395
41;17;1;Partenon;51347;46071;5276;-1707;1459;-3166
41;17;1;Passo DAreia;22391;20567;1824;-237;1210;-1447
41;17;1;Passo das Pedras;15611;14444;1167;440;1416;-976
41;17;1;Pedra Redonda;55;55;0;20;54;-34
41;17;1;Petrópolis;39134;35578;3556;-1330;1472;-2802
41;17;1;Pitinga;3907;3723;184;324;528;-204
41;17;1;Ponta Grossa;8433;7880;553;143;622;-479
41;17;1;Praia de Belas;1484;1422;62;393;403;-10
41;17;1;Restinga;56390;52167;4223;-1942;1095;-3037
41;17;1;Rio Branco;17470;16045;1425;174;1404;-1230
41;17;1;Rubem Berta;34048;31355;2693;-746;1263;-2009
41;17;1;Santa Cecília;4608;4456;152;607;894;-287
41;17;1;Santa Maria Goretti;2614;2565;49;396;588;-192
41;17;1;Santa Rosa de Lima;36968;33832;3136;-1026;1086;-2112
41;17;1;Santa Tereza;41435;37469;3966;-1550;1218;-2768
41;17;1;Santana;20955;19093;1862;55;1438;-1383
41;17;1;Santo Antônio;12683;11661;1022;449;1359;-910
41;17;1;São Caetano;621;391;230;46;104;-58
41;17;1;São Geraldo;8263;7657;606;369;989;-620
41;17;1;São João;11970;11162;808;403;1111;-708
41;17;1;São Sebastião;6206;6041;165;709;1006;-297
41;17;1;Sarandi;64243;58137;6106;-2648;1089;-3737
41;17;1;Serraria;5845;5397;448;263;632;-369
41;17;1;Sétimo Céu;680;643;37;188;259;-71
41;17;1;Teresópolis;14428;13205;1223;513;1370;-857
41;17;1;Três Figueiras;2961;2935;26;482;657;-175
41;17;1;Tristeza;16611;15391;1220;-60;970;-1030
41;17;1;Vila Assunção;3759;3574;185;155;646;-491
41;17;1;Vila Conceição;856;717;139;90;214;-124
41;17;1;Vila Ipiranga;18668;17054;1614;69;1339;-1270
41;17;1;Vila Jardim;12796;11724;1072;253;1301;-1048
41;17;1;Vila João Pessoa;12401;11457;944;467;1339;-872
41;17;1;Vila Nova;33277;30817;2460;-1410;1024;-2434
41;17;1;Vila São José;27010;24767;2243;-815;1169;-1984
42;18;1;Aberta dos Morros;6840;6420;420;54;-25;79
42;18;1;Agronomia;1866;1802;64;108;56;52
42;18;1;Anchieta;1526;1508;18;28;11;17
42;18;1;Arquipélago;8273;7761;512;-36;-42;6
42;18;1;Auxiliadora;9031;8602;429;159;-28;187
42;18;1;Azenha;13267;12610;657;246;-86;332
42;18;1;Bela Vista;11082;10529;553;89;-79;168
42;18;1;Belém Novo;10221;9495;726;41;-70;111
42;18;1;Belém Velho;10791;10043;748;-61;-41;-20
42;18;1;Boa Vista;9404;8949;455;70;-46;116
42;18;1;Boa Vista do Sul;2094;1933;161;181;71;110
42;18;1;Bom Fim;10962;10419;543;70;-87;157
42;18;1;Bom Jesus;29244;27199;2045;-530;-145;-385
42;18;1;Camaquã;17933;16753;1180;-179;-144;-35
42;18;1;Campo Novo;8520;7948;572;-6;-52;46
42;18;1;Cascata;12929;12054;875;-68;-11;-57
42;18;1;Cavalhada;30179;28111;2068;-142;-77;-65
42;18;1;Centro;41031;37958;3073;-639;-217;-422
42;18;1;Chácara das Pedras;5855;5590;265;156;-40;196
42;18;1;Chapéu do Sol;2451;2336;115;105;28;77
42;18;1;Cidade Baixa;15100;14131;969;-71;-87;16
42;18;1;Coronel Aparício Borges;19246;17906;1340;-57;-30;-27
42;18;1;Costa e Silva;15412;14493;919;-62;-81;19
42;18;1;Cristal;32841;30284;2557;-728;-224;-504
42;18;1;Cristo Redentor;16329;15446;883;131;-17;148
42;18;1;Espírito Santo;5048;4749;299;111;15;96
42;18;1;Extrema;1802;1700;102;128;106;22
42;18;1;Farrapos;19443;18005;1438;-217;-140;-77
42;18;1;Farroupilha;316;316;0;-32;-32;0
42;18;1;Floresta;11183;10522;661;27;-59;86
42;18;1;Glória;16848;15663;1185;-166;-72;-94
42;18;1;Guarujá;4330;4038;292;89;-30;119
42;18;1;Higienópolis;10161;9598;563;63;-43;106
42;18;1;Hípica;18880;17462;1418;-45;-105;60
42;18;1;Humaitá;11501;10677;824;-86;-83;-3
42;18;1;Independência;7445;7061;384;218;-29;247
42;18;1;Ipanema;13725;12680;1045;132;57;75
42;18;1;Jardim Botânico;11927;11309;618;255;24;231
42;18;1;Jardim Carvalho;25873;23813;2060;-253;-65;-188
42;18;1;Jardim do Salso;3455;3321;134;160;46;114
42;18;1;Jardim Dona Leopoldina;17450;16390;1060;-53;-19;-34
42;18;1;Jardim Europa;1365;1364;1;-26;44;-70
42;18;1;Jardim Floresta;2540;2471;69;54;-8;62
42;18;1;Jardim Isabel;2258;2149;109;121;60;61
42;18;1;Jardim Itu;17523;16367;1156;-55;-18;-37
42;18;1;Jardim Lindóia;6897;6568;329;243;41;202
42;18;1;Jardim Sabará;12997;12146;851;-74;-24;-50
42;18;1;Jardim São Pedro;3194;3055;139;133;25;108
42;18;1;Lageado;4152;3849;303;245;93;152
42;18;1;Lami;4109;3846;263;195;98;97
42;18;1;Lomba do Pinheiro;62172;56792;5380;-528;-58;-470
42;18;1;Mário Quintana;39197;36152;3045;-829;-312;-517
42;18;1;Medianeira;10498;9822;676;25;-50;75
42;18;1;Menino Deus;32668;30004;2664;-520;-169;-351
42;18;1;Moinhos de Vento;11432;10789;643;139;-24;163
42;18;1;MontSerrat;10576;9890;686;-27;-63;36
42;18;1;Morro Santana;19442;17960;1482;-19;20;-39
42;18;1;Navegantes;3782;3605;177;-18;18;-36
42;18;1;Nonoai;25363;23390;1973;-251;-123;-128
42;18;1;Parque Santa Fé;5431;5144;287;189;45;144
42;18;1;Partenon;50103;45594;4509;-1244;-477;-767
42;18;1;Passo DAreia;22241;20442;1799;-150;-125;-25
42;18;1;Passo das Pedras;15588;14437;1151;-23;-7;-16
42;18;1;Pedra Redonda;77;33;44;22;-22;44
42;18;1;Petrópolis;38760;35444;3316;-374;-134;-240
42;18;1;Pitinga;4085;3812;273;178;89;89
42;18;1;Ponta Grossa;8572;7966;606;139;86;53
42;18;1;Praia de Belas;1554;1470;84;70;48;22
42;18;1;Restinga;56265;52123;4142;-125;-44;-81
42;18;1;Rio Branco;17345;15907;1438;-125;-138;13
42;18;1;Rubem Berta;34079;31186;2893;31;-169;200
42;18;1;Santa Cecília;4809;4443;366;201;-13;214
42;18;1;Santa Maria Goretti;2864;2627;237;250;62;188
42;18;1;Santa Rosa de Lima;36593;33648;2945;-375;-184;-191
42;18;1;Santa Tereza;40758;37233;3525;-677;-236;-441
42;18;1;Santana;21029;19081;1948;74;-12;86
42;18;1;Santo Antônio;12930;11728;1202;247;67;180
42;18;1;São Caetano;572;468;104;-49;77;-126
42;18;1;São Geraldo;8437;7699;738;174;42;132
42;18;1;São João;12277;11286;991;307;124;183
42;18;1;São Sebastião;6507;6112;395;301;71;230
42;18;1;Sarandi;63916;58021;5895;-327;-116;-211
42;18;1;Serraria;5983;5536;447;138;139;-1
42;18;1;Sétimo Céu;730;655;75;50;12;38
42;18;1;Teresópolis;14648;13244;1404;220;39;181
42;18;1;Três Figueiras;3344;3033;311;383;98;285
42;18;1;Tristeza;16712;15375;1337;101;-16;117
42;18;1;Vila Assunção;4044;3650;394;285;76;209
42;18;1;Vila Conceição;943;809;134;87;92;-5
42;18;1;Vila Ipiranga;18994;17167;1827;326;113;213
42;18;1;Vila Jardim;13134;11858;1276;338;134;204
42;18;1;Vila João Pessoa;12685;11525;1160;284;68;216
42;18;1;Vila Nova;33866;30871;2995;589;54;535
42;18;1;Vila São José;27497;25008;2489;487;241;246
43;19;1;Aberta dos Morros;6830;6432;398;-10;12;-22
43;19;1;Agronomia;1857;1815;42;-9;13;-22
43;19;1;Anchieta;1530;1528;2;4;20;-16
43;19;1;Arquipélago;8301;7783;518;28;22;6
43;19;1;Auxiliadora;9007;8652;355;-24;50;-74
43;19;1;Azenha;13132;12663;469;-135;53;-188
43;19;1;Bela Vista;11026;10571;455;-56;42;-98
43;19;1;Belém Novo;10255;9520;735;34;25;9
43;19;1;Belém Velho;10838;10064;774;47;21;26
43;19;1;Boa Vista;9367;8984;383;-37;35;-72
43;19;1;Boa Vista do Sul;2104;1947;157;10;14;-4
43;19;1;Bom Fim;10926;10489;437;-36;70;-106
43;19;1;Bom Jesus;29387;27261;2126;143;62;81
43;19;1;Camaquã;18032;16850;1182;99;97;2
43;19;1;Campo Novo;8526;7969;557;6;21;-15
43;19;1;Cascata;12987;12080;907;58;26;32
43;19;1;Cavalhada;30113;28122;1991;-66;11;-77
43;19;1;Centro;41078;38054;3024;47;96;-49
43;19;1;Chácara das Pedras;5805;5625;180;-50;35;-85
43;19;1;Chapéu do Sol;2429;2335;94;-22;-1;-21
43;19;1;Cidade Baixa;15136;14188;948;36;57;-21
43;19;1;Coronel Aparício Borges;19249;17960;1289;3;54;-51
43;19;1;Costa e Silva;15498;14560;938;86;67;19
43;19;1;Cristal;33088;30376;2712;247;92;155
43;19;1;Cristo Redentor;16287;15494;793;-42;48;-90
43;19;1;Espírito Santo;5065;4781;284;17;32;-15
43;19;1;Extrema;1806;1704;102;4;4;0
43;19;1;Farrapos;19607;18092;1515;164;87;77
43;19;1;Farroupilha;386;386;0;70;70;0
43;19;1;Floresta;11172;10575;597;-11;53;-64
43;19;1;Glória;16919;15708;1211;71;45;26
43;19;1;Guarujá;4355;4070;285;25;32;-7
43;19;1;Higienópolis;10168;9650;518;7;52;-45
43;19;1;Hípica;18986;17499;1487;106;37;69
43;19;1;Humaitá;11528;10726;802;27;49;-22
43;19;1;Independência;7338;7087;251;-107;26;-133
43;19;1;Ipanema;13819;12719;1100;94;39;55
43;19;1;Jardim Botânico;11810;11328;482;-117;19;-136
43;19;1;Jardim Carvalho;26022;23887;2135;149;74;75
43;19;1;Jardim do Salso;3401;3361;40;-54;40;-94
43;19;1;Jardim Dona Leopoldina;17535;16444;1091;85;54;31
43;19;1;Jardim Europa;1428;1427;1;63;63;0
43;19;1;Jardim Floresta;2528;2528;0;-12;57;-69
43;19;1;Jardim Isabel;2217;2166;51;-41;17;-58
43;19;1;Jardim Itu;17647;16443;1204;124;76;48
43;19;1;Jardim Lindóia;6851;6609;242;-46;41;-87
43;19;1;Jardim Sabará;13126;12230;896;129;84;45
43;19;1;Jardim São Pedro;3148;3091;57;-46;36;-82
43;19;1;Lageado;4169;3874;295;17;25;-8
43;19;1;Lami;4119;3851;268;10;5;5
43;19;1;Lomba do Pinheiro;62037;56807;5230;-135;15;-150
43;19;1;Mário Quintana;39432;36274;3158;235;122;113
43;19;1;Medianeira;10558;9906;652;60;84;-24
43;19;1;Menino Deus;32831;30098;2733;163;94;69
43;19;1;Moinhos de Vento;11438;10829;609;6;40;-34
43;19;1;MontSerrat;10571;9941;630;-5;51;-56
43;19;1;Morro Santana;19596;18006;1590;154;46;108
43;19;1;Navegantes;3735;3640;95;-47;35;-82
43;19;1;Nonoai;25444;23419;2025;81;29;52
43;19;1;Parque Santa Fé;5422;5207;215;-9;63;-72
43;19;1;Partenon;50416;45756;4660;313;162;151
43;19;1;Passo DAreia;22362;20517;1845;121;75;46
43;19;1;Passo das Pedras;15606;14529;1077;18;92;-74
43;19;1;Pedra Redonda;59;54;5;-18;21;-39
43;19;1;Petrópolis;38908;35526;3382;148;82;66
43;19;1;Pitinga;4110;3820;290;25;8;17
43;19;1;Ponta Grossa;8592;7958;634;20;-8;28
43;19;1;Praia de Belas;1490;1490;0;-64;20;-84
43;19;1;Restinga;55924;52102;3822;-341;-21;-320
43;19;1;Rio Branco;17423;15992;1431;78;85;-7
43;19;1;Rubem Berta;33952;31196;2756;-127;10;-137
43;19;1;Santa Cecília;4722;4481;241;-87;38;-125
43;19;1;Santa Maria Goretti;2789;2651;138;-75;24;-99
43;19;1;Santa Rosa de Lima;36543;33718;2825;-50;70;-120
43;19;1;Santa Tereza;40793;37309;3484;35;76;-41
43;19;1;Santana;21043;19114;1929;14;33;-19
43;19;1;Santo Antônio;12869;11741;1128;-61;13;-74
43;19;1;São Caetano;577;472;105;5;4;1
43;19;1;São Geraldo;8417;7733;684;-20;34;-54
43;19;1;São João;12254;11332;922;-23;46;-69
43;19;1;São Sebastião;6450;6146;304;-57;34;-91
43;19;1;Sarandi;63480;58022;5458;-436;1;-437
43;19;1;Serraria;6000;5524;476;17;-12;29
43;19;1;Sétimo Céu;734;676;58;4;21;-17
43;19;1;Teresópolis;14557;13244;1313;-91;0;-91
43;19;1;Três Figueiras;3211;3049;162;-133;16;-149
43;19;1;Tristeza;16711;15354;1357;-1;-21;20
43;19;1;Vila Assunção;4043;3660;383;-1;10;-11
43;19;1;Vila Conceição;939;798;141;-4;-11;7
43;19;1;Vila Ipiranga;18825;17112;1713;-169;-55;-114
43;19;1;Vila Jardim;12972;11789;1183;-162;-69;-93
43;19;1;Vila João Pessoa;12720;11563;1157;35;38;-3
43;19;1;Vila Nova;33539;30833;2706;-327;-38;-289
43;19;1;Vila São José;27319;24917;2402;-178;-91;-87
44;20;1;Aberta dos Morros;7119;6894;225;289;462;-173
44;20;1;Agronomia;2538;2228;310;681;413;268
44;20;1;Anchieta;2142;1928;214;612;400;212
44;20;1;Arquipélago;8501;8250;251;200;467;-267
44;20;1;Auxiliadora;9505;9452;53;498;800;-302
44;20;1;Azenha;13533;13533;0;401;870;-469
44;20;1;Bela Vista;11538;11495;43;512;924;-412
44;20;1;Belém Novo;10285;9916;369;30;396;-366
44;20;1;Belém Velho;10932;10632;300;94;568;-474
44;20;1;Boa Vista;9880;9815;65;513;831;-318
44;20;1;Boa Vista do Sul;2418;2110;308;314;163;151
44;20;1;Bom Fim;11410;11355;55;484;866;-382
44;20;1;Bom Jesus;28576;28361;215;-811;1100;-1911
44;20;1;Camaquã;17839;17630;209;-193;780;-973
44;20;1;Campo Novo;8734;8507;227;208;538;-330
44;20;1;Cascata;13078;12795;283;91;715;-624
44;20;1;Cavalhada;29155;28981;174;-958;859;-1817
44;20;1;Centro;39183;38966;217;-1895;912;-2807
44;20;1;Chácara das Pedras;6501;6417;84;696;792;-96
44;20;1;Chapéu do Sol;2937;2694;243;508;359;149
44;20;1;Cidade Baixa;15321;15184;137;185;996;-811
44;20;1;Coronel Aparício Borges;19202;18978;224;-47;1018;-1065
44;20;1;Costa e Silva;15700;15538;162;202;978;-776
44;20;1;Cristal;32145;31523;622;-943;1147;-2090
44;20;1;Cristo Redentor;16221;16218;3;-66;724;-790
44;20;1;Espírito Santo;5440;5265;175;375;484;-109
44;20;1;Extrema;2133;1849;284;327;145;182
44;20;1;Farrapos;19225;18812;413;-382;720;-1102
44;20;1;Farroupilha;980;811;169;594;425;169
44;20;1;Floresta;11500;11381;119;328;806;-478
44;20;1;Glória;16923;16735;188;4;1027;-1023
44;20;1;Guarujá;4793;4538;255;438;468;-30
44;20;1;Higienópolis;10544;10450;94;376;800;-424
44;20;1;Hípica;18586;18163;423;-400;664;-1064
44;20;1;Humaitá;11630;11334;296;102;608;-506
44;20;1;Independência;7964;7898;66;626;811;-185
44;20;1;Ipanema;13695;13351;344;-124;632;-756
44;20;1;Jardim Botânico;12243;12211;32;433;883;-450
44;20;1;Jardim Carvalho;25433;25022;411;-589;1135;-1724
44;20;1;Jardim do Salso;4364;4168;196;963;807;156
44;20;1;Jardim Dona Leopoldina;17782;17591;191;247;1147;-900
44;20;1;Jardim Europa;2203;2072;131;775;645;130
44;20;1;Jardim Floresta;3276;3110;166;748;582;166
44;20;1;Jardim Isabel;2803;2589;214;586;423;163
44;20;1;Jardim Itu;17655;17488;167;8;1045;-1037
44;20;1;Jardim Lindóia;7294;7205;89;443;596;-153
44;20;1;Jardim Sabará;13359;13197;162;233;967;-734
44;20;1;Jardim São Pedro;3920;3724;196;772;633;139
44;20;1;Lageado;4539;4231;308;370;357;13
44;20;1;Lami;4358;4071;287;239;220;19
44;20;1;Lomba do Pinheiro;58995;57831;1164;-3042;1024;-4066
44;20;1;Mário Quintana;38320;37605;715;-1112;1331;-2443
44;20;1;Medianeira;10995;10876;119;437;970;-533
44;20;1;Menino Deus;31596;31252;344;-1235;1154;-2389
44;20;1;Moinhos de Vento;11764;11675;89;326;846;-520
44;20;1;MontSerrat;11085;10917;168;514;976;-462
44;20;1;Morro Santana;19421;18978;443;-175;972;-1147
44;20;1;Navegantes;4343;4148;195;608;508;100
44;20;1;Nonoai;25102;24655;447;-342;1236;-1578
44;20;1;Parque Santa Fé;6242;6065;177;820;858;-38
44;20;1;Partenon;48508;47385;1123;-1908;1629;-3537
44;20;1;Passo DAreia;21883;21563;320;-479;1046;-1525
44;20;1;Passo das Pedras;15787;15539;248;181;1010;-829
44;20;1;Pedra Redonda;345;106;239;286;52;234
44;20;1;Petrópolis;37549;36890;659;-1359;1364;-2723
44;20;1;Pitinga;4543;4186;357;433;366;67
44;20;1;Ponta Grossa;8757;8357;400;165;399;-234
44;20;1;Praia de Belas;2392;2129;263;902;639;263
44;20;1;Restinga;53610;52863;747;-2314;761;-3075
44;20;1;Rio Branco;17306;17074;232;-117;1082;-1199
44;20;1;Rubem Berta;33450;32648;802;-502;1452;-1954
44;20;1;Santa Cecília;5720;5422;298;998;941;57
44;20;1;Santa Maria Goretti;3562;3267;295;773;616;157
44;20;1;Santa Rosa de Lima;35704;34832;872;-839;1114;-1953
44;20;1;Santa Tereza;39845;38829;1016;-948;1520;-2468
44;20;1;Santana;20543;20228;315;-500;1114;-1614
44;20;1;Santo Antônio;13009;12709;300;140;968;-828
44;20;1;São Caetano;889;588;301;312;116;196
44;20;1;São Geraldo;8750;8433;317;333;700;-367
44;20;1;São João;12177;11962;215;-77;630;-707
44;20;1;São Sebastião;6989;6804;185;539;658;-119
44;20;1;Sarandi;60219;59081;1138;-3261;1059;-4320
44;20;1;Serraria;6276;5856;420;276;332;-56
44;20;1;Sétimo Céu;1213;1010;203;479;334;145
44;20;1;Teresópolis;14628;14217;411;71;973;-902
44;20;1;Três Figueiras;4039;3770;269;828;721;107
44;20;1;Tristeza;16578;16103;475;-133;749;-882
44;20;1;Vila Assunção;4598;4152;446;555;492;63
44;20;1;Vila Conceição;1486;1118;368;547;320;227
44;20;1;Vila Ipiranga;18668;18182;486;-157;1070;-1227
44;20;1;Vila Jardim;13207;12755;452;235;966;-731
44;20;1;Vila João Pessoa;12923;12558;365;203;995;-792
44;20;1;Vila Nova;32528;31671;857;-1011;838;-1849
44;20;1;Vila São José;26772;25930;842;-547;1013;-1560
45;21;1;Aberta dos Morros;7116;6959;157;-3;65;-68
45;21;1;Agronomia;2495;2253;242;-43;25;-68
45;21;1;Anchieta;2135;1976;159;-7;48;-55
45;21;1;Arquipélago;8443;8280;163;-58;30;-88
45;21;1;Auxiliadora;9556;9545;11;51;93;-42
45;21;1;Azenha;13635;13635;0;102;102;0
45;21;1;Bela Vista;11627;11609;18;89;114;-25
45;21;1;Belém Novo;10192;9961;231;-93;45;-138
45;21;1;Belém Velho;10869;10676;193;-63;44;-107
45;21;1;Boa Vista;9927;9910;17;47;95;-48
45;21;1;Boa Vista do Sul;2424;2143;281;6;33;-27
45;21;1;Bom Fim;11448;11436;12;38;81;-43
45;21;1;Bom Jesus;28740;28441;299;164;80;84
45;21;1;Camaquã;17845;17696;149;6;66;-60
45;21;1;Campo Novo;8718;8556;162;-16;49;-65
45;21;1;Cascata;13040;12855;185;-38;60;-98
45;21;1;Cavalhada;29198;29082;116;43;101;-58
45;21;1;Centro;39354;39043;311;171;77;94
45;21;1;Chácara das Pedras;6512;6512;0;11;95;-84
45;21;1;Chapéu do Sol;2931;2744;187;-6;50;-56
45;21;1;Cidade Baixa;15311;15241;70;-10;57;-67
45;21;1;Coronel Aparício Borges;19249;19066;183;47;88;-41
45;21;1;Costa e Silva;15701;15637;64;1;99;-98
45;21;1;Cristal;31978;31667;311;-167;144;-311
45;21;1;Cristo Redentor;16357;16320;37;136;102;34
45;21;1;Espírito Santo;5497;5357;140;57;92;-35
45;21;1;Extrema;2148;1865;283;15;16;-1
45;21;1;Farrapos;19115;18880;235;-110;68;-178
45;21;1;Farroupilha;910;844;66;-70;33;-103
45;21;1;Floresta;11502;11467;35;2;86;-84
45;21;1;Glória;16997;16840;157;74;105;-31
45;21;1;Guarujá;4821;4617;204;28;79;-51
45;21;1;Higienópolis;10610;10567;43;66;117;-51
45;21;1;Hípica;18553;18295;258;-33;132;-165
45;21;1;Humaitá;11575;11407;168;-55;73;-128
45;21;1;Independência;7975;7972;3;11;74;-63
45;21;1;Ipanema;13721;13470;251;26;119;-93
45;21;1;Jardim Botânico;12316;12314;2;73;103;-30
45;21;1;Jardim Carvalho;25456;25165;291;23;143;-120
45;21;1;Jardim do Salso;4346;4251;95;-18;83;-101
45;21;1;Jardim Dona Leopoldina;17832;17736;96;50;145;-95
45;21;1;Jardim Europa;2247;2169;78;44;97;-53
45;21;1;Jardim Floresta;3306;3205;101;30;95;-65
45;21;1;Jardim Isabel;2800;2641;159;-3;52;-55
45;21;1;Jardim Itu;17779;17650;129;124;162;-38
45;21;1;Jardim Lindóia;7300;7293;7;6;88;-82
45;21;1;Jardim Sabará;13456;13334;122;97;137;-40
45;21;1;Jardim São Pedro;3926;3825;101;6;101;-95
45;21;1;Lageado;4534;4285;249;-5;54;-59
45;21;1;Lami;4369;4105;264;11;34;-23
45;21;1;Lomba do Pinheiro;58720;57917;803;-275;86;-361
45;21;1;Mário Quintana;38308;37827;481;-12;222;-234
45;21;1;Medianeira;11078;11009;69;83;133;-50
45;21;1;Menino Deus;31804;31409;395;208;157;51
45;21;1;Moinhos de Vento;11808;11782;26;44;107;-63
45;21;1;MontSerrat;11077;11036;41;-8;119;-127
45;21;1;Morro Santana;19404;19136;268;-17;158;-175
45;21;1;Navegantes;4312;4213;99;-31;65;-96
45;21;1;Nonoai;25099;24838;261;-3;183;-186
45;21;1;Parque Santa Fé;6291;6191;100;49;126;-77
45;21;1;Partenon;48435;47716;719;-73;331;-404
45;21;1;Passo DAreia;21994;21763;231;111;200;-89
45;21;1;Passo das Pedras;15832;15695;137;45;156;-111
45;21;1;Pedra Redonda;334;128;206;-11;22;-33
45;21;1;Petrópolis;37587;37154;433;38;264;-226
45;21;1;Pitinga;4523;4218;305;-20;32;-52
45;21;1;Ponta Grossa;8734;8463;271;-23;106;-129
45;21;1;Praia de Belas;2279;2165;114;-113;36;-149
45;21;1;Restinga;53546;53058;488;-64;195;-259
45;21;1;Rio Branco;17531;17275;256;225;201;24
45;21;1;Rubem Berta;33326;32851;475;-124;203;-327
45;21;1;Santa Cecília;5617;5534;83;-103;112;-215
45;21;1;Santa Maria Goretti;3530;3363;167;-32;96;-128
45;21;1;Santa Rosa de Lima;35547;35056;491;-157;224;-381
45;21;1;Santa Tereza;39776;39113;663;-69;284;-353
45;21;1;Santana;20734;20433;301;191;205;-14
45;21;1;Santo Antônio;12996;12882;114;-13;173;-186
45;21;1;São Caetano;916;613;303;27;25;2
45;21;1;São Geraldo;8666;8527;139;-84;94;-178
45;21;1;São João;12143;12084;59;-34;122;-156
45;21;1;São Sebastião;6932;6897;35;-57;93;-150
45;21;1;Sarandi;59957;59374;583;-262;293;-555
45;21;1;Serraria;6307;5962;345;31;106;-75
45;21;1;Sétimo Céu;1235;1069;166;22;59;-37
45;21;1;Teresópolis;14628;14408;220;0;191;-191
45;21;1;Três Figueiras;3971;3877;94;-68;107;-175
45;21;1;Tristeza;16642;16312;330;64;209;-145
45;21;1;Vila Assunção;4542;4215;327;-56;63;-119
45;21;1;Vila Conceição;1516;1165;351;30;47;-17
45;21;1;Vila Ipiranga;18636;18392;244;-32;210;-242
45;21;1;Vila Jardim;13148;12928;220;-59;173;-232
45;21;1;Vila João Pessoa;12881;12704;177;-42;146;-188
45;21;1;Vila Nova;32453;31947;506;-75;276;-351
45;21;1;Vila São José;26664;26132;532;-108;202;-310
46;22;1;Aberta dos Morros;7147;6970;177;31;11;20
46;22;1;Agronomia;2560;2265;295;65;12;53
46;22;1;Anchieta;2187;1962;225;52;-14;66
46;22;1;Arquipélago;8424;8255;169;-19;-25;6
46;22;1;Auxiliadora;9616;9464;152;60;-81;141
46;22;1;Azenha;13747;13590;157;112;-45;157
46;22;1;Bela Vista;11716;11560;156;89;-49;138
46;22;1;Belém Novo;10199;9961;238;7;0;7
46;22;1;Belém Velho;10869;10682;187;0;6;-6
46;22;1;Boa Vista;10018;9857;161;91;-53;144
46;22;1;Boa Vista do Sul;2469;2153;316;45;10;35
46;22;1;Bom Fim;11508;11367;141;60;-69;129
46;22;1;Bom Jesus;28611;28436;175;-129;-5;-124
46;22;1;Camaquã;17850;17686;164;5;-10;15
46;22;1;Campo Novo;8740;8571;169;22;15;7
46;22;1;Cascata;13019;12850;169;-21;-5;-16
46;22;1;Cavalhada;29267;29058;209;69;-24;93
46;22;1;Centro;39282;38971;311;-72;-72;0
46;22;1;Chácara das Pedras;6627;6475;152;115;-37;152
46;22;1;Chapéu do Sol;2976;2757;219;45;13;32
46;22;1;Cidade Baixa;15374;15195;179;63;-46;109
46;22;1;Coronel Aparício Borges;19254;19079;175;5;13;-8
46;22;1;Costa e Silva;15806;15643;163;105;6;99
46;22;1;Cristal;31931;31697;234;-47;30;-77
46;22;1;Cristo Redentor;16418;16248;170;61;-72;133
46;22;1;Espírito Santo;5512;5371;141;15;14;1
46;22;1;Extrema;2168;1860;308;20;-5;25
46;22;1;Farrapos;19045;18844;201;-70;-36;-34
46;22;1;Farroupilha;922;773;149;12;-71;83
46;22;1;Floresta;11577;11415;162;75;-52;127
46;22;1;Glória;17049;16848;201;52;8;44
46;22;1;Guarujá;4840;4624;216;19;7;12
46;22;1;Higienópolis;10681;10515;166;71;-52;123
46;22;1;Hípica;18581;18363;218;28;68;-40
46;22;1;Humaitá;11566;11385;181;-9;-22;13
46;22;1;Independência;8076;7905;171;101;-67;168
46;22;1;Ipanema;13677;13476;201;-44;6;-50
46;22;1;Jardim Botânico;12471;12305;166;155;-9;164
46;22;1;Jardim Carvalho;25417;25186;231;-39;21;-60
46;22;1;Jardim do Salso;4394;4249;145;48;-2;50
46;22;1;Jardim Dona Leopoldina;17932;17783;149;100;47;53
46;22;1;Jardim Europa;2273;2125;148;26;-44;70
46;22;1;Jardim Floresta;3307;3160;147;1;-45;46
46;22;1;Jardim Isabel;2810;2627;183;10;-14;24
46;22;1;Jardim Itu;17797;17628;169;18;-22;40
46;22;1;Jardim Lindóia;7400;7247;153;100;-46;146
46;22;1;Jardim Sabará;13496;13333;163;40;-1;41
46;22;1;Jardim São Pedro;3925;3779;146;-1;-46;45
46;22;1;Lageado;4550;4294;256;16;9;7
46;22;1;Lami;4373;4090;283;4;-15;19
46;22;1;Lomba do Pinheiro;58458;57941;517;-262;24;-286
46;22;1;Mário Quintana;38192;37905;287;-116;78;-194
46;22;1;Medianeira;11172;11004;168;94;-5;99
46;22;1;Menino Deus;31621;31366;255;-183;-43;-140
46;22;1;Moinhos de Vento;11884;11705;179;76;-77;153
46;22;1;MontSerrat;11149;10985;164;72;-51;123
46;22;1;Morro Santana;19386;19168;218;-18;32;-50
46;22;1;Navegantes;4328;4179;149;16;-34;50
46;22;1;Nonoai;25093;24880;213;-6;42;-48
46;22;1;Parque Santa Fé;6353;6216;137;62;25;37
46;22;1;Partenon;48151;47719;432;-284;3;-287
46;22;1;Passo DAreia;21905;21712;193;-89;-51;-38
46;22;1;Passo das Pedras;15896;15718;178;64;23;41
46;22;1;Pedra Redonda;412;148;264;78;20;58
46;22;1;Petrópolis;37404;37135;269;-183;-19;-164
46;22;1;Pitinga;4541;4232;309;18;14;4
46;22;1;Ponta Grossa;8777;8502;275;43;39;4
46;22;1;Praia de Belas;2317;2156;161;38;-9;47
46;22;1;Restinga;53279;53091;188;-267;33;-300
46;22;1;Rio Branco;17414;17194;220;-117;-81;-36
46;22;1;Rubem Berta;33201;32894;307;-125;43;-168
46;22;1;Santa Cecília;5662;5507;155;45;-27;72
46;22;1;Santa Maria Goretti;3503;3328;175;-27;-35;8
46;22;1;Santa Rosa de Lima;35394;35080;314;-153;24;-177
46;22;1;Santa Tereza;39618;39152;466;-158;39;-197
46;22;1;Santana;20642;20384;258;-92;-49;-43
46;22;1;Santo Antônio;13093;12908;185;97;26;71
46;22;1;São Caetano;889;574;315;-27;-39;12
46;22;1;São Geraldo;8635;8479;156;-31;-48;17
46;22;1;São João;12222;12042;180;79;-42;121
46;22;1;São Sebastião;7006;6868;138;74;-29;103
46;22;1;Sarandi;59760;59394;366;-197;20;-217
46;22;1;Serraria;6297;5986;311;-10;24;-34
46;22;1;Sétimo Céu;1264;1077;187;29;8;21
46;22;1;Teresópolis;14665;14438;227;37;30;7
46;22;1;Três Figueiras;4022;3871;151;51;-6;57
46;22;1;Tristeza;16606;16300;306;-36;-12;-24
46;22;1;Vila Assunção;4484;4224;260;-58;9;-67
46;22;1;Vila Conceição;1512;1153;359;-4;-12;8
46;22;1;Vila Ipiranga;18576;18371;205;-60;-21;-39
46;22;1;Vila Jardim;13154;12950;204;6;22;-16
46;22;1;Vila João Pessoa;12942;12763;179;61;59;2
46;22;1;Vila Nova;32349;31983;366;-104;36;-140
46;22;1;Vila São José;26669;26204;465;5;72;-67
47;23;1;Aberta dos Morros;7146;7146;0;-1;176;-177
47;23;1;Agronomia;2331;2331;0;-229;66;-295
47;23;1;Anchieta;2024;2024;0;-163;62;-225
47;23;1;Arquipélago;8330;8330;0;-94;75;-169
47;23;1;Auxiliadora;9683;9683;0;67;219;-152
47;23;1;Azenha;13804;13804;0;57;214;-157
47;23;1;Bela Vista;11787;11787;0;71;227;-156
47;23;1;Belém Novo;10100;10100;0;-99;139;-238
47;23;1;Belém Velho;10835;10835;0;-34;153;-187
47;23;1;Boa Vista;10053;10053;0;35;196;-161
47;23;1;Boa Vista do Sul;2309;2309;0;-160;156;-316
47;23;1;Bom Fim;11593;11593;0;85;226;-141
47;23;1;Bom Jesus;28675;28675;0;64;239;-175
47;23;1;Camaquã;17938;17938;0;88;252;-164
47;23;1;Campo Novo;8766;8766;0;26;195;-169
47;23;1;Cascata;13013;13013;0;-6;163;-169
47;23;1;Cavalhada;29299;29299;0;32;241;-209
47;23;1;Centro;39154;39154;0;-128;183;-311
47;23;1;Chácara das Pedras;6668;6668;0;41;193;-152
47;23;1;Chapéu do Sol;2913;2913;0;-63;156;-219
47;23;1;Cidade Baixa;15379;15379;0;5;184;-179
47;23;1;Coronel Aparício Borges;19303;19303;0;49;224;-175
47;23;1;Costa e Silva;15842;15842;0;36;199;-163
47;23;1;Cristal;31946;31946;0;15;249;-234
47;23;1;Cristo Redentor;16455;16455;0;37;207;-170
47;23;1;Espírito Santo;5606;5606;0;94;235;-141
47;23;1;Extrema;1981;1981;0;-187;121;-308
47;23;1;Farrapos;18986;18986;0;-59;142;-201
47;23;1;Farroupilha;961;961;0;39;188;-149
47;23;1;Floresta;11596;11596;0;19;181;-162
47;23;1;Glória;17067;17067;0;18;219;-201
47;23;1;Guarujá;4811;4811;0;-29;187;-216
47;23;1;Higienópolis;10724;10724;0;43;209;-166
47;23;1;Hípica;18645;18645;0;64;282;-218
47;23;1;Humaitá;11502;11502;0;-64;117;-181
47;23;1;Independência;8112;8112;0;36;207;-171
47;23;1;Ipanema;13728;13728;0;51;252;-201
47;23;1;Jardim Botânico;12521;12521;0;50;216;-166
47;23;1;Jardim Carvalho;25386;25386;0;-31;200;-231
47;23;1;Jardim do Salso;4405;4405;0;11;156;-145
47;23;1;Jardim Dona Leopoldina;18016;18016;0;84;233;-149
47;23;1;Jardim Europa;2299;2299;0;26;174;-148
47;23;1;Jardim Floresta;3307;3307;0;0;147;-147
47;23;1;Jardim Isabel;2835;2835;0;25;208;-183
47;23;1;Jardim Itu;17853;17853;0;56;225;-169
47;23;1;Jardim Lindóia;7417;7417;0;17;170;-153
47;23;1;Jardim Sabará;13530;13530;0;34;197;-163
47;23;1;Jardim São Pedro;3967;3967;0;42;188;-146
47;23;1;Lageado;4481;4481;0;-69;187;-256
47;23;1;Lami;4289;4289;0;-84;199;-283
47;23;1;Lomba do Pinheiro;58106;58106;0;-352;165;-517
47;23;1;Mário Quintana;38116;38116;0;-76;211;-287
47;23;1;Medianeira;11223;11223;0;51;219;-168
47;23;1;Menino Deus;31650;31650;0;29;284;-255
47;23;1;Moinhos de Vento;11937;11937;0;53;232;-179
47;23;1;MontSerrat;11236;11236;0;87;251;-164
47;23;1;Morro Santana;19338;19338;0;-48;170;-218
47;23;1;Navegantes;4327;4327;0;-1;148;-149
47;23;1;Nonoai;25160;25160;0;67;280;-213
47;23;1;Parque Santa Fé;6376;6376;0;23;160;-137
47;23;1;Partenon;48160;48160;0;9;441;-432
47;23;1;Passo DAreia;21968;21968;0;63;256;-193
47;23;1;Passo das Pedras;15902;15902;0;6;184;-178
47;23;1;Pedra Redonda;274;274;0;-138;126;-264
47;23;1;Petrópolis;37496;37496;0;92;361;-269
47;23;1;Pitinga;4352;4352;0;-189;120;-309
47;23;1;Ponta Grossa;8722;8722;0;-55;220;-275
47;23;1;Praia de Belas;2281;2281;0;-36;125;-161
47;23;1;Restinga;53508;53508;0;229;417;-188
47;23;1;Rio Branco;17531;17531;0;117;337;-220
47;23;1;Rubem Berta;33168;33168;0;-33;274;-307
47;23;1;Santa Cecília;5768;5768;0;106;261;-155
47;23;1;Santa Maria Goretti;3509;3509;0;6;181;-175
47;23;1;Santa Rosa de Lima;35333;35333;0;-61;253;-314
47;23;1;Santa Tereza;39577;39577;0;-41;425;-466
47;23;1;Santana;20723;20723;0;81;339;-258
47;23;1;Santo Antônio;13161;13161;0;68;253;-185
47;23;1;São Caetano;757;757;0;-132;183;-315
47;23;1;São Geraldo;8681;8681;0;46;202;-156
47;23;1;São João;12226;12226;0;4;184;-180
47;23;1;São Sebastião;7019;7019;0;13;151;-138
47;23;1;Sarandi;59711;59711;0;-49;317;-366
47;23;1;Serraria;6239;6239;0;-58;253;-311
47;23;1;Sétimo Céu;1329;1329;0;65;252;-187
47;23;1;Teresópolis;14707;14707;0;42;269;-227
47;23;1;Três Figueiras;4070;4070;0;48;199;-151
47;23;1;Tristeza;16692;16692;0;86;392;-306
47;23;1;Vila Assunção;4418;4418;0;-66;194;-260
47;23;1;Vila Conceição;1349;1349;0;-163;196;-359
47;23;1;Vila Ipiranga;18659;18659;0;83;288;-205
47;23;1;Vila Jardim;13189;13189;0;35;239;-204
47;23;1;Vila João Pessoa;13041;13041;0;99;278;-179
47;23;1;Vila Nova;32469;32469;0;120;486;-366
47;23;1;Vila São José;26522;26522;0;-147;318;-465
48;0;2;Aberta dos Morros;7114;7082;32;-32;-64;32
48;0;2;Agronomia;2336;2300;36;5;-31;36
48;0;2;Anchieta;2021;1975;46;-3;-49;46
48;0;2;Arquipélago;8334;8291;43;4;-39;43
48;0;2;Auxiliadora;9616;9555;61;-67;-128;61
48;0;2;Azenha;13732;13633;99;-72;-171;99
48;0;2;Bela Vista;11712;11650;62;-75;-137;62
48;0;2;Belém Novo;10085;10070;15;-15;-30;15
48;0;2;Belém Velho;10832;10792;40;-3;-43;40
48;0;2;Boa Vista;9999;9936;63;-54;-117;63
48;0;2;Boa Vista do Sul;2284;2269;15;-25;-40;15
48;0;2;Bom Fim;11470;11429;41;-123;-164;41
48;0;2;Bom Jesus;28644;28586;58;-31;-89;58
48;0;2;Camaquã;17902;17854;48;-36;-84;48
48;0;2;Campo Novo;8750;8709;41;-16;-57;41
48;0;2;Cascata;13004;12955;49;-9;-58;49
48;0;2;Cavalhada;29269;29217;52;-30;-82;52
48;0;2;Centro;39190;39074;116;36;-80;116
48;0;2;Chácara das Pedras;6640;6575;65;-28;-93;65
48;0;2;Chapéu do Sol;2900;2870;30;-13;-43;30
48;0;2;Cidade Baixa;15306;15244;62;-73;-135;62
48;0;2;Coronel Aparício Borges;19270;19211;59;-33;-92;59
48;0;2;Costa e Silva;15838;15782;56;-4;-60;56
48;0;2;Cristal;31929;31879;50;-17;-67;50
48;0;2;Cristo Redentor;16468;16322;146;13;-133;146
48;0;2;Espírito Santo;5585;5537;48;-21;-69;48
48;0;2;Extrema;1977;1968;9;-4;-13;9
48;0;2;Farrapos;19003;18949;54;17;-37;54
48;0;2;Farroupilha;955;810;145;-6;-151;145
48;0;2;Floresta;11543;11479;64;-53;-117;64
48;0;2;Glória;17107;16980;127;40;-87;127
48;0;2;Guarujá;4796;4748;48;-15;-63;48
48;0;2;Higienópolis;10695;10628;67;-29;-96;67
48;0;2;Hípica;18635;18593;42;-10;-52;42
48;0;2;Humaitá;11524;11464;60;22;-38;60
48;0;2;Independência;8139;7981;158;27;-131;158
48;0;2;Ipanema;13713;13664;49;-15;-64;49
48;0;2;Jardim Botânico;12551;12406;145;30;-115;145
48;0;2;Jardim Carvalho;25466;25328;138;80;-58;138
48;0;2;Jardim do Salso;4393;4328;65;-12;-77;65
48;0;2;Jardim Dona Leopoldina;18004;17948;56;-12;-68;56
48;0;2;Jardim Europa;2274;2207;67;-25;-92;67
48;0;2;Jardim Floresta;3293;3226;67;-14;-81;67
48;0;2;Jardim Isabel;2809;2756;53;-26;-79;53
48;0;2;Jardim Itu;17843;17776;67;-10;-77;67
48;0;2;Jardim Lindóia;7404;7333;71;-13;-84;71
48;0;2;Jardim Sabará;13522;13457;65;-8;-73;65
48;0;2;Jardim São Pedro;3947;3877;70;-20;-90;70
48;0;2;Lageado;4485;4451;34;4;-30;34
48;0;2;Lami;4284;4262;22;-5;-27;22
48;0;2;Lomba do Pinheiro;58134;58086;48;28;-20;48
48;0;2;Mário Quintana;38124;38069;55;8;-47;55
48;0;2;Medianeira;11183;11119;64;-40;-104;64
48;0;2;Menino Deus;31707;31546;161;57;-104;161
48;0;2;Moinhos de Vento;11994;11822;172;57;-115;172
48;0;2;MontSerrat;11189;11119;70;-47;-117;70
48;0;2;Morro Santana;19350;19288;62;12;-50;62
48;0;2;Navegantes;4337;4270;67;10;-57;67
48;0;2;Nonoai;25141;25081;60;-19;-79;60
48;0;2;Parque Santa Fé;6370;6312;58;-6;-64;58
48;0;2;Partenon;48145;48077;68;-15;-83;68
48;0;2;Passo DAreia;21947;21874;73;-21;-94;73
48;0;2;Passo das Pedras;15905;15840;65;3;-62;65
48;0;2;Pedra Redonda;252;196;56;-22;-78;56
48;0;2;Petrópolis;37470;37399;71;-26;-97;71
48;0;2;Pitinga;4372;4336;36;20;-16;36
48;0;2;Ponta Grossa;8736;8695;41;14;-27;41
48;0;2;Praia de Belas;2271;2202;69;-10;-79;69
48;0;2;Restinga;53594;53489;105;86;-19;105
48;0;2;Rio Branco;17586;17399;187;55;-132;187
48;0;2;Rubem Berta;33182;33113;69;14;-55;69
48;0;2;Santa Cecília;5837;5650;187;69;-118;187
48;0;2;Santa Maria Goretti;3513;3440;73;4;-69;73
48;0;2;Santa Rosa de Lima;35364;35305;59;31;-28;59
48;0;2;Santa Tereza;39575;39510;65;-2;-67;65
48;0;2;Santana;20803;20609;194;80;-114;194
48;0;2;Santo Antônio;13150;13070;80;-11;-91;80
48;0;2;São Caetano;775;739;36;18;-18;36
48;0;2;São Geraldo;8691;8613;78;10;-68;78
48;0;2;São João;12243;12161;82;17;-65;82
48;0;2;São Sebastião;7028;6956;72;9;-63;72
48;0;2;Sarandi;59735;59664;71;24;-47;71
48;0;2;Serraria;6255;6202;53;16;-37;53
48;0;2;Sétimo Céu;1308;1252;56;-21;-77;56
48;0;2;Teresópolis;14818;14641;177;111;-66;177
48;0;2;Três Figueiras;4069;3990;79;-1;-80;79
48;0;2;Tristeza;16670;16614;56;-22;-78;56
48;0;2;Vila Assunção;4531;4381;150;113;-37;150
48;0;2;Vila Conceição;1365;1306;59;16;-43;59
48;0;2;Vila Ipiranga;18661;18583;78;2;-76;78
48;0;2;Vila Jardim;13196;13116;80;7;-73;80
48;0;2;Vila João Pessoa;13054;12978;76;13;-63;76
48;0;2;Vila Nova;32581;32426;155;112;-43;155
48;0;2;Vila São José;26548;26475;73;26;-47;73
49;1;2;Aberta dos Morros;7108;7071;37;-6;-11;5
49;1;2;Agronomia;2324;2286;38;-12;-14;2
49;1;2;Anchieta;2018;1971;47;-3;-4;1
49;1;2;Arquipélago;8340;8285;55;6;-6;12
49;1;2;Auxiliadora;9602;9535;67;-14;-20;6
49;1;2;Azenha;13739;13604;135;7;-29;36
49;1;2;Bela Vista;11704;11631;73;-8;-19;11
49;1;2;Belém Novo;10085;10066;19;0;-4;4
49;1;2;Belém Velho;10828;10778;50;-4;-14;10
49;1;2;Boa Vista;9993;9919;74;-6;-17;11
49;1;2;Boa Vista do Sul;2281;2264;17;-3;-5;2
49;1;2;Bom Fim;11443;11403;40;-27;-26;-1
49;1;2;Bom Jesus;28661;28566;95;17;-20;37
49;1;2;Camaquã;17906;17833;73;4;-21;25
49;1;2;Campo Novo;8745;8696;49;-5;-13;8
49;1;2;Cascata;13001;12933;68;-3;-22;19
49;1;2;Cavalhada;29280;29196;84;11;-21;32
49;1;2;Centro;39283;39068;215;93;-6;99
49;1;2;Chácara das Pedras;6616;6546;70;-24;-29;5
49;1;2;Chapéu do Sol;2890;2857;33;-10;-13;3
49;1;2;Cidade Baixa;15300;15226;74;-6;-18;12
49;1;2;Coronel Aparício Borges;19257;19181;76;-13;-30;17
49;1;2;Costa e Silva;15824;15751;73;-14;-31;17
49;1;2;Cristal;31955;31866;89;26;-13;39
49;1;2;Cristo Redentor;16494;16306;188;26;-16;42
49;1;2;Espírito Santo;5568;5515;53;-17;-22;5
49;1;2;Extrema;1975;1965;10;-2;-3;1
49;1;2;Farrapos;19022;18943;79;19;-6;25
49;1;2;Farroupilha;905;778;127;-50;-32;-18
49;1;2;Floresta;11531;11459;72;-12;-20;8
49;1;2;Glória;17097;16948;149;-10;-32;22
49;1;2;Guarujá;4792;4739;53;-4;-9;5
49;1;2;Higienópolis;10695;10611;84;0;-17;17
49;1;2;Hípica;18633;18576;57;-2;-17;15
49;1;2;Humaitá;11527;11455;72;3;-9;12
49;1;2;Independência;8114;7955;159;-25;-26;1
49;1;2;Ipanema;13714;13651;63;1;-13;14
49;1;2;Jardim Botânico;12540;12376;164;-11;-30;19
49;1;2;Jardim Carvalho;25501;25310;191;35;-18;53
49;1;2;Jardim do Salso;4367;4298;69;-26;-30;4
49;1;2;Jardim Dona Leopoldina;17995;17913;82;-9;-35;26
49;1;2;Jardim Europa;2249;2180;69;-25;-27;2
49;1;2;Jardim Floresta;3279;3208;71;-14;-18;4
49;1;2;Jardim Isabel;2797;2740;57;-12;-16;4
49;1;2;Jardim Itu;17830;17740;90;-13;-36;23
49;1;2;Jardim Lindóia;7393;7312;81;-11;-21;10
49;1;2;Jardim Sabará;13514;13427;87;-8;-30;22
49;1;2;Jardim São Pedro;3929;3856;73;-18;-21;3
49;1;2;Lageado;4480;4444;36;-5;-7;2
49;1;2;Lami;4281;4258;23;-3;-4;1
49;1;2;Lomba do Pinheiro;58180;58081;99;46;-5;51
49;1;2;Mário Quintana;38151;38049;102;27;-20;47
49;1;2;Medianeira;11161;11091;70;-22;-28;6
49;1;2;Menino Deus;31760;31525;235;53;-21;74
49;1;2;Moinhos de Vento;11995;11799;196;1;-23;24
49;1;2;MontSerrat;11177;11094;83;-12;-25;13
49;1;2;Morro Santana;19354;19268;86;4;-20;24
49;1;2;Navegantes;4327;4255;72;-10;-15;5
49;1;2;Nonoai;25143;25057;86;2;-24;26
49;1;2;Parque Santa Fé;6341;6276;65;-29;-36;7
49;1;2;Partenon;48197;48055;142;52;-22;74
49;1;2;Passo DAreia;21968;21859;109;21;-15;36
49;1;2;Passo das Pedras;15898;15812;86;-7;-28;21
49;1;2;Pedra Redonda;238;182;56;-14;-14;0
49;1;2;Petrópolis;37511;37384;127;41;-15;56
49;1;2;Pitinga;4365;4327;38;-7;-9;2
49;1;2;Ponta Grossa;8731;8687;44;-5;-8;3
49;1;2;Praia de Belas;2241;2172;69;-30;-30;0
49;1;2;Restinga;53673;53484;189;79;-5;84
49;1;2;Rio Branco;17591;17370;221;5;-29;34
49;1;2;Rubem Berta;33196;33084;112;14;-29;43
49;1;2;Santa Cecília;5809;5622;187;-28;-28;0
49;1;2;Santa Maria Goretti;3499;3422;77;-14;-18;4
49;1;2;Santa Rosa de Lima;35385;35291;94;21;-14;35
49;1;2;Santa Tereza;39603;39490;113;28;-20;48
49;1;2;Santana;20816;20582;234;13;-27;40
49;1;2;Santo Antônio;13126;13033;93;-24;-37;13
49;1;2;São Caetano;769;733;36;-6;-6;0
49;1;2;São Geraldo;8681;8591;90;-10;-22;12
49;1;2;São João;12248;12145;103;5;-16;21
49;1;2;São Sebastião;7014;6931;83;-14;-25;11
49;1;2;Sarandi;59795;59648;147;60;-16;76
49;1;2;Serraria;6248;6190;58;-7;-12;5
49;1;2;Sétimo Céu;1292;1237;55;-16;-15;-1
49;1;2;Teresópolis;14810;14614;196;-8;-27;19
49;1;2;Três Figueiras;4055;3971;84;-14;-19;5
49;1;2;Tristeza;16675;16599;76;5;-15;20
49;1;2;Vila Assunção;4517;4367;150;-14;-14;0
49;1;2;Vila Conceição;1359;1300;59;-6;-6;0
49;1;2;Vila Ipiranga;18654;18549;105;-7;-34;27
49;1;2;Vila Jardim;13180;13086;94;-16;-30;14
49;1;2;Vila João Pessoa;13032;12945;87;-22;-33;11
49;1;2;Vila Nova;32627;32414;213;46;-12;58
49;1;2;Vila São José;26554;26450;104;6;-25;31
50;2;2;Aberta dos Morros;7105;7068;37;-3;-3;0
50;2;2;Agronomia;2337;2299;38;13;13;0
50;2;2;Anchieta;2025;1976;49;7;5;2
50;2;2;Arquipélago;8334;8283;51;-6;-2;-4
50;2;2;Auxiliadora;9607;9552;55;5;17;-12
50;2;2;Azenha;13777;13644;133;38;40;-2
50;2;2;Bela Vista;11703;11645;58;-1;14;-15
50;2;2;Belém Novo;10087;10066;21;2;0;2
50;2;2;Belém Velho;10832;10782;50;4;4;0
50;2;2;Boa Vista;10005;9938;67;12;19;-7
50;2;2;Boa Vista do Sul;2280;2264;16;-1;0;-1
50;2;2;Bom Fim;11446;11425;21;3;22;-19
50;2;2;Bom Jesus;28658;28584;74;-3;18;-21
50;2;2;Camaquã;17920;17852;68;14;19;-5
50;2;2;Campo Novo;8749;8697;52;4;1;3
50;2;2;Cascata;12998;12937;61;-3;4;-7
50;2;2;Cavalhada;29285;29210;75;5;14;-9
50;2;2;Centro;39310;39083;227;27;15;12
50;2;2;Chácara das Pedras;6621;6564;57;5;18;-13
50;2;2;Chapéu do Sol;2898;2865;33;8;8;0
50;2;2;Cidade Baixa;15299;15242;57;-1;16;-17
50;2;2;Coronel Aparício Borges;19261;19195;66;4;14;-10
50;2;2;Costa e Silva;15844;15771;73;20;20;0
50;2;2;Cristal;31958;31873;85;3;7;-4
50;2;2;Cristo Redentor;16474;16319;155;-20;13;-33
50;2;2;Espírito Santo;5571;5520;51;3;5;-2
50;2;2;Extrema;1975;1964;11;0;-1;1
50;2;2;Farrapos;19023;18943;80;1;0;1
50;2;2;Farroupilha;921;806;115;16;28;-12
50;2;2;Floresta;11531;11474;57;0;15;-15
50;2;2;Glória;17115;16953;162;18;5;13
50;2;2;Guarujá;4791;4739;52;-1;0;-1
50;2;2;Higienópolis;10690;10614;76;-5;3;-8
50;2;2;Hípica;18644;18588;56;11;12;-1
50;2;2;Humaitá;11526;11454;72;-1;-1;0
50;2;2;Independência;8120;7970;150;6;15;-9
50;2;2;Ipanema;13716;13650;66;2;-1;3
50;2;2;Jardim Botânico;12554;12405;149;14;29;-15
50;2;2;Jardim Carvalho;25485;25311;174;-16;1;-17
50;2;2;Jardim do Salso;4375;4312;63;8;14;-6
50;2;2;Jardim Dona Leopoldina;18010;17944;66;15;31;-16
50;2;2;Jardim Europa;2256;2192;64;7;12;-5
50;2;2;Jardim Floresta;3284;3214;70;5;6;-1
50;2;2;Jardim Isabel;2798;2742;56;1;2;-1
50;2;2;Jardim Itu;17832;17755;77;2;15;-13
50;2;2;Jardim Lindóia;7394;7325;69;1;13;-12
50;2;2;Jardim Sabará;13519;13440;79;5;13;-8
50;2;2;Jardim São Pedro;3944;3877;67;15;21;-6
50;2;2;Lageado;4483;4447;36;3;3;0
50;2;2;Lami;4284;4259;25;3;1;2
50;2;2;Lomba do Pinheiro;58158;58080;78;-22;-1;-21
50;2;2;Mário Quintana;38146;38060;86;-5;11;-16
50;2;2;Medianeira;11157;11103;54;-4;12;-16
50;2;2;Menino Deus;31748;31543;205;-12;18;-30
50;2;2;Moinhos de Vento;11988;11819;169;-7;20;-27
50;2;2;MontSerrat;11183;11112;71;6;18;-12
50;2;2;Morro Santana;19356;19269;87;2;1;1
50;2;2;Navegantes;4325;4253;72;-2;-2;0
50;2;2;Nonoai;25147;25064;83;4;7;-3
50;2;2;Parque Santa Fé;6347;6291;56;6;15;-9
50;2;2;Partenon;48172;48065;107;-25;10;-35
50;2;2;Passo DAreia;21972;21867;105;4;8;-4
50;2;2;Passo das Pedras;15897;15822;75;-1;10;-11
50;2;2;Pedra Redonda;240;187;53;2;5;-3
50;2;2;Petrópolis;37490;37386;104;-21;2;-23
50;2;2;Pitinga;4373;4332;41;8;5;3
50;2;2;Ponta Grossa;8734;8686;48;3;-1;4
50;2;2;Praia de Belas;2248;2191;57;7;19;-12
50;2;2;Restinga;53644;53482;162;-29;-2;-27
50;2;2;Rio Branco;17565;17369;196;-26;-1;-25
50;2;2;Rubem Berta;33182;33102;80;-14;18;-32
50;2;2;Santa Cecília;5800;5627;173;-9;5;-14
50;2;2;Santa Maria Goretti;3503;3425;78;4;3;1
50;2;2;Santa Rosa de Lima;35387;35293;94;2;2;0
50;2;2;Santa Tereza;39588;39492;96;-15;2;-17
50;2;2;Santana;20803;20583;220;-13;1;-14
50;2;2;Santo Antônio;13111;13044;67;-15;11;-26
50;2;2;São Caetano;766;730;36;-3;-3;0
50;2;2;São Geraldo;8684;8600;84;3;9;-6
50;2;2;São João;12240;12146;94;-8;1;-9
50;2;2;São Sebastião;7017;6940;77;3;9;-6
50;2;2;Sarandi;59764;59652;112;-31;4;-35
50;2;2;Serraria;6250;6192;58;2;2;0
50;2;2;Sétimo Céu;1300;1245;55;8;8;0
50;2;2;Teresópolis;14800;14613;187;-10;-1;-9
50;2;2;Três Figueiras;4057;3971;86;2;0;2
50;2;2;Tristeza;16675;16602;73;0;3;-3
50;2;2;Vila Assunção;4506;4361;145;-11;-6;-5
50;2;2;Vila Conceição;1360;1300;60;1;0;1
50;2;2;Vila Ipiranga;18649;18556;93;-5;7;-12
50;2;2;Vila Jardim;13178;13089;89;-2;3;-5
50;2;2;Vila João Pessoa;13033;12958;75;1;13;-12
50;2;2;Vila Nova;32598;32412;186;-29;-2;-27
50;2;2;Vila São José;26556;26456;100;2;6;-4
51;3;2;Aberta dos Morros;7105;7067;38;0;-1;1
51;3;2;Agronomia;2336;2299;37;-1;0;-1
51;3;2;Anchieta;2028;1979;49;3;3;0
51;3;2;Arquipélago;8338;8285;53;4;2;2
51;3;2;Auxiliadora;9613;9572;41;6;20;-14
51;3;2;Azenha;13813;13691;122;36;47;-11
51;3;2;Bela Vista;11703;11666;37;0;21;-21
51;3;2;Belém Novo;10088;10068;20;1;2;-1
51;3;2;Belém Velho;10839;10788;51;7;6;1
51;3;2;Boa Vista;10009;9955;54;4;17;-13
51;3;2;Boa Vista do Sul;2281;2266;15;1;2;-1
51;3;2;Bom Fim;11465;11449;16;19;24;-5
51;3;2;Bom Jesus;28669;28604;65;11;20;-9
51;3;2;Camaquã;17925;17872;53;5;20;-15
51;3;2;Campo Novo;8750;8701;49;1;4;-3
51;3;2;Cascata;13002;12951;51;4;14;-10
51;3;2;Cavalhada;29294;29227;67;9;17;-8
51;3;2;Centro;39287;39083;204;-23;0;-23
51;3;2;Chácara das Pedras;6632;6585;47;11;21;-10
51;3;2;Chapéu do Sol;2901;2868;33;3;3;0
51;3;2;Cidade Baixa;15285;15254;31;-14;12;-26
51;3;2;Coronel Aparício Borges;19258;19223;35;-3;28;-31
51;3;2;Costa e Silva;15841;15793;48;-3;22;-25
51;3;2;Cristal;31944;31886;58;-14;13;-27
51;3;2;Cristo Redentor;16502;16354;148;28;35;-7
51;3;2;Espírito Santo;5573;5526;47;2;6;-4
51;3;2;Extrema;1975;1963;12;0;-1;1
51;3;2;Farrapos;19020;18945;75;-3;2;-5
51;3;2;Farroupilha;945;838;107;24;32;-8
51;3;2;Floresta;11535;11490;45;4;16;-12
51;3;2;Glória;17133;16983;150;18;30;-12
51;3;2;Guarujá;4792;4741;51;1;2;-1
51;3;2;Higienópolis;10689;10621;68;-1;7;-8
51;3;2;Hípica;18640;18590;50;-4;2;-6
51;3;2;Humaitá;11527;11458;69;1;4;-3
51;3;2;Independência;8130;7988;142;10;18;-8
51;3;2;Ipanema;13721;13657;64;5;7;-2
51;3;2;Jardim Botânico;12555;12424;131;1;19;-18
51;3;2;Jardim Carvalho;25521;25332;189;36;21;15
51;3;2;Jardim do Salso;4370;4322;48;-5;10;-15
51;3;2;Jardim Dona Leopoldina;18012;17969;43;2;25;-23
51;3;2;Jardim Europa;2264;2212;52;8;20;-12
51;3;2;Jardim Floresta;3295;3232;63;11;18;-7
51;3;2;Jardim Isabel;2801;2747;54;3;5;-2
51;3;2;Jardim Itu;17823;17774;49;-9;19;-28
51;3;2;Jardim Lindóia;7401;7341;60;7;16;-9
51;3;2;Jardim Sabará;13516;13461;55;-3;21;-24
51;3;2;Jardim São Pedro;3947;3886;61;3;9;-6
51;3;2;Lageado;4486;4450;36;3;3;0
51;3;2;Lami;4282;4258;24;-2;-1;-1
51;3;2;Lomba do Pinheiro;58164;58081;83;6;1;5
51;3;2;Mário Quintana;38142;38077;65;-4;17;-21
51;3;2;Medianeira;11149;11116;33;-8;13;-21
51;3;2;Menino Deus;31758;31559;199;10;16;-6
51;3;2;Moinhos de Vento;11990;11828;162;2;9;-7
51;3;2;MontSerrat;11172;11119;53;-11;7;-18
51;3;2;Morro Santana;19350;19281;69;-6;12;-18
51;3;2;Navegantes;4326;4257;69;1;4;-3
51;3;2;Nonoai;25126;25079;47;-21;15;-36
51;3;2;Parque Santa Fé;6371;6324;47;24;33;-9
51;3;2;Partenon;48169;48082;87;-3;17;-20
51;3;2;Passo DAreia;21962;21882;80;-10;15;-25
51;3;2;Passo das Pedras;15892;15837;55;-5;15;-20
51;3;2;Pedra Redonda;240;190;50;0;3;-3
51;3;2;Petrópolis;37474;37391;83;-16;5;-21
51;3;2;Pitinga;4377;4334;43;4;2;2
51;3;2;Ponta Grossa;8733;8685;48;-1;-1;0
51;3;2;Praia de Belas;2253;2206;47;5;15;-10
51;3;2;Restinga;53634;53482;152;-10;0;-10
51;3;2;Rio Branco;17575;17391;184;10;22;-12
51;3;2;Rubem Berta;33161;33114;47;-21;12;-33
51;3;2;Santa Cecília;5800;5650;150;0;23;-23
51;3;2;Santa Maria Goretti;3501;3430;71;-2;5;-7
51;3;2;Santa Rosa de Lima;35367;35297;70;-20;4;-24
51;3;2;Santa Tereza;39575;39505;70;-13;13;-26
51;3;2;Santana;20792;20593;199;-11;10;-21
51;3;2;Santo Antônio;13098;13059;39;-13;15;-28
51;3;2;São Caetano;770;734;36;4;4;0
51;3;2;São Geraldo;8680;8609;71;-4;9;-13
51;3;2;São João;12237;12153;84;-3;7;-10
51;3;2;São Sebastião;7014;6952;62;-3;12;-15
51;3;2;Sarandi;59752;59659;93;-12;7;-19
51;3;2;Serraria;6249;6191;58;-1;-1;0
51;3;2;Sétimo Céu;1303;1249;54;3;4;-1
51;3;2;Teresópolis;14792;14624;168;-8;11;-19
51;3;2;Três Figueiras;4053;3978;75;-4;7;-11
51;3;2;Tristeza;16670;16612;58;-5;10;-15
51;3;2;Vila Assunção;4507;4367;140;1;6;-5
51;3;2;Vila Conceição;1359;1298;61;-1;-2;1
51;3;2;Vila Ipiranga;18632;18569;63;-17;13;-30
51;3;2;Vila Jardim;13176;13106;70;-2;17;-19
51;3;2;Vila João Pessoa;13025;12969;56;-8;11;-19
51;3;2;Vila Nova;32591;32418;173;-7;6;-13
51;3;2;Vila São José;26529;26461;68;-27;5;-32
52;4;2;Aberta dos Morros;6803;6441;362;-302;-626;324
52;4;2;Agronomia;1742;1676;66;-594;-623;29
52;4;2;Anchieta;1395;1360;35;-633;-619;-14
52;4;2;Arquipélago;8161;7678;483;-177;-607;430
52;4;2;Auxiliadora;9160;8635;525;-453;-937;484
52;4;2;Azenha;13463;12661;802;-350;-1030;680
52;4;2;Bela Vista;11320;10623;697;-383;-1043;660
52;4;2;Belém Novo;10045;9571;474;-43;-497;454
52;4;2;Belém Velho;10711;10072;639;-128;-716;588
52;4;2;Boa Vista;9555;8982;573;-454;-973;519
52;4;2;Boa Vista do Sul;1816;1776;40;-465;-490;25
52;4;2;Bom Fim;11002;10375;627;-463;-1074;611
52;4;2;Bom Jesus;29333;27546;1787;664;-1058;1722
52;4;2;Camaquã;17976;16982;994;51;-890;941
52;4;2;Campo Novo;8428;7982;446;-322;-719;397
52;4;2;Cascata;12863;12134;729;-139;-817;678
52;4;2;Cavalhada;30030;28322;1708;736;-905;1641
52;4;2;Centro;40506;38241;2265;1219;-842;2061
52;4;2;Chácara das Pedras;5845;5536;309;-787;-1049;262
52;4;2;Chapéu do Sol;2328;2270;58;-573;-598;25
52;4;2;Cidade Baixa;15125;14235;890;-160;-1019;859
52;4;2;Coronel Aparício Borges;19317;18199;1118;59;-1024;1083
52;4;2;Costa e Silva;15645;14795;850;-196;-998;802
52;4;2;Cristal;32906;31062;1844;962;-824;1786
52;4;2;Cristo Redentor;16264;15305;959;-238;-1049;811
52;4;2;Espírito Santo;5052;4803;249;-521;-723;202
52;4;2;Extrema;1579;1544;35;-396;-419;23
52;4;2;Farrapos;19334;18273;1061;314;-672;986
52;4;2;Farroupilha;445;445;0;-500;-393;-107
52;4;2;Floresta;11222;10554;668;-313;-936;623
52;4;2;Glória;16992;15961;1031;-141;-1022;881
52;4;2;Guarujá;4270;4068;202;-522;-673;151
52;4;2;Higienópolis;10269;9639;630;-420;-982;562
52;4;2;Hípica;18930;17935;995;290;-655;945
52;4;2;Humaitá;11405;10765;640;-122;-693;571
52;4;2;Independência;7388;6944;444;-742;-1044;302
52;4;2;Ipanema;13697;12949;748;-24;-708;684
52;4;2;Jardim Botânico;12039;11289;750;-516;-1135;619
52;4;2;Jardim Carvalho;25972;24399;1573;451;-933;1384
52;4;2;Jardim do Salso;3476;3292;184;-894;-1030;136
52;4;2;Jardim Dona Leopoldina;17937;16906;1031;-75;-1063;988
52;4;2;Jardim Europa;1311;1289;22;-953;-923;-30
52;4;2;Jardim Floresta;2482;2386;96;-813;-846;33
52;4;2;Jardim Isabel;2059;2025;34;-742;-722;-20
52;4;2;Jardim Itu;17885;16802;1083;62;-972;1034
52;4;2;Jardim Lindóia;6809;6413;396;-592;-928;336
52;4;2;Jardim Sabará;13300;12494;806;-216;-967;751
52;4;2;Jardim São Pedro;3164;2984;180;-783;-902;119
52;4;2;Lageado;4048;3853;195;-438;-597;159
52;4;2;Lami;3990;3783;207;-292;-475;183
52;4;2;Lomba do Pinheiro;60687;57423;3264;2523;-658;3181
52;4;2;Mário Quintana;39412;37264;2148;1270;-813;2083
52;4;2;Medianeira;10755;10117;638;-394;-999;605
52;4;2;Menino Deus;32647;30633;2014;889;-926;1815
52;4;2;Moinhos de Vento;11570;10829;741;-420;-999;579
52;4;2;MontSerrat;10773;10103;670;-399;-1016;617
52;4;2;Morro Santana;19621;18473;1148;271;-808;1079
52;4;2;Navegantes;3672;3473;199;-654;-784;130
52;4;2;Nonoai;25643;24174;1469;517;-905;1422
52;4;2;Parque Santa Fé;5675;5365;310;-696;-959;263
52;4;2;Partenon;49929;47087;2842;1760;-995;2755
52;4;2;Passo DAreia;22313;20961;1352;351;-921;1272
52;4;2;Passo das Pedras;15828;14914;914;-64;-923;859
52;4;2;Pedra Redonda;155;129;26;-85;-61;-24
52;4;2;Petrópolis;38759;36399;2360;1285;-992;2277
52;4;2;Pitinga;3959;3748;211;-418;-586;168
52;4;2;Ponta Grossa;8607;8166;441;-126;-519;393
52;4;2;Praia de Belas;1532;1409;123;-721;-797;76
52;4;2;Restinga;55921;52979;2942;2287;-503;2790
52;4;2;Rio Branco;17502;16362;1140;-73;-1029;956
52;4;2;Rubem Berta;34171;32277;1894;1010;-837;1847
52;4;2;Santa Cecília;4900;4589;311;-900;-1061;161
52;4;2;Santa Maria Goretti;2829;2596;233;-672;-834;162
52;4;2;Santa Rosa de Lima;36631;34600;2031;1264;-697;1961
52;4;2;Santa Tereza;41030;38649;2381;1455;-856;2311
52;4;2;Santana;21040;19631;1409;248;-962;1210
52;4;2;Santo Antônio;13016;12122;894;-82;-937;855
52;4;2;São Caetano;607;412;195;-163;-322;159
52;4;2;São Geraldo;8408;7816;592;-272;-793;521
52;4;2;São João;12256;11372;884;19;-781;800
52;4;2;São Sebastião;6497;6071;426;-517;-881;364
52;4;2;Sarandi;62626;58982;3644;2874;-677;3551
52;4;2;Serraria;6099;5723;376;-150;-468;318
52;4;2;Sétimo Céu;758;660;98;-545;-589;44
52;4;2;Teresópolis;14814;13736;1078;22;-888;910
52;4;2;Três Figueiras;3428;3041;387;-625;-937;312
52;4;2;Tristeza;16918;15899;1019;248;-713;961
52;4;2;Vila Assunção;4073;3709;364;-434;-658;224
52;4;2;Vila Conceição;933;764;169;-426;-534;108
52;4;2;Vila Ipiranga;19011;17704;1307;379;-865;1244
52;4;2;Vila Jardim;13222;12227;995;46;-879;925
52;4;2;Vila João Pessoa;12911;12022;889;-114;-947;833
52;4;2;Vila Nova;33894;31858;2036;1303;-560;1863
52;4;2;Vila São José;27525;25774;1751;996;-687;1683
53;5;2;Aberta dos Morros;6802;6436;366;-1;-5;4
53;5;2;Agronomia;1735;1672;63;-7;-4;-3
53;5;2;Anchieta;1387;1355;32;-8;-5;-3
53;5;2;Arquipélago;8174;7676;498;13;-2;15
53;5;2;Auxiliadora;9161;8631;530;1;-4;5
53;5;2;Azenha;13447;12634;813;-16;-27;11
53;5;2;Bela Vista;11309;10615;694;-11;-8;-3
53;5;2;Belém Novo;10052;9570;482;7;-1;8
53;5;2;Belém Velho;10705;10062;643;-6;-10;4
53;5;2;Boa Vista;9559;8977;582;4;-5;9
53;5;2;Boa Vista do Sul;1814;1775;39;-2;-1;-1
53;5;2;Bom Fim;10978;10363;615;-24;-12;-12
53;5;2;Bom Jesus;29370;27529;1841;37;-17;54
53;5;2;Camaquã;17981;16961;1020;5;-21;26
53;5;2;Campo Novo;8425;7970;455;-3;-12;9
53;5;2;Cascata;12879;12124;755;16;-10;26
53;5;2;Cavalhada;30073;28307;1766;43;-15;58
53;5;2;Centro;40566;38231;2335;60;-10;70
53;5;2;Chácara das Pedras;5830;5529;301;-15;-7;-8
53;5;2;Chapéu do Sol;2317;2269;48;-11;-1;-10
53;5;2;Cidade Baixa;15133;14218;915;8;-17;25
53;5;2;Coronel Aparício Borges;19334;18179;1155;17;-20;37
53;5;2;Costa e Silva;15631;14765;866;-14;-30;16
53;5;2;Cristal;32954;31047;1907;48;-15;63
53;5;2;Cristo Redentor;16255;15285;970;-9;-20;11
53;5;2;Espírito Santo;5048;4801;247;-4;-2;-2
53;5;2;Extrema;1579;1544;35;0;0;0
53;5;2;Farrapos;19352;18269;1083;18;-4;22
53;5;2;Farroupilha;441;441;0;-4;-4;0
53;5;2;Floresta;11224;10539;685;2;-15;17
53;5;2;Glória;16996;15933;1063;4;-28;32
53;5;2;Guarujá;4268;4064;204;-2;-4;2
53;5;2;Higienópolis;10268;9623;645;-1;-16;15
53;5;2;Hípica;18940;17922;1018;10;-13;23
53;5;2;Humaitá;11416;10758;658;11;-7;18
53;5;2;Independência;7383;6941;442;-5;-3;-2
53;5;2;Ipanema;13709;12944;765;12;-5;17
53;5;2;Jardim Botânico;12039;11272;767;0;-17;17
53;5;2;Jardim Carvalho;26004;24383;1621;32;-16;48
53;5;2;Jardim do Salso;3463;3287;176;-13;-5;-8
53;5;2;Jardim Dona Leopoldina;17924;16868;1056;-13;-38;25
53;5;2;Jardim Europa;1289;1283;6;-22;-6;-16
53;5;2;Jardim Floresta;2470;2381;89;-12;-5;-7
53;5;2;Jardim Isabel;2050;2022;28;-9;-3;-6
53;5;2;Jardim Itu;17897;16781;1116;12;-21;33
53;5;2;Jardim Lindóia;6815;6415;400;6;2;4
53;5;2;Jardim Sabará;13302;12476;826;2;-18;20
53;5;2;Jardim São Pedro;3158;2979;179;-6;-5;-1
53;5;2;Lageado;4045;3853;192;-3;0;-3
53;5;2;Lami;3993;3786;207;3;3;0
53;5;2;Lomba do Pinheiro;60757;57421;3336;70;-2;72
53;5;2;Mário Quintana;39460;37252;2208;48;-12;60
53;5;2;Medianeira;10748;10093;655;-7;-24;17
53;5;2;Menino Deus;32684;30601;2083;37;-32;69
53;5;2;Moinhos de Vento;11544;10798;746;-26;-31;5
53;5;2;MontSerrat;10776;10084;692;3;-19;22
53;5;2;Morro Santana;19642;18458;1184;21;-15;36
53;5;2;Navegantes;3670;3474;196;-2;1;-3
53;5;2;Nonoai;25668;24158;1510;25;-16;41
53;5;2;Parque Santa Fé;5655;5337;318;-20;-28;8
53;5;2;Partenon;49985;47052;2933;56;-35;91
53;5;2;Passo DAreia;22345;20950;1395;32;-11;43
53;5;2;Passo das Pedras;15831;14892;939;3;-22;25
53;5;2;Pedra Redonda;142;124;18;-13;-5;-8
53;5;2;Petrópolis;38820;36387;2433;61;-12;73
53;5;2;Pitinga;3946;3741;205;-13;-7;-6
53;5;2;Ponta Grossa;8589;8150;439;-18;-16;-2
53;5;2;Praia de Belas;1487;1399;88;-45;-10;-35
53;5;2;Restinga;55950;52971;2979;29;-8;37
53;5;2;Rio Branco;17480;16319;1161;-22;-43;21
53;5;2;Rubem Berta;34184;32255;1929;13;-22;35
53;5;2;Santa Cecília;4880;4583;297;-20;-6;-14
53;5;2;Santa Maria Goretti;2816;2592;224;-13;-4;-9
53;5;2;Santa Rosa de Lima;36644;34588;2056;13;-12;25
53;5;2;Santa Tereza;41042;38631;2411;12;-18;30
53;5;2;Santana;21023;19598;1425;-17;-33;16
53;5;2;Santo Antônio;12982;12095;887;-34;-27;-7
53;5;2;São Caetano;600;408;192;-7;-4;-3
53;5;2;São Geraldo;8395;7794;601;-13;-22;9
53;5;2;São João;12237;11350;887;-19;-22;3
53;5;2;São Sebastião;6484;6062;422;-13;-9;-4
53;5;2;Sarandi;62623;58961;3662;-3;-21;18
53;5;2;Serraria;6095;5712;383;-4;-11;7
53;5;2;Sétimo Céu;747;657;90;-11;-3;-8
53;5;2;Teresópolis;14776;13704;1072;-38;-32;-6
53;5;2;Três Figueiras;3396;3020;376;-32;-21;-11
53;5;2;Tristeza;16920;15891;1029;2;-8;10
53;5;2;Vila Assunção;4038;3695;343;-35;-14;-21
53;5;2;Vila Conceição;921;752;169;-12;-12;0
53;5;2;Vila Ipiranga;18977;17660;1317;-34;-44;10
53;5;2;Vila Jardim;13178;12173;1005;-44;-54;10
53;5;2;Vila João Pessoa;12884;11991;893;-27;-31;4
53;5;2;Vila Nova;33886;31835;2051;-8;-23;15
53;5;2;Vila São José;27500;25735;1765;-25;-39;14
54;6;2;Aberta dos Morros;6628;5873;755;-174;-563;389
54;6;2;Agronomia;1346;1169;177;-389;-503;114
54;6;2;Anchieta;1123;1012;111;-264;-343;79
54;6;2;Arquipélago;8079;7108;971;-95;-568;473
54;6;2;Auxiliadora;8818;7706;1112;-343;-925;582
54;6;2;Azenha;13227;11600;1627;-220;-1034;814
54;6;2;Bela Vista;10989;9591;1398;-320;-1024;704
54;6;2;Belém Novo;10132;9162;970;80;-408;488
54;6;2;Belém Velho;10612;9402;1210;-93;-660;567
54;6;2;Boa Vista;9183;8022;1161;-376;-955;579
54;6;2;Boa Vista do Sul;1492;1398;94;-322;-377;55
54;6;2;Bom Fim;10621;9337;1284;-357;-1026;669
54;6;2;Bom Jesus;30060;26575;3485;690;-954;1644
54;6;2;Camaquã;18101;16148;1953;120;-813;933
54;6;2;Campo Novo;8197;7318;879;-228;-652;424
54;6;2;Cascata;12818;11361;1457;-61;-763;702
54;6;2;Cavalhada;30728;27437;3291;655;-870;1525
54;6;2;Centro;41725;37401;4324;1159;-830;1989
54;6;2;Chácara das Pedras;5172;4524;648;-658;-1005;347
54;6;2;Chapéu do Sol;1882;1752;130;-435;-517;82
54;6;2;Cidade Baixa;15048;13263;1785;-85;-955;870
54;6;2;Coronel Aparício Borges;19436;17204;2232;102;-975;1077
54;6;2;Costa e Silva;15563;13832;1731;-68;-933;865
54;6;2;Cristal;33854;30261;3593;900;-786;1686
54;6;2;Cristo Redentor;16220;14320;1900;-35;-965;930
54;6;2;Espírito Santo;4669;4174;495;-379;-627;248
54;6;2;Extrema;1224;1173;51;-355;-371;16
54;6;2;Farrapos;19755;17653;2102;403;-616;1019
54;6;2;Farroupilha;442;439;3;1;-2;3
54;6;2;Floresta;10943;9660;1283;-281;-879;598
54;6;2;Glória;16989;14996;1993;-7;-937;930
54;6;2;Guarujá;3871;3496;375;-397;-568;171
54;6;2;Higienópolis;9916;8700;1216;-352;-923;571
54;6;2;Hípica;19293;17332;1961;353;-590;943
54;6;2;Humaitá;11332;10105;1227;-84;-653;569
54;6;2;Independência;6786;5955;831;-597;-986;389
54;6;2;Ipanema;13712;12258;1454;3;-686;689
54;6;2;Jardim Botânico;11647;10227;1420;-392;-1045;653
54;6;2;Jardim Carvalho;26448;23449;2999;444;-934;1378
54;6;2;Jardim do Salso;2635;2269;366;-828;-1018;190
54;6;2;Jardim Dona Leopoldina;17863;15834;2029;-61;-1034;973
54;6;2;Jardim Europa;1210;1122;88;-79;-161;82
54;6;2;Jardim Floresta;1869;1657;212;-601;-724;123
54;6;2;Jardim Isabel;1528;1430;98;-522;-592;70
54;6;2;Jardim Itu;17894;15793;2101;-3;-988;985
54;6;2;Jardim Lindóia;6297;5541;756;-518;-874;356
54;6;2;Jardim Sabará;13069;11503;1566;-233;-973;740
54;6;2;Jardim São Pedro;2434;2097;337;-724;-882;158
54;6;2;Lageado;3683;3365;318;-362;-488;126
54;6;2;Lami;3690;3391;299;-303;-395;92
54;6;2;Lomba do Pinheiro;62921;56734;6187;2164;-687;2851
54;6;2;Mário Quintana;40711;36413;4298;1251;-839;2090
54;6;2;Medianeira;10373;9115;1258;-375;-978;603
54;6;2;Menino Deus;33454;29627;3827;770;-974;1744
54;6;2;Moinhos de Vento;11246;9868;1378;-298;-930;632
54;6;2;MontSerrat;10384;9083;1301;-392;-1001;609
54;6;2;Morro Santana;19877;17614;2263;235;-844;1079
54;6;2;Navegantes;3101;2727;374;-569;-747;178
54;6;2;Nonoai;26120;23246;2874;452;-912;1364
54;6;2;Parque Santa Fé;4981;4390;591;-674;-947;273
54;6;2;Partenon;51593;46003;5590;1608;-1049;2657
54;6;2;Passo DAreia;22695;20008;2687;350;-942;1292
54;6;2;Passo das Pedras;15737;13919;1818;-94;-973;879
54;6;2;Pedra Redonda;124;123;1;-18;-1;-17
54;6;2;Petrópolis;40001;35363;4638;1181;-1024;2205
54;6;2;Pitinga;3542;3201;341;-404;-540;136
54;6;2;Ponta Grossa;8408;7609;799;-181;-541;360
54;6;2;Praia de Belas;1249;1123;126;-238;-276;38
54;6;2;Restinga;57538;52210;5328;1588;-761;2349
54;6;2;Rio Branco;17416;15298;2118;-64;-1021;957
54;6;2;Rubem Berta;34994;31351;3643;810;-904;1714
54;6;2;Santa Cecília;4104;3578;526;-776;-1005;229
54;6;2;Santa Maria Goretti;2093;1800;293;-723;-792;69
54;6;2;Santa Rosa de Lima;37645;33814;3831;1001;-774;1775
54;6;2;Santa Tereza;42288;37720;4568;1246;-911;2157
54;6;2;Santana;21074;18520;2554;51;-1078;1129
54;6;2;Santo Antônio;12657;11086;1571;-325;-1009;684
54;6;2;São Caetano;531;375;156;-69;-33;-36
54;6;2;São Geraldo;7994;6988;1006;-401;-806;405
54;6;2;São João;11992;10511;1481;-245;-839;594
54;6;2;São Sebastião;5895;5171;724;-589;-891;302
54;6;2;Sarandi;64707;58102;6605;2084;-859;2943
54;6;2;Serraria;5685;5093;592;-410;-619;209
54;6;2;Sétimo Céu;713;654;59;-34;-3;-31
54;6;2;Teresópolis;14464;12707;1757;-312;-997;685
54;6;2;Três Figueiras;2552;2103;449;-844;-917;73
54;6;2;Tristeza;16987;15163;1824;67;-728;795
54;6;2;Vila Assunção;3358;2956;402;-680;-739;59
54;6;2;Vila Conceição;832;668;164;-89;-84;-5
54;6;2;Vila Ipiranga;18979;16672;2307;2;-988;990
54;6;2;Vila Jardim;12820;11177;1643;-358;-996;638
54;6;2;Vila João Pessoa;12525;10957;1568;-359;-1034;675
54;6;2;Vila Nova;34743;31073;3670;857;-762;1619
54;6;2;Vila São José;27995;24855;3140;495;-880;1375
55;7;2;Aberta dos Morros;6239;4830;1409;-389;-1043;654
55;7;2;Agronomia;1255;925;330;-91;-244;153
55;7;2;Anchieta;1019;773;246;-104;-239;135
55;7;2;Arquipélago;7624;5909;1715;-455;-1199;744
55;7;2;Auxiliadora;8197;6133;2064;-621;-1573;952
55;7;2;Azenha;12506;9339;3167;-721;-2261;1540
55;7;2;Bela Vista;10246;7668;2578;-743;-1923;1180
55;7;2;Belém Novo;10059;8415;1644;-73;-747;674
55;7;2;Belém Velho;10069;7904;2165;-543;-1498;955
55;7;2;Boa Vista;8593;6400;2193;-590;-1622;1032
55;7;2;Boa Vista do Sul;1430;1233;197;-62;-165;103
55;7;2;Bom Fim;9911;7461;2450;-710;-1876;1166
55;7;2;Bom Jesus;30693;24186;6507;633;-2389;3022
55;7;2;Camaquã;17934;14227;3707;-167;-1921;1754
55;7;2;Campo Novo;7711;6096;1615;-486;-1222;736
55;7;2;Cascata;12217;9540;2677;-601;-1821;1220
55;7;2;Cavalhada;31752;25526;6226;1024;-1911;2935
55;7;2;Centro;43964;35610;8354;2239;-1791;4030
55;7;2;Chácara das Pedras;4779;3516;1263;-393;-1008;615
55;7;2;Chapéu do Sol;1791;1477;314;-91;-275;184
55;7;2;Cidade Baixa;14335;11110;3225;-713;-2153;1440
55;7;2;Coronel Aparício Borges;19036;14829;4207;-400;-2375;1975
55;7;2;Costa e Silva;14864;11591;3273;-699;-2241;1542
55;7;2;Cristal;35138;28546;6592;1284;-1715;2999
55;7;2;Cristo Redentor;15745;12004;3741;-475;-2316;1841
55;7;2;Espírito Santo;4411;3460;951;-258;-714;456
55;7;2;Extrema;1192;1049;143;-32;-124;92
55;7;2;Farrapos;20050;16245;3805;295;-1408;1703
55;7;2;Farroupilha;324;226;98;-118;-213;95
55;7;2;Floresta;10285;7913;2372;-658;-1747;1089
55;7;2;Glória;16480;12792;3688;-509;-2204;1695
55;7;2;Guarujá;3690;2945;745;-181;-551;370
55;7;2;Higienópolis;9311;7009;2302;-605;-1691;1086
55;7;2;Hípica;19545;16110;3435;252;-1222;1474
55;7;2;Humaitá;10876;8649;2227;-456;-1456;1000
55;7;2;Independência;6565;4728;1837;-221;-1227;1006
55;7;2;Ipanema;13507;10873;2634;-205;-1385;1180
55;7;2;Jardim Botânico;11086;8267;2819;-561;-1960;1399
55;7;2;Jardim Carvalho;26828;21357;5471;380;-2092;2472
55;7;2;Jardim do Salso;2454;1556;898;-181;-713;532
55;7;2;Jardim Dona Leopoldina;17108;13393;3715;-755;-2441;1686
55;7;2;Jardim Europa;1232;681;551;22;-441;463
55;7;2;Jardim Floresta;1698;1114;584;-171;-543;372
55;7;2;Jardim Isabel;1457;1008;449;-71;-422;351
55;7;2;Jardim Itu;17246;13457;3789;-648;-2336;1688
55;7;2;Jardim Lindóia;6066;4434;1632;-231;-1107;876
55;7;2;Jardim Sabará;12298;9472;2826;-771;-2031;1260
55;7;2;Jardim São Pedro;2248;1451;797;-186;-646;460
55;7;2;Lageado;3491;2921;570;-192;-444;252
55;7;2;Lami;3510;3017;493;-180;-374;194
55;7;2;Lomba do Pinheiro;66398;55458;10940;3477;-1276;4753
55;7;2;Mário Quintana;42507;34566;7941;1796;-1847;3643
55;7;2;Medianeira;9759;7417;2342;-614;-1698;1084
55;7;2;Menino Deus;34365;27474;6891;911;-2153;3064
55;7;2;Moinhos de Vento;10791;7991;2800;-455;-1877;1422
55;7;2;MontSerrat;9830;7438;2392;-554;-1645;1091
55;7;2;Morro Santana;19697;15681;4016;-180;-1933;1753
55;7;2;Navegantes;3112;1975;1137;11;-752;763
55;7;2;Nonoai;26481;21214;5267;361;-2032;2393
55;7;2;Parque Santa Fé;4632;3279;1353;-349;-1111;762
55;7;2;Partenon;54140;43620;10520;2547;-2383;4930
55;7;2;Passo DAreia;22739;17781;4958;44;-2227;2271
55;7;2;Passo das Pedras;15011;11685;3326;-726;-2234;1508
55;7;2;Pedra Redonda;85;57;28;-39;-66;27
55;7;2;Petrópolis;41360;33006;8354;1359;-2357;3716
55;7;2;Pitinga;3364;2598;766;-178;-603;425
55;7;2;Ponta Grossa;8030;6685;1345;-378;-924;546
55;7;2;Praia de Belas;1327;701;626;78;-422;500
55;7;2;Restinga;60015;51100;8915;2477;-1110;3587
55;7;2;Rio Branco;16802;12901;3901;-614;-2397;1783
55;7;2;Rubem Berta;36051;29347;6704;1057;-2004;3061
55;7;2;Santa Cecília;3837;2563;1274;-267;-1015;748
55;7;2;Santa Maria Goretti;1968;1233;735;-125;-567;442
55;7;2;Santa Rosa de Lima;38835;32217;6618;1190;-1597;2787
55;7;2;Santa Tereza;44038;35760;8278;1750;-1960;3710
55;7;2;Santana;20757;16126;4631;-317;-2394;2077
55;7;2;Santo Antônio;11908;9139;2769;-749;-1947;1198
55;7;2;São Caetano;493;253;240;-38;-122;84
55;7;2;São Geraldo;7476;5427;2049;-518;-1561;1043
55;7;2;São João;11471;8827;2644;-521;-1684;1163
55;7;2;São Sebastião;5706;3877;1829;-189;-1294;1105
55;7;2;Sarandi;67603;56287;11316;2896;-1815;4711
55;7;2;Serraria;5392;4195;1197;-293;-898;605
55;7;2;Sétimo Céu;601;409;192;-112;-245;133
55;7;2;Teresópolis;13642;10624;3018;-822;-2083;1261
55;7;2;Três Figueiras;2555;1387;1168;3;-716;719
55;7;2;Tristeza;16660;13628;3032;-327;-1535;1208
55;7;2;Vila Assunção;3203;2231;972;-155;-725;570
55;7;2;Vila Conceição;728;416;312;-104;-252;148
55;7;2;Vila Ipiranga;18244;14356;3888;-735;-2316;1581
55;7;2;Vila Jardim;12078;8987;3091;-742;-2190;1448
55;7;2;Vila João Pessoa;11822;8814;3008;-703;-2143;1440
55;7;2;Vila Nova;35615;29480;6135;872;-1593;2465
55;7;2;Vila São José;28158;22711;5447;163;-2144;2307
56;8;2;Aberta dos Morros;6288;5030;1258;49;200;-151
56;8;2;Agronomia;1307;1114;193;52;189;-137
56;8;2;Anchieta;1066;903;163;47;130;-83
56;8;2;Arquipélago;7757;6116;1641;133;207;-74
56;8;2;Auxiliadora;8184;6362;1822;-13;229;-242
56;8;2;Azenha;12329;9689;2640;-177;350;-527
56;8;2;Bela Vista;10253;7949;2304;7;281;-274
56;8;2;Belém Novo;10103;8434;1669;44;19;25
56;8;2;Belém Velho;10173;8051;2122;104;147;-43
56;8;2;Boa Vista;8611;6676;1935;18;276;-258
56;8;2;Boa Vista do Sul;1448;1312;136;18;79;-61
56;8;2;Bom Fim;9968;7813;2155;57;352;-295
56;8;2;Bom Jesus;30900;24364;6536;207;178;29
56;8;2;Camaquã;18046;14381;3665;112;154;-42
56;8;2;Campo Novo;7723;6200;1523;12;104;-92
56;8;2;Cascata;12274;9652;2622;57;112;-55
56;8;2;Cavalhada;31668;25645;6023;-84;119;-203
56;8;2;Centro;44168;35862;8306;204;252;-48
56;8;2;Chácara das Pedras;4784;3790;994;5;274;-269
56;8;2;Chapéu do Sol;1789;1583;206;-2;106;-108
56;8;2;Cidade Baixa;14520;11422;3098;185;312;-127
56;8;2;Coronel Aparício Borges;19158;14973;4185;122;144;-22
56;8;2;Costa e Silva;15002;11788;3214;138;197;-59
56;8;2;Cristal;35279;28665;6614;141;119;22
56;8;2;Cristo Redentor;15652;12280;3372;-93;276;-369
56;8;2;Espírito Santo;4305;3588;717;-106;128;-234
56;8;2;Extrema;1310;1165;145;118;116;2
56;8;2;Farrapos;20277;16441;3836;227;196;31
56;8;2;Farroupilha;203;174;29;-121;-52;-69
56;8;2;Floresta;10344;8122;2222;59;209;-150
56;8;2;Glória;16497;13018;3479;17;226;-209
56;8;2;Guarujá;3592;3038;554;-98;93;-191
56;8;2;Higienópolis;9350;7244;2106;39;235;-196
56;8;2;Hípica;19545;16174;3371;0;64;-64
56;8;2;Humaitá;11012;8831;2181;136;182;-46
56;8;2;Independência;6290;4975;1315;-275;247;-522
56;8;2;Ipanema;13466;10899;2567;-41;26;-67
56;8;2;Jardim Botânico;10815;8455;2360;-271;188;-459
56;8;2;Jardim Carvalho;26960;21539;5421;132;182;-50
56;8;2;Jardim do Salso;2460;1839;621;6;283;-277
56;8;2;Jardim Dona Leopoldina;17141;13552;3589;33;159;-126
56;8;2;Jardim Europa;879;643;236;-353;-38;-315
56;8;2;Jardim Floresta;1699;1273;426;1;159;-158
56;8;2;Jardim Isabel;1490;1158;332;33;150;-117
56;8;2;Jardim Itu;17291;13629;3662;45;172;-127
56;8;2;Jardim Lindóia;5760;4591;1169;-306;157;-463
56;8;2;Jardim Sabará;12314;9622;2692;16;150;-134
56;8;2;Jardim São Pedro;2291;1719;572;43;268;-225
56;8;2;Lageado;3404;2958;446;-87;37;-124
56;8;2;Lami;3399;3045;354;-111;28;-139
56;8;2;Lomba do Pinheiro;66171;55396;10775;-227;-62;-165
56;8;2;Mário Quintana;42539;34636;7903;32;70;-38
56;8;2;Medianeira;9737;7613;2124;-22;196;-218
56;8;2;Menino Deus;34488;27696;6792;123;222;-99
56;8;2;Moinhos de Vento;10497;8164;2333;-294;173;-467
56;8;2;MontSerrat;9797;7640;2157;-33;202;-235
56;8;2;Morro Santana;19751;15799;3952;54;118;-64
56;8;2;Navegantes;2866;2160;706;-246;185;-431
56;8;2;Nonoai;26539;21314;5225;58;100;-42
56;8;2;Parque Santa Fé;4575;3516;1059;-57;237;-294
56;8;2;Partenon;54237;43705;10532;97;85;12
56;8;2;Passo DAreia;22781;17906;4875;42;125;-83
56;8;2;Passo das Pedras;15013;11805;3208;2;120;-118
56;8;2;Pedra Redonda;55;30;25;-30;-27;-3
56;8;2;Petrópolis;41372;33075;8297;12;69;-57
56;8;2;Pitinga;3321;2702;619;-43;104;-147
56;8;2;Ponta Grossa;7990;6704;1286;-40;19;-59
56;8;2;Praia de Belas;1040;722;318;-287;21;-308
56;8;2;Restinga;60212;51124;9088;197;24;173
56;8;2;Rio Branco;16746;13057;3689;-56;156;-212
56;8;2;Rubem Berta;35985;29395;6590;-66;48;-114
56;8;2;Santa Cecília;3801;2863;938;-36;300;-336
56;8;2;Santa Maria Goretti;2037;1462;575;69;229;-160
56;8;2;Santa Rosa de Lima;38951;32322;6629;116;105;11
56;8;2;Santa Tereza;43956;35853;8103;-82;93;-175
56;8;2;Santana;20727;16312;4415;-30;186;-216
56;8;2;Santo Antônio;11891;9323;2568;-17;184;-201
56;8;2;São Caetano;594;265;329;101;12;89
56;8;2;São Geraldo;7504;5560;1944;28;133;-105
56;8;2;São João;11332;8888;2444;-139;61;-200
56;8;2;São Sebastião;5341;3996;1345;-365;119;-484
56;8;2;Sarandi;67704;56237;11467;101;-50;151
56;8;2;Serraria;5357;4232;1125;-35;37;-72
56;8;2;Sétimo Céu;586;373;213;-15;-36;21
56;8;2;Teresópolis;13668;10729;2939;26;105;-79
56;8;2;Três Figueiras;2490;1690;800;-65;303;-368
56;8;2;Tristeza;16631;13644;2987;-29;16;-45
56;8;2;Vila Assunção;3262;2396;866;59;165;-106
56;8;2;Vila Conceição;867;437;430;139;21;118
56;8;2;Vila Ipiranga;18264;14436;3828;20;80;-60
56;8;2;Vila Jardim;12218;9147;3071;140;160;-20
56;8;2;Vila João Pessoa;11822;8899;2923;0;85;-85
56;8;2;Vila Nova;35709;29448;6261;94;-32;126
56;8;2;Vila São José;28383;22753;5630;225;42;183
57;9;2;Aberta dos Morros;6253;5014;1239;-35;-16;-19
57;9;2;Agronomia;1275;1102;173;-32;-12;-20
57;9;2;Anchieta;1080;908;172;14;5;9
57;9;2;Arquipélago;7745;6094;1651;-12;-22;10
57;9;2;Auxiliadora;8143;6334;1809;-41;-28;-13
57;9;2;Azenha;12275;9594;2681;-54;-95;41
57;9;2;Bela Vista;10185;7903;2282;-68;-46;-22
57;9;2;Belém Novo;10089;8441;1648;-14;7;-21
57;9;2;Belém Velho;10203;8061;2142;30;10;20
57;9;2;Boa Vista;8568;6643;1925;-43;-33;-10
57;9;2;Boa Vista do Sul;1463;1319;144;15;7;8
57;9;2;Bom Fim;9866;7734;2132;-102;-79;-23
57;9;2;Bom Jesus;30973;24275;6698;73;-89;162
57;9;2;Camaquã;18053;14337;3716;7;-44;51
57;9;2;Campo Novo;7716;6181;1535;-7;-19;12
57;9;2;Cascata;12305;9621;2684;31;-31;62
57;9;2;Cavalhada;31708;25608;6100;40;-37;77
57;9;2;Centro;44416;35806;8610;248;-56;304
57;9;2;Chácara das Pedras;4734;3765;969;-50;-25;-25
57;9;2;Chapéu do Sol;1765;1562;203;-24;-21;-3
57;9;2;Cidade Baixa;14489;11332;3157;-31;-90;59
57;9;2;Coronel Aparício Borges;19224;14925;4299;66;-48;114
57;9;2;Costa e Silva;14989;11705;3284;-13;-83;70
57;9;2;Cristal;35307;28600;6707;28;-65;93
57;9;2;Cristo Redentor;15778;12294;3484;126;14;112
57;9;2;Espírito Santo;4307;3587;720;2;-1;3
57;9;2;Extrema;1325;1175;150;15;10;5
57;9;2;Farrapos;20293;16425;3868;16;-16;32
57;9;2;Farroupilha;185;185;0;-18;11;-29
57;9;2;Floresta;10358;8065;2293;14;-57;71
57;9;2;Glória;16607;12976;3631;110;-42;152
57;9;2;Guarujá;3609;3033;576;17;-5;22
57;9;2;Higienópolis;9359;7214;2145;9;-30;39
57;9;2;Hípica;19586;16144;3442;41;-30;71
57;9;2;Humaitá;11071;8812;2259;59;-19;78
57;9;2;Independência;6240;4900;1340;-50;-75;25
57;9;2;Ipanema;13515;10886;2629;49;-13;62
57;9;2;Jardim Botânico;10828;8400;2428;13;-55;68
57;9;2;Jardim Carvalho;27131;21514;5617;171;-25;196
57;9;2;Jardim do Salso;2353;1827;526;-107;-12;-95
57;9;2;Jardim Dona Leopoldina;17110;13445;3665;-31;-107;76
57;9;2;Jardim Europa;852;667;185;-27;24;-51
57;9;2;Jardim Floresta;1660;1295;365;-39;22;-61
57;9;2;Jardim Isabel;1508;1186;322;18;28;-10
57;9;2;Jardim Itu;17331;13573;3758;40;-56;96
57;9;2;Jardim Lindóia;5785;4585;1200;25;-6;31
57;9;2;Jardim Sabará;12302;9587;2715;-12;-35;23
57;9;2;Jardim São Pedro;2243;1712;531;-48;-7;-41
57;9;2;Lageado;3399;2967;432;-5;9;-14
57;9;2;Lami;3397;3048;349;-2;3;-5
57;9;2;Lomba do Pinheiro;66359;55388;10971;188;-8;196
57;9;2;Mário Quintana;42553;34550;8003;14;-86;100
57;9;2;Medianeira;9722;7562;2160;-15;-51;36
57;9;2;Menino Deus;34555;27575;6980;67;-121;188
57;9;2;Moinhos de Vento;10501;8100;2401;4;-64;68
57;9;2;MontSerrat;9768;7565;2203;-29;-75;46
57;9;2;Morro Santana;19752;15709;4043;1;-90;91
57;9;2;Navegantes;2853;2158;695;-13;-2;-11
57;9;2;Nonoai;26589;21233;5356;50;-81;131
57;9;2;Parque Santa Fé;4440;3472;968;-135;-44;-91
57;9;2;Partenon;54516;43632;10884;279;-73;352
57;9;2;Passo DAreia;22821;17862;4959;40;-44;84
57;9;2;Passo das Pedras;15066;11722;3344;53;-83;136
57;9;2;Pedra Redonda;55;44;11;0;14;-14
57;9;2;Petrópolis;41550;32959;8591;178;-116;294
57;9;2;Pitinga;3319;2695;624;-2;-7;5
57;9;2;Ponta Grossa;7987;6695;1292;-3;-9;6
57;9;2;Praia de Belas;957;699;258;-83;-23;-60
57;9;2;Restinga;60149;51117;9032;-63;-7;-56
57;9;2;Rio Branco;16768;12935;3833;22;-122;144
57;9;2;Rubem Berta;36141;29323;6818;156;-72;228
57;9;2;Santa Cecília;3692;2817;875;-109;-46;-63
57;9;2;Santa Maria Goretti;1982;1438;544;-55;-24;-31
57;9;2;Santa Rosa de Lima;39021;32275;6746;70;-47;117
57;9;2;Santa Tereza;44037;35757;8280;81;-96;177
57;9;2;Santana;20759;16178;4581;32;-134;166
57;9;2;Santo Antônio;11841;9216;2625;-50;-107;57
57;9;2;São Caetano;586;273;313;-8;8;-16
57;9;2;São Geraldo;7434;5507;1927;-70;-53;-17
57;9;2;São João;11330;8856;2474;-2;-32;30
57;9;2;São Sebastião;5258;3964;1294;-83;-32;-51
57;9;2;Sarandi;67685;56159;11526;-19;-78;59
57;9;2;Serraria;5344;4205;1139;-13;-27;14
57;9;2;Sétimo Céu;548;389;159;-38;16;-54
57;9;2;Teresópolis;13575;10642;2933;-93;-87;-6
57;9;2;Três Figueiras;2390;1622;768;-100;-68;-32
57;9;2;Tristeza;16655;13669;2986;24;25;-1
57;9;2;Vila Assunção;3177;2376;801;-85;-20;-65
57;9;2;Vila Conceição;818;444;374;-49;7;-56
57;9;2;Vila Ipiranga;18153;14330;3823;-111;-106;-5
57;9;2;Vila Jardim;12113;9055;3058;-105;-92;-13
57;9;2;Vila João Pessoa;11790;8855;2935;-32;-44;12
57;9;2;Vila Nova;35587;29390;6197;-122;-58;-64
57;9;2;Vila São José;28199;22638;5561;-184;-115;-69
58;10;2;Aberta dos Morros;6296;5194;1102;43;180;-137
58;10;2;Agronomia;1448;1177;271;173;75;98
58;10;2;Anchieta;1242;996;246;162;88;74
58;10;2;Arquipélago;7793;6281;1512;48;187;-139
58;10;2;Auxiliadora;8190;6607;1583;47;273;-226
58;10;2;Azenha;12306;9872;2434;31;278;-247
58;10;2;Bela Vista;10224;8189;2035;39;286;-247
58;10;2;Belém Novo;10062;8629;1433;-27;188;-215
58;10;2;Belém Velho;10214;8264;1950;11;203;-192
58;10;2;Boa Vista;8664;6953;1711;96;310;-214
58;10;2;Boa Vista do Sul;1735;1523;212;272;204;68
58;10;2;Bom Fim;9940;8048;1892;74;314;-240
58;10;2;Bom Jesus;30942;24576;6366;-31;301;-332
58;10;2;Camaquã;17991;14562;3429;-62;225;-287
58;10;2;Campo Novo;7789;6457;1332;73;276;-203
58;10;2;Cascata;12258;9867;2391;-47;246;-293
58;10;2;Cavalhada;31797;25795;6002;89;187;-98
58;10;2;Centro;44306;35765;8541;-110;-41;-69
58;10;2;Chácara das Pedras;5156;4168;988;422;403;19
58;10;2;Chapéu do Sol;2075;1770;305;310;208;102
58;10;2;Cidade Baixa;14444;11634;2810;-45;302;-347
58;10;2;Coronel Aparício Borges;19074;15184;3890;-150;259;-409
58;10;2;Costa e Silva;14873;11978;2895;-116;273;-389
58;10;2;Cristal;35128;28734;6394;-179;134;-313
58;10;2;Cristo Redentor;15660;12556;3104;-118;262;-380
58;10;2;Espírito Santo;4533;3809;724;226;222;4
58;10;2;Extrema;1474;1302;172;149;127;22
58;10;2;Farrapos;20212;16543;3669;-81;118;-199
58;10;2;Farroupilha;183;183;0;-2;-2;0
58;10;2;Floresta;10309;8369;1940;-49;304;-353
58;10;2;Glória;16394;13207;3187;-213;231;-444
58;10;2;Guarujá;3877;3264;613;268;231;37
58;10;2;Higienópolis;9364;7543;1821;5;329;-324
58;10;2;Hípica;19379;16206;3173;-207;62;-269
58;10;2;Humaitá;11030;9007;2023;-41;195;-236
58;10;2;Independência;6662;5221;1441;422;321;101
58;10;2;Ipanema;13413;11089;2324;-102;203;-305
58;10;2;Jardim Botânico;10918;8761;2157;90;361;-271
58;10;2;Jardim Carvalho;26819;21646;5173;-312;132;-444
58;10;2;Jardim do Salso;2766;2200;566;413;373;40
58;10;2;Jardim Dona Leopoldina;16906;13697;3209;-204;252;-456
58;10;2;Jardim Europa;1010;689;321;158;22;136
58;10;2;Jardim Floresta;1944;1529;415;284;234;50
58;10;2;Jardim Isabel;1784;1420;364;276;234;42
58;10;2;Jardim Itu;17186;13798;3388;-145;225;-370
58;10;2;Jardim Lindóia;6073;4826;1247;288;241;47
58;10;2;Jardim Sabará;12315;9922;2393;13;335;-322
58;10;2;Jardim São Pedro;2533;2002;531;290;290;0
58;10;2;Lageado;3605;3158;447;206;191;15
58;10;2;Lami;3615;3216;399;218;168;50
58;10;2;Lomba do Pinheiro;65992;55337;10655;-367;-51;-316
58;10;2;Mário Quintana;42075;34638;7437;-478;88;-566
58;10;2;Medianeira;9702;7906;1796;-20;344;-364
58;10;2;Menino Deus;34177;27646;6531;-378;71;-449
58;10;2;Moinhos de Vento;10472;8344;2128;-29;244;-273
58;10;2;MontSerrat;9761;7900;1861;-7;335;-342
58;10;2;Morro Santana;19582;15836;3746;-170;127;-297
58;10;2;Navegantes;3285;2434;851;432;276;156
58;10;2;Nonoai;26397;21394;5003;-192;161;-353
58;10;2;Parque Santa Fé;4614;3708;906;174;236;-62
58;10;2;Partenon;54223;43761;10462;-293;129;-422
58;10;2;Passo DAreia;22683;18105;4578;-138;243;-381
58;10;2;Passo das Pedras;14917;11941;2976;-149;219;-368
58;10;2;Pedra Redonda;41;37;4;-14;-7;-7
58;10;2;Petrópolis;41290;33129;8161;-260;170;-430
58;10;2;Pitinga;3495;2842;653;176;147;29
58;10;2;Ponta Grossa;7925;6878;1047;-62;183;-245
58;10;2;Praia de Belas;1190;784;406;233;85;148
58;10;2;Restinga;59184;50967;8217;-965;-150;-815
58;10;2;Rio Branco;16611;13248;3363;-157;313;-470
58;10;2;Rubem Berta;35804;29365;6439;-337;42;-379
58;10;2;Santa Cecília;4073;3196;877;381;379;2
58;10;2;Santa Maria Goretti;2250;1743;507;268;305;-37
58;10;2;Santa Rosa de Lima;38698;32229;6469;-323;-46;-277
58;10;2;Santa Tereza;43777;35827;7950;-260;70;-330
58;10;2;Santana;20530;16427;4103;-229;249;-478
58;10;2;Santo Antônio;11817;9509;2308;-24;293;-317
58;10;2;São Caetano;485;274;211;-101;1;-102
58;10;2;São Geraldo;7417;5810;1607;-17;303;-320
58;10;2;São João;11441;9138;2303;111;282;-171
58;10;2;São Sebastião;5568;4261;1307;310;297;13
58;10;2;Sarandi;67661;56233;11428;-24;74;-98
58;10;2;Serraria;5390;4411;979;46;206;-160
58;10;2;Sétimo Céu;519;385;134;-29;-4;-25
58;10;2;Teresópolis;13421;10897;2524;-154;255;-409
58;10;2;Três Figueiras;2792;1953;839;402;331;71
58;10;2;Tristeza;16575;13860;2715;-80;191;-271
58;10;2;Vila Assunção;3427;2647;780;250;271;-21
58;10;2;Vila Conceição;737;483;254;-81;39;-120
58;10;2;Vila Ipiranga;18080;14561;3519;-73;231;-304
58;10;2;Vila Jardim;12121;9427;2694;8;372;-364
58;10;2;Vila João Pessoa;11703;9222;2481;-87;367;-454
58;10;2;Vila Nova;35350;29511;5839;-237;121;-358
58;10;2;Vila São José;28188;22890;5298;-11;252;-263
59;11;2;Aberta dos Morros;6643;6097;546;347;903;-556
59;11;2;Agronomia;1417;1302;115;-31;125;-156
59;11;2;Anchieta;1176;1085;91;-66;89;-155
59;11;2;Arquipélago;8220;7301;919;427;1020;-593
59;11;2;Auxiliadora;8571;7911;660;381;1304;-923
59;11;2;Azenha;12963;11837;1126;657;1965;-1308
59;11;2;Bela Vista;10758;9783;975;534;1594;-1060
59;11;2;Belém Novo;10125;9297;828;63;668;-605
59;11;2;Belém Velho;10727;9575;1152;513;1311;-798
59;11;2;Boa Vista;8956;8239;717;292;1286;-994
59;11;2;Boa Vista do Sul;1741;1635;106;6;112;-106
59;11;2;Bom Fim;10315;9536;779;375;1488;-1113
59;11;2;Bom Jesus;30502;26563;3939;-440;1987;-2427
59;11;2;Camaquã;18151;16158;1993;160;1596;-1436
59;11;2;Campo Novo;8181;7484;697;392;1027;-635
59;11;2;Cascata;12830;11414;1416;572;1547;-975
59;11;2;Cavalhada;31094;27396;3698;-703;1601;-2304
59;11;2;Centro;42560;37292;5268;-1746;1527;-3273
59;11;2;Chácara das Pedras;5229;4855;374;73;687;-614
59;11;2;Chapéu do Sol;2076;1946;130;1;176;-175
59;11;2;Cidade Baixa;14954;13414;1540;510;1780;-1270
59;11;2;Coronel Aparício Borges;19388;17104;2284;314;1920;-1606
59;11;2;Costa e Silva;15433;13795;1638;560;1817;-1257
59;11;2;Cristal;34205;30161;4044;-923;1427;-2350
59;11;2;Cristo Redentor;16185;14425;1760;525;1869;-1344
59;11;2;Espírito Santo;4695;4345;350;162;536;-374
59;11;2;Extrema;1490;1398;92;16;96;-80
59;11;2;Farrapos;20049;17753;2296;-163;1210;-1373
59;11;2;Farroupilha;265;265;0;82;82;0
59;11;2;Floresta;10776;9731;1045;467;1362;-895
59;11;2;Glória;16824;15011;1813;430;1804;-1374
59;11;2;Guarujá;3975;3685;290;98;421;-323
59;11;2;Higienópolis;9738;8855;883;374;1312;-938
59;11;2;Hípica;19275;17234;2041;-104;1028;-1132
59;11;2;Humaitá;11422;10237;1185;392;1230;-838
59;11;2;Independência;6847;6122;725;185;901;-716
59;11;2;Ipanema;13564;12244;1320;151;1155;-1004
59;11;2;Jardim Botânico;11388;10345;1043;470;1584;-1114
59;11;2;Jardim Carvalho;26593;23327;3266;-226;1681;-1907
59;11;2;Jardim do Salso;2775;2573;202;9;373;-364
59;11;2;Jardim Dona Leopoldina;17465;15602;1863;559;1905;-1346
59;11;2;Jardim Europa;1184;864;320;174;175;-1
59;11;2;Jardim Floresta;1946;1846;100;2;317;-315
59;11;2;Jardim Isabel;1794;1686;108;10;266;-256
59;11;2;Jardim Itu;17740;15691;2049;554;1893;-1339
59;11;2;Jardim Lindóia;6314;5646;668;241;820;-579
59;11;2;Jardim Sabará;12911;11522;1389;596;1600;-1004
59;11;2;Jardim São Pedro;2542;2358;184;9;356;-347
59;11;2;Lageado;3696;3478;218;91;320;-229
59;11;2;Lami;3765;3544;221;150;328;-178
59;11;2;Lomba do Pinheiro;63357;56492;6865;-2635;1155;-3790
59;11;2;Mário Quintana;40786;36176;4610;-1289;1538;-2827
59;11;2;Medianeira;10109;9189;920;407;1283;-876
59;11;2;Menino Deus;33512;29390;4122;-665;1744;-2409
59;11;2;Moinhos de Vento;10980;9854;1126;508;1510;-1002
59;11;2;MontSerrat;10105;9134;971;344;1234;-890
59;11;2;Morro Santana;19816;17432;2384;234;1596;-1362
59;11;2;Navegantes;3428;2933;495;143;499;-356
59;11;2;Nonoai;26120;23051;3069;-277;1657;-1934
59;11;2;Parque Santa Fé;4800;4449;351;186;741;-555
59;11;2;Partenon;52295;45730;6565;-1928;1969;-3897
59;11;2;Passo DAreia;22573;19812;2761;-110;1707;-1817
59;11;2;Passo das Pedras;15515;13739;1776;598;1798;-1200
59;11;2;Pedra Redonda;65;65;0;24;28;-4
59;11;2;Petrópolis;40159;35011;5148;-1131;1882;-3013
59;11;2;Pitinga;3585;3327;258;90;485;-395
59;11;2;Ponta Grossa;8242;7663;579;317;785;-468
59;11;2;Praia de Belas;1335;960;375;145;176;-31
59;11;2;Restinga;57320;51935;5385;-1864;968;-2832
59;11;2;Rio Branco;17016;15096;1920;405;1848;-1443
59;11;2;Rubem Berta;35033;30960;4073;-771;1595;-2366
59;11;2;Santa Cecília;4176;3799;377;103;603;-500
59;11;2;Santa Maria Goretti;2191;1999;192;-59;256;-315
59;11;2;Santa Rosa de Lima;37817;33547;4270;-881;1318;-2199
59;11;2;Santa Tereza;42504;37422;5082;-1273;1595;-2868
59;11;2;Santana;20807;18316;2491;277;1889;-1612
59;11;2;Santo Antônio;12349;11002;1347;532;1493;-961
59;11;2;São Caetano;505;343;162;20;69;-49
59;11;2;São Geraldo;7744;7004;740;327;1194;-867
59;11;2;São João;11972;10401;1571;531;1263;-732
59;11;2;São Sebastião;5867;5213;654;299;952;-653
59;11;2;Sarandi;65378;57607;7771;-2283;1374;-3657
59;11;2;Serraria;5590;5139;451;200;728;-528
59;11;2;Sétimo Céu;558;500;58;39;115;-76
59;11;2;Teresópolis;14110;12556;1554;689;1659;-970
59;11;2;Três Figueiras;2885;2291;594;93;338;-245
59;11;2;Tristeza;16785;15027;1758;210;1167;-957
59;11;2;Vila Assunção;3536;3153;383;109;506;-397
59;11;2;Vila Conceição;769;598;171;32;115;-83
59;11;2;Vila Ipiranga;18640;16336;2304;560;1775;-1215
59;11;2;Vila Jardim;12701;11142;1559;580;1715;-1135
59;11;2;Vila João Pessoa;12288;10915;1373;585;1693;-1108
59;11;2;Vila Nova;34646;30755;3891;-704;1244;-1948
59;11;2;Vila São José;27949;24576;3373;-239;1686;-1925
60;12;2;Aberta dos Morros;6533;5562;971;-110;-535;425
60;12;2;Agronomia;1365;1146;219;-52;-156;104
60;12;2;Anchieta;1122;950;172;-54;-135;81
60;12;2;Arquipélago;8052;6722;1330;-168;-579;411
60;12;2;Auxiliadora;8389;7028;1361;-182;-883;701
60;12;2;Azenha;12881;10887;1994;-82;-950;868
60;12;2;Bela Vista;10436;8757;1679;-322;-1026;704
60;12;2;Belém Novo;10234;8957;1277;109;-340;449
60;12;2;Belém Velho;10611;8924;1687;-116;-651;535
60;12;2;Boa Vista;8740;7365;1375;-216;-874;658
60;12;2;Boa Vista do Sul;1574;1461;113;-167;-174;7
60;12;2;Bom Fim;10169;8586;1583;-146;-950;804
60;12;2;Bom Jesus;31149;25626;5523;647;-937;1584
60;12;2;Camaquã;18308;15497;2811;157;-661;818
60;12;2;Campo Novo;7979;6881;1098;-202;-603;401
60;12;2;Cascata;12643;10647;1996;-187;-767;580
60;12;2;Cavalhada;31815;26771;5044;721;-625;1346
60;12;2;Centro;44092;36637;7455;1532;-655;2187
60;12;2;Chácara das Pedras;5060;4258;802;-169;-597;428
60;12;2;Chapéu do Sol;1919;1770;149;-157;-176;19
60;12;2;Cidade Baixa;14704;12550;2154;-250;-864;614
60;12;2;Coronel Aparício Borges;19368;16175;3193;-20;-929;909
60;12;2;Costa e Silva;15118;12833;2285;-315;-962;647
60;12;2;Cristal;34825;29378;5447;620;-783;1403
60;12;2;Cristo Redentor;15888;13584;2304;-297;-841;544
60;12;2;Espírito Santo;4398;3855;543;-297;-490;193
60;12;2;Extrema;1323;1231;92;-167;-167;0
60;12;2;Farrapos;20421;17146;3275;372;-607;979
60;12;2;Farroupilha;217;166;51;-48;-99;51
60;12;2;Floresta;10484;8918;1566;-292;-813;521
60;12;2;Glória;16621;14105;2516;-203;-906;703
60;12;2;Guarujá;3728;3267;461;-247;-418;171
60;12;2;Higienópolis;9360;7885;1475;-378;-970;592
60;12;2;Hípica;19454;16705;2749;179;-529;708
60;12;2;Humaitá;11241;9570;1671;-181;-667;486
60;12;2;Independência;6522;5457;1065;-325;-665;340
60;12;2;Ipanema;13425;11579;1846;-139;-665;526
60;12;2;Jardim Botânico;11014;9328;1686;-374;-1017;643
60;12;2;Jardim Carvalho;26851;22468;4383;258;-859;1117
60;12;2;Jardim do Salso;2780;2216;564;5;-357;362
60;12;2;Jardim Dona Leopoldina;17208;14613;2595;-257;-989;732
60;12;2;Jardim Europa;961;719;242;-223;-145;-78
60;12;2;Jardim Floresta;1911;1564;347;-35;-282;247
60;12;2;Jardim Isabel;1636;1374;262;-158;-312;154
60;12;2;Jardim Itu;17323;14618;2705;-417;-1073;656
60;12;2;Jardim Lindóia;5959;5036;923;-355;-610;255
60;12;2;Jardim Sabará;12344;10463;1881;-567;-1059;492
60;12;2;Jardim São Pedro;2539;2037;502;-3;-321;318
60;12;2;Lageado;3425;3089;336;-271;-389;118
60;12;2;Lami;3530;3207;323;-235;-337;102
60;12;2;Lomba do Pinheiro;65229;55686;9543;1872;-806;2678
60;12;2;Mário Quintana;41808;35221;6587;1022;-955;1977
60;12;2;Medianeira;9785;8280;1505;-324;-909;585
60;12;2;Menino Deus;34047;28586;5461;535;-804;1339
60;12;2;Moinhos de Vento;10642;8984;1658;-338;-870;532
60;12;2;MontSerrat;9755;8212;1543;-350;-922;572
60;12;2;Morro Santana;19776;16620;3156;-40;-812;772
60;12;2;Navegantes;3152;2504;648;-276;-429;153
60;12;2;Nonoai;26428;22193;4235;308;-858;1166
60;12;2;Parque Santa Fé;4635;3878;757;-165;-571;406
60;12;2;Partenon;53684;44650;9034;1389;-1080;2469
60;12;2;Passo DAreia;22551;18849;3702;-22;-963;941
60;12;2;Passo das Pedras;15057;12805;2252;-458;-934;476
60;12;2;Pedra Redonda;62;26;36;-3;-39;36
60;12;2;Petrópolis;40913;33955;6958;754;-1056;1810
60;12;2;Pitinga;3360;2978;382;-225;-349;124
60;12;2;Ponta Grossa;8087;7152;935;-155;-511;356
60;12;2;Praia de Belas;1104;764;340;-231;-196;-35
60;12;2;Restinga;58391;51044;7347;1071;-891;1962
60;12;2;Rio Branco;16627;14071;2556;-389;-1025;636
60;12;2;Rubem Berta;35382;30033;5349;349;-927;1276
60;12;2;Santa Cecília;4022;3193;829;-154;-606;452
60;12;2;Santa Maria Goretti;2151;1633;518;-40;-366;326
60;12;2;Santa Rosa de Lima;38517;32739;5778;700;-808;1508
60;12;2;Santa Tereza;43449;36410;7039;945;-1012;1957
60;12;2;Santana;20324;17253;3071;-483;-1063;580
60;12;2;Santo Antônio;11913;10042;1871;-436;-960;524
60;12;2;São Caetano;558;251;307;53;-92;145
60;12;2;São Geraldo;7477;6251;1226;-267;-753;486
60;12;2;São João;11373;9606;1767;-599;-795;196
60;12;2;São Sebastião;5588;4511;1077;-279;-702;423
60;12;2;Sarandi;67112;56732;10380;1734;-875;2609
60;12;2;Serraria;5371;4607;764;-219;-532;313
60;12;2;Sétimo Céu;576;373;203;18;-127;145
60;12;2;Teresópolis;13646;11592;2054;-464;-964;500
60;12;2;Três Figueiras;2613;1902;711;-272;-389;117
60;12;2;Tristeza;16563;14268;2295;-222;-759;537
60;12;2;Vila Assunção;3428;2674;754;-108;-479;371
60;12;2;Vila Conceição;814;431;383;45;-167;212
60;12;2;Vila Ipiranga;18296;15367;2929;-344;-969;625
60;12;2;Vila Jardim;12182;10151;2031;-519;-991;472
60;12;2;Vila João Pessoa;11748;9913;1835;-540;-1002;462
60;12;2;Vila Nova;35209;29856;5353;563;-899;1462
60;12;2;Vila São José;28297;23600;4697;348;-976;1324
61;13;2;Aberta dos Morros;6486;5534;952;-47;-28;-19
61;13;2;Agronomia;1307;1132;175;-58;-14;-44
61;13;2;Anchieta;1083;934;149;-39;-16;-23
61;13;2;Arquipélago;8050;6704;1346;-2;-18;16
61;13;2;Auxiliadora;8287;7025;1262;-102;-3;-99
61;13;2;Azenha;12696;10822;1874;-185;-65;-120
61;13;2;Bela Vista;10261;8710;1551;-175;-47;-128
61;13;2;Belém Novo;10243;8950;1293;9;-7;16
61;13;2;Belém Velho;10577;8865;1712;-34;-59;25
61;13;2;Boa Vista;8585;7325;1260;-155;-40;-115
61;13;2;Boa Vista do Sul;1571;1450;121;-3;-11;8
61;13;2;Bom Fim;9978;8531;1447;-191;-55;-136
61;13;2;Bom Jesus;31278;25513;5765;129;-113;242
61;13;2;Camaquã;18292;15416;2876;-16;-81;65
61;13;2;Campo Novo;7918;6813;1105;-61;-68;7
61;13;2;Cascata;12598;10551;2047;-45;-96;51
61;13;2;Cavalhada;32053;26671;5382;238;-100;338
61;13;2;Centro;44459;36594;7865;367;-43;410
61;13;2;Chácara das Pedras;4893;4198;695;-167;-60;-107
61;13;2;Chapéu do Sol;1867;1736;131;-52;-34;-18
61;13;2;Cidade Baixa;14671;12429;2242;-33;-121;88
61;13;2;Coronel Aparício Borges;19300;16002;3298;-68;-173;105
61;13;2;Costa e Silva;15054;12724;2330;-64;-109;45
61;13;2;Cristal;35020;29268;5752;195;-110;305
61;13;2;Cristo Redentor;15924;13596;2328;36;12;24
61;13;2;Espírito Santo;4351;3805;546;-47;-50;3
61;13;2;Extrema;1321;1228;93;-2;-3;1
61;13;2;Farrapos;20501;17107;3394;80;-39;119
61;13;2;Farroupilha;147;147;0;-70;-19;-51
61;13;2;Floresta;10430;8837;1593;-54;-81;27
61;13;2;Glória;16605;13967;2638;-16;-138;122
61;13;2;Guarujá;3693;3232;461;-35;-35;0
61;13;2;Higienópolis;9283;7826;1457;-77;-59;-18
61;13;2;Hípica;19554;16682;2872;100;-23;123
61;13;2;Humaitá;11321;9556;1765;80;-14;94
61;13;2;Independência;6435;5387;1048;-87;-70;-17
61;13;2;Ipanema;13475;11554;1921;50;-25;75
61;13;2;Jardim Botânico;10830;9197;1633;-184;-131;-53
61;13;2;Jardim Carvalho;27030;22342;4688;179;-126;305
61;13;2;Jardim do Salso;2598;2165;433;-182;-51;-131
61;13;2;Jardim Dona Leopoldina;17095;14436;2659;-113;-177;64
61;13;2;Jardim Europa;973;728;245;12;9;3
61;13;2;Jardim Floresta;1799;1560;239;-112;-4;-108
61;13;2;Jardim Isabel;1607;1329;278;-29;-45;16
61;13;2;Jardim Itu;17335;14484;2851;12;-134;146
61;13;2;Jardim Lindóia;5905;5011;894;-54;-25;-29
61;13;2;Jardim Sabará;12343;10368;1975;-1;-95;94
61;13;2;Jardim São Pedro;2380;2002;378;-159;-35;-124
61;13;2;Lageado;3412;3077;335;-13;-12;-1
61;13;2;Lami;3519;3207;312;-11;0;-11
61;13;2;Lomba do Pinheiro;65473;55659;9814;244;-27;271
61;13;2;Mário Quintana;41881;35069;6812;73;-152;225
61;13;2;Medianeira;9669;8118;1551;-116;-162;46
61;13;2;Menino Deus;34368;28451;5917;321;-135;456
61;13;2;Moinhos de Vento;10572;8904;1668;-70;-80;10
61;13;2;MontSerrat;9728;8107;1621;-27;-105;78
61;13;2;Morro Santana;19801;16471;3330;25;-149;174
61;13;2;Navegantes;3098;2472;626;-54;-32;-22
61;13;2;Nonoai;26511;22011;4500;83;-182;265
61;13;2;Parque Santa Fé;4466;3744;722;-169;-134;-35
61;13;2;Partenon;54226;44528;9698;542;-122;664
61;13;2;Passo DAreia;22749;18777;3972;198;-72;270
61;13;2;Passo das Pedras;15034;12631;2403;-23;-174;151
61;13;2;Pedra Redonda;29;24;5;-33;-2;-31
61;13;2;Petrópolis;41199;33792;7407;286;-163;449
61;13;2;Pitinga;3334;2953;381;-26;-25;-1
61;13;2;Ponta Grossa;8070;7146;924;-17;-6;-11
61;13;2;Praia de Belas;1033;732;301;-71;-32;-39
61;13;2;Restinga;58588;50997;7591;197;-47;244
61;13;2;Rio Branco;16780;13973;2807;153;-98;251
61;13;2;Rubem Berta;35554;29912;5642;172;-121;293
61;13;2;Santa Cecília;3798;3077;721;-224;-116;-108
61;13;2;Santa Maria Goretti;2002;1592;410;-149;-41;-108
61;13;2;Santa Rosa de Lima;38678;32643;6035;161;-96;257
61;13;2;Santa Tereza;43673;36309;7364;224;-101;325
61;13;2;Santana;20436;17082;3354;112;-171;283
61;13;2;Santo Antônio;11853;9856;1997;-60;-186;126
61;13;2;São Caetano;539;248;291;-19;-3;-16
61;13;2;São Geraldo;7459;6166;1293;-18;-85;67
61;13;2;São João;11375;9576;1799;2;-30;32
61;13;2;São Sebastião;5511;4489;1022;-77;-22;-55
61;13;2;Sarandi;67466;56643;10823;354;-89;443
61;13;2;Serraria;5371;4587;784;0;-20;20
61;13;2;Sétimo Céu;523;384;139;-53;11;-64
61;13;2;Teresópolis;13639;11426;2213;-7;-166;159
61;13;2;Três Figueiras;2348;1807;541;-265;-95;-170
61;13;2;Tristeza;16618;14254;2364;55;-14;69
61;13;2;Vila Assunção;3293;2615;678;-135;-59;-76
61;13;2;Vila Conceição;779;436;343;-35;5;-40
61;13;2;Vila Ipiranga;18322;15249;3073;26;-118;144
61;13;2;Vila Jardim;12122;10019;2103;-60;-132;72
61;13;2;Vila João Pessoa;11658;9728;1930;-90;-185;95
61;13;2;Vila Nova;35141;29751;5390;-68;-105;37
61;13;2;Vila São José;28191;23401;4790;-106;-199;93
62;14;2;Aberta dos Morros;6589;5583;1006;103;49;54
62;14;2;Agronomia;1477;1235;242;170;103;67
62;14;2;Anchieta;1237;1035;202;154;101;53
62;14;2;Arquipélago;8017;6755;1262;-33;51;-84
62;14;2;Auxiliadora;8459;7100;1359;172;75;97
62;14;2;Azenha;12773;10960;1813;77;138;-61
62;14;2;Bela Vista;10493;8829;1664;232;119;113
62;14;2;Belém Novo;10315;9032;1283;72;82;-10
62;14;2;Belém Velho;10604;8955;1649;27;90;-63
62;14;2;Boa Vista;8831;7431;1400;246;106;140
62;14;2;Boa Vista do Sul;1754;1555;199;183;105;78
62;14;2;Bom Fim;10345;8723;1622;367;192;175
62;14;2;Bom Jesus;30923;25641;5282;-355;128;-483
62;14;2;Camaquã;18178;15507;2671;-114;91;-205
62;14;2;Campo Novo;8092;6900;1192;174;87;87
62;14;2;Cascata;12623;10677;1946;25;126;-101
62;14;2;Cavalhada;31595;26850;4745;-458;179;-637
62;14;2;Centro;43996;36682;7314;-463;88;-551
62;14;2;Chácara das Pedras;5133;4319;814;240;121;119
62;14;2;Chapéu do Sol;2104;1860;244;237;124;113
62;14;2;Cidade Baixa;14843;12577;2266;172;148;24
62;14;2;Coronel Aparício Borges;19120;16152;2968;-180;150;-330
62;14;2;Costa e Silva;15078;12857;2221;24;133;-109
62;14;2;Cristal;34638;29263;5375;-382;-5;-377
62;14;2;Cristo Redentor;16320;13833;2487;396;237;159
62;14;2;Espírito Santo;4549;3897;652;198;92;106
62;14;2;Extrema;1503;1378;125;182;150;32
62;14;2;Farrapos;20113;17102;3011;-388;-5;-383
62;14;2;Farroupilha;159;159;0;12;12;0
62;14;2;Floresta;10654;9016;1638;224;179;45
62;14;2;Glória;16619;14029;2590;14;62;-48
62;14;2;Guarujá;3881;3324;557;188;92;96
62;14;2;Higienópolis;9519;7978;1541;236;152;84
62;14;2;Hípica;19039;16670;2369;-515;-12;-503
62;14;2;Humaitá;11205;9628;1577;-116;72;-188
62;14;2;Independência;6778;5644;1134;343;257;86
62;14;2;Ipanema;13514;11680;1834;39;126;-87
62;14;2;Jardim Botânico;11094;9408;1686;264;211;53
62;14;2;Jardim Carvalho;26509;22367;4142;-521;25;-546
62;14;2;Jardim do Salso;2788;2310;478;190;145;45
62;14;2;Jardim Dona Leopoldina;17184;14642;2542;89;206;-117
62;14;2;Jardim Europa;1003;824;179;30;96;-66
62;14;2;Jardim Floresta;2002;1718;284;203;158;45
62;14;2;Jardim Isabel;1838;1511;327;231;182;49
62;14;2;Jardim Itu;17280;14648;2632;-55;164;-219
62;14;2;Jardim Lindóia;6167;5232;935;262;221;41
62;14;2;Jardim Sabará;12456;10489;1967;113;121;-8
62;14;2;Jardim São Pedro;2570;2167;403;190;165;25
62;14;2;Lageado;3644;3251;393;232;174;58
62;14;2;Lami;3752;3386;366;233;179;54
62;14;2;Lomba do Pinheiro;64860;55638;9222;-613;-21;-592
62;14;2;Mário Quintana;41407;35064;6343;-474;-5;-469
62;14;2;Medianeira;9823;8260;1563;154;142;12
62;14;2;Menino Deus;33830;28429;5401;-538;-22;-516
62;14;2;Moinhos de Vento;10863;9127;1736;291;223;68
62;14;2;MontSerrat;9872;8285;1587;144;178;-34
62;14;2;Morro Santana;19460;16580;2880;-341;109;-450
62;14;2;Navegantes;3340;2665;675;242;193;49
62;14;2;Nonoai;25934;22008;3926;-577;-3;-574
62;14;2;Parque Santa Fé;4692;3926;766;226;182;44
62;14;2;Partenon;53414;44497;8917;-812;-31;-781
62;14;2;Passo DAreia;22414;18961;3453;-335;184;-519
62;14;2;Passo das Pedras;15013;12785;2228;-21;154;-175
62;14;2;Pedra Redonda;22;22;0;-7;-2;-5
62;14;2;Petrópolis;40634;33840;6794;-565;48;-613
62;14;2;Pitinga;3551;3093;458;217;140;77
62;14;2;Ponta Grossa;8278;7306;972;208;160;48
62;14;2;Praia de Belas;1117;921;196;84;189;-105
62;14;2;Restinga;58331;50904;7427;-257;-93;-164
62;14;2;Rio Branco;16873;14153;2720;93;180;-87
62;14;2;Rubem Berta;35197;29906;5291;-357;-6;-351
62;14;2;Santa Cecília;3972;3233;739;174;156;18
62;14;2;Santa Maria Goretti;2211;1801;410;209;209;0
62;14;2;Santa Rosa de Lima;38219;32622;5597;-459;-21;-438
62;14;2;Santa Tereza;43105;36272;6833;-568;-37;-531
62;14;2;Santana;20415;17214;3201;-21;132;-153
62;14;2;Santo Antônio;12013;9985;2028;160;129;31
62;14;2;São Caetano;480;298;182;-59;50;-109
62;14;2;São Geraldo;7655;6349;1306;196;183;13
62;14;2;São João;11670;9815;1855;295;239;56
62;14;2;São Sebastião;5733;4775;958;222;286;-64
62;14;2;Sarandi;67042;56820;10222;-424;177;-601
62;14;2;Serraria;5541;4792;749;170;205;-35
62;14;2;Sétimo Céu;529;421;108;6;37;-31
62;14;2;Teresópolis;13731;11532;2199;92;106;-14
62;14;2;Três Figueiras;2563;2064;499;215;257;-42
62;14;2;Tristeza;16522;14330;2192;-96;76;-172
62;14;2;Vila Assunção;3492;2772;720;199;157;42
62;14;2;Vila Conceição;768;532;236;-11;96;-107
62;14;2;Vila Ipiranga;18318;15453;2865;-4;204;-208
62;14;2;Vila Jardim;12312;10197;2115;190;178;12
62;14;2;Vila João Pessoa;11761;9850;1911;103;122;-19
62;14;2;Vila Nova;34953;29945;5008;-188;194;-382
62;14;2;Vila São José;28064;23537;4527;-127;136;-263
63;15;2;Aberta dos Morros;6540;5557;983;-49;-26;-23
63;15;2;Agronomia;1404;1225;179;-73;-10;-63
63;15;2;Anchieta;1159;1040;119;-78;5;-83
63;15;2;Arquipélago;8087;6757;1330;70;2;68
63;15;2;Auxiliadora;8323;7180;1143;-136;80;-216
63;15;2;Azenha;12312;10958;1354;-461;-2;-459
63;15;2;Bela Vista;10360;8898;1462;-133;69;-202
63;15;2;Belém Novo;10320;9017;1303;5;-15;20
63;15;2;Belém Velho;10633;8957;1676;29;2;27
63;15;2;Boa Vista;8677;7465;1212;-154;34;-188
63;15;2;Boa Vista do Sul;1730;1544;186;-24;-11;-13
63;15;2;Bom Fim;10204;8797;1407;-141;74;-215
63;15;2;Bom Jesus;31151;25654;5497;228;13;215
63;15;2;Camaquã;18182;15591;2591;4;84;-80
63;15;2;Campo Novo;8077;6888;1189;-15;-12;-3
63;15;2;Cascata;12627;10661;1966;4;-16;20
63;15;2;Cavalhada;31600;26814;4786;5;-36;41
63;15;2;Centro;44203;36800;7403;207;118;89
63;15;2;Chácara das Pedras;4958;4347;611;-175;28;-203
63;15;2;Chapéu do Sol;2067;1851;216;-37;-9;-28
63;15;2;Cidade Baixa;14893;12621;2272;50;44;6
63;15;2;Coronel Aparício Borges;19117;16100;3017;-3;-52;49
63;15;2;Costa e Silva;15055;12869;2186;-23;12;-35
63;15;2;Cristal;34819;29184;5635;181;-79;260
63;15;2;Cristo Redentor;16038;13899;2139;-282;66;-348
63;15;2;Espírito Santo;4530;3886;644;-19;-11;-8
63;15;2;Extrema;1492;1370;122;-11;-8;-3
63;15;2;Farrapos;20316;17112;3204;203;10;193
63;15;2;Farroupilha;167;167;0;8;8;0
63;15;2;Floresta;10729;9101;1628;75;85;-10
63;15;2;Glória;16636;13976;2660;17;-53;70
63;15;2;Guarujá;3861;3308;553;-20;-16;-4
63;15;2;Higienópolis;9508;8020;1488;-11;42;-53
63;15;2;Hípica;19119;16631;2488;80;-39;119
63;15;2;Humaitá;11282;9617;1665;77;-11;88
63;15;2;Independência;6471;5705;766;-307;61;-368
63;15;2;Ipanema;13526;11625;1901;12;-55;67
63;15;2;Jardim Botânico;10761;9410;1351;-333;2;-335
63;15;2;Jardim Carvalho;26754;22293;4461;245;-74;319
63;15;2;Jardim do Salso;2618;2294;324;-170;-16;-154
63;15;2;Jardim Dona Leopoldina;17101;14599;2502;-83;-43;-40
63;15;2;Jardim Europa;1035;848;187;32;24;8
63;15;2;Jardim Floresta;1903;1779;124;-99;61;-160
63;15;2;Jardim Isabel;1739;1495;244;-99;-16;-83
63;15;2;Jardim Itu;17298;14695;2603;18;47;-29
63;15;2;Jardim Lindóia;5882;5323;559;-285;91;-376
63;15;2;Jardim Sabará;12434;10460;1974;-22;-29;7
63;15;2;Jardim São Pedro;2475;2224;251;-95;57;-152
63;15;2;Lageado;3636;3219;417;-8;-32;24
63;15;2;Lami;3731;3362;369;-21;-24;3
63;15;2;Lomba do Pinheiro;65263;55625;9638;403;-13;416
63;15;2;Mário Quintana;41658;34992;6666;251;-72;323
63;15;2;Medianeira;9730;8221;1509;-93;-39;-54
63;15;2;Menino Deus;34028;28404;5624;198;-25;223
63;15;2;Moinhos de Vento;10627;9168;1459;-236;41;-277
63;15;2;MontSerrat;9876;8320;1556;4;35;-31
63;15;2;Morro Santana;19551;16501;3050;91;-79;170
63;15;2;Navegantes;3100;2672;428;-240;7;-247
63;15;2;Nonoai;25986;21908;4078;52;-100;152
63;15;2;Parque Santa Fé;4539;3907;632;-153;-19;-134
63;15;2;Partenon;53699;44402;9297;285;-95;380
63;15;2;Passo DAreia;22666;19021;3645;252;60;192
63;15;2;Passo das Pedras;15050;12734;2316;37;-51;88
63;15;2;Pedra Redonda;18;18;0;-4;-4;0
63;15;2;Petrópolis;41084;33818;7266;450;-22;472
63;15;2;Pitinga;3566;3091;475;15;-2;17
63;15;2;Ponta Grossa;8276;7267;1009;-2;-39;37
63;15;2;Praia de Belas;1073;904;169;-44;-17;-27
63;15;2;Restinga;58322;50871;7451;-9;-33;24
63;15;2;Rio Branco;17124;14224;2900;251;71;180
63;15;2;Rubem Berta;35424;29854;5570;227;-52;279
63;15;2;Santa Cecília;3790;3227;563;-182;-6;-176
63;15;2;Santa Maria Goretti;2097;1789;308;-114;-12;-102
63;15;2;Santa Rosa de Lima;38350;32609;5741;131;-13;144
63;15;2;Santa Tereza;43358;36140;7218;253;-132;385
63;15;2;Santana;20707;17254;3453;292;40;252
63;15;2;Santo Antônio;12001;9972;2029;-12;-13;1
63;15;2;São Caetano;474;280;194;-6;-18;12
63;15;2;São Geraldo;7710;6388;1322;55;39;16
63;15;2;São João;11658;9837;1821;-12;22;-34
63;15;2;São Sebastião;5498;4816;682;-235;41;-276
63;15;2;Sarandi;67253;56828;10425;211;8;203
63;15;2;Serraria;5543;4740;803;2;-52;54
63;15;2;Sétimo Céu;482;403;79;-47;-18;-29
63;15;2;Teresópolis;13830;11466;2364;99;-66;165
63;15;2;Três Figueiras;2187;2012;175;-376;-52;-324
63;15;2;Tristeza;16590;14314;2276;68;-16;84
63;15;2;Vila Assunção;3447;2724;723;-45;-48;3
63;15;2;Vila Conceição;704;470;234;-64;-62;-2
63;15;2;Vila Ipiranga;18431;15443;2988;113;-10;123
63;15;2;Vila Jardim;12278;10126;2152;-34;-71;37
63;15;2;Vila João Pessoa;11759;9781;1978;-2;-69;67
63;15;2;Vila Nova;35033;29843;5190;80;-102;182
63;15;2;Vila São José;27971;23398;4573;-93;-139;46
64;16;2;Aberta dos Morros;6525;5675;850;-15;118;-133
64;16;2;Agronomia;1458;1348;110;54;123;-69
64;16;2;Anchieta;1219;1163;56;60;123;-63
64;16;2;Arquipélago;8159;6983;1176;72;226;-154
64;16;2;Auxiliadora;8385;7517;868;62;337;-275
64;16;2;Azenha;12377;11286;1091;65;328;-263
64;16;2;Bela Vista;10432;9256;1176;72;358;-286
64;16;2;Belém Novo;10327;9081;1246;7;64;-57
64;16;2;Belém Velho;10676;9143;1533;43;186;-143
64;16;2;Boa Vista;8756;7756;1000;79;291;-212
64;16;2;Boa Vista do Sul;1723;1589;134;-7;45;-52
64;16;2;Bom Fim;10229;9145;1084;25;348;-323
64;16;2;Bom Jesus;30656;25996;4660;-495;342;-837
64;16;2;Camaquã;18158;15774;2384;-24;183;-207
64;16;2;Campo Novo;8185;7116;1069;108;228;-120
64;16;2;Cascata;12763;10969;1794;136;308;-172
64;16;2;Cavalhada;31208;27073;4135;-392;259;-651
64;16;2;Centro;43755;37097;6658;-448;297;-745
64;16;2;Chácara das Pedras;5131;4684;447;173;337;-164
64;16;2;Chapéu do Sol;2064;1948;116;-3;97;-100
64;16;2;Cidade Baixa;14981;12983;1998;88;362;-274
64;16;2;Coronel Aparício Borges;19256;16519;2737;139;419;-280
64;16;2;Costa e Silva;15209;13199;2010;154;330;-176
64;16;2;Cristal;34398;29338;5060;-421;154;-575
64;16;2;Cristo Redentor;15996;14191;1805;-42;292;-334
64;16;2;Espírito Santo;4569;4045;524;39;159;-120
64;16;2;Extrema;1510;1398;112;18;28;-10
64;16;2;Farrapos;20139;17240;2899;-177;128;-305
64;16;2;Farroupilha;136;136;0;-31;-31;0
64;16;2;Floresta;10812;9410;1402;83;309;-226
64;16;2;Glória;16786;14358;2428;150;382;-232
64;16;2;Guarujá;3904;3442;462;43;134;-91
64;16;2;Higienópolis;9617;8378;1239;109;358;-249
64;16;2;Hípica;19248;16742;2506;129;111;18
64;16;2;Humaitá;11419;9806;1613;137;189;-52
64;16;2;Independência;6526;6075;451;55;370;-315
64;16;2;Ipanema;13562;11681;1881;36;56;-20
64;16;2;Jardim Botânico;10928;9816;1112;167;406;-239
64;16;2;Jardim Carvalho;26448;22539;3909;-306;246;-552
64;16;2;Jardim do Salso;2807;2545;262;189;251;-62
64;16;2;Jardim Dona Leopoldina;17247;14991;2256;146;392;-246
64;16;2;Jardim Europa;1073;943;130;38;95;-57
64;16;2;Jardim Floresta;1987;1946;41;84;167;-83
64;16;2;Jardim Isabel;1793;1630;163;54;135;-81
64;16;2;Jardim Itu;17322;14967;2355;24;272;-248
64;16;2;Jardim Lindóia;5929;5555;374;47;232;-185
64;16;2;Jardim Sabará;12576;10807;1769;142;347;-205
64;16;2;Jardim São Pedro;2611;2433;178;136;209;-73
64;16;2;Lageado;3649;3282;367;13;63;-50
64;16;2;Lami;3673;3361;312;-58;-1;-57
64;16;2;Lomba do Pinheiro;65206;55814;9392;-57;189;-246
64;16;2;Mário Quintana;41307;35272;6035;-351;280;-631
64;16;2;Medianeira;9932;8552;1380;202;331;-129
64;16;2;Menino Deus;33918;28864;5054;-110;460;-570
64;16;2;Moinhos de Vento;10736;9540;1196;109;372;-263
64;16;2;MontSerrat;10029;8674;1355;153;354;-201
64;16;2;Morro Santana;19572;16741;2831;21;240;-219
64;16;2;Navegantes;3140;2842;298;40;170;-130
64;16;2;Nonoai;25819;22241;3578;-167;333;-500
64;16;2;Parque Santa Fé;4794;4258;536;255;351;-96
64;16;2;Partenon;53021;44565;8456;-678;163;-841
64;16;2;Passo DAreia;22562;19290;3272;-104;269;-373
64;16;2;Passo das Pedras;15196;13053;2143;146;319;-173
64;16;2;Pedra Redonda;36;1;35;18;-17;35
64;16;2;Petrópolis;40461;34102;6359;-623;284;-907
64;16;2;Pitinga;3591;3208;383;25;117;-92
64;16;2;Ponta Grossa;8292;7260;1032;16;-7;23
64;16;2;Praia de Belas;1105;1046;59;32;142;-110
64;16;2;Restinga;58353;51083;7270;31;212;-181
64;16;2;Rio Branco;17333;14682;2651;209;458;-249
64;16;2;Rubem Berta;34751;30045;4706;-673;191;-864
64;16;2;Santa Cecília;4004;3571;433;214;344;-130
64;16;2;Santa Maria Goretti;2239;1993;246;142;204;-62
64;16;2;Santa Rosa de Lima;37961;32692;5269;-389;83;-472
64;16;2;Santa Tereza;43038;36301;6737;-320;161;-481
64;16;2;Santana;20875;17659;3216;168;405;-237
64;16;2;Santo Antônio;12253;10302;1951;252;330;-78
64;16;2;São Caetano;559;285;274;85;5;80
64;16;2;São Geraldo;7876;6651;1225;166;263;-97
64;16;2;São João;11617;10095;1522;-41;258;-299
64;16;2;São Sebastião;5477;5018;459;-21;202;-223
64;16;2;Sarandi;66907;57054;9853;-346;226;-572
64;16;2;Serraria;5567;4756;811;24;16;8
64;16;2;Sétimo Céu;510;399;111;28;-4;32
64;16;2;Teresópolis;13940;11859;2081;110;393;-283
64;16;2;Três Figueiras;2506;2307;199;319;295;24
64;16;2;Tristeza;16722;14422;2300;132;108;24
64;16;2;Vila Assunção;3596;2912;684;149;188;-39
64;16;2;Vila Conceição;741;472;269;37;2;35
64;16;2;Vila Ipiranga;18641;15744;2897;210;301;-91
64;16;2;Vila Jardim;12518;10425;2093;240;299;-59
64;16;2;Vila João Pessoa;11922;10103;1819;163;322;-159
64;16;2;Vila Nova;34658;29779;4879;-375;-64;-311
64;16;2;Vila São José;27773;23564;4209;-198;166;-364
65;17;2;Aberta dos Morros;6783;6447;336;258;772;-514
65;17;2;Agronomia;1740;1729;11;282;381;-99
65;17;2;Anchieta;1489;1489;0;270;326;-56
65;17;2;Arquipélago;8283;7782;501;124;799;-675
65;17;2;Auxiliadora;8901;8668;233;516;1151;-635
65;17;2;Azenha;12980;12662;318;603;1376;-773
65;17;2;Bela Vista;10989;10601;388;557;1345;-788
65;17;2;Belém Novo;10184;9577;607;-143;496;-639
65;17;2;Belém Velho;10858;10092;766;182;949;-767
65;17;2;Boa Vista;9296;8957;339;540;1201;-661
65;17;2;Boa Vista do Sul;1932;1878;54;209;289;-80
65;17;2;Bom Fim;10872;10489;383;643;1344;-701
65;17;2;Bom Jesus;29790;27359;2431;-866;1363;-2229
65;17;2;Camaquã;18111;16908;1203;-47;1134;-1181
65;17;2;Campo Novo;8517;7991;526;332;875;-543
65;17;2;Cascata;13006;12081;925;243;1112;-869
65;17;2;Cavalhada;30336;28198;2138;-872;1125;-1997
65;17;2;Centro;41711;38201;3510;-2044;1104;-3148
65;17;2;Chácara das Pedras;5698;5631;67;567;947;-380
65;17;2;Chapéu do Sol;2343;2304;39;279;356;-77
65;17;2;Cidade Baixa;15203;14251;952;222;1268;-1046
65;17;2;Coronel Aparício Borges;19297;17924;1373;41;1405;-1364
65;17;2;Costa e Silva;15442;14548;894;233;1349;-1116
65;17;2;Cristal;33531;30490;3041;-867;1152;-2019
65;17;2;Cristo Redentor;16182;15441;741;186;1250;-1064
65;17;2;Espírito Santo;4938;4739;199;369;694;-325
65;17;2;Extrema;1686;1596;90;176;198;-22
65;17;2;Farrapos;19669;18159;1510;-470;919;-1389
65;17;2;Farroupilha;344;344;0;208;208;0
65;17;2;Floresta;11164;10590;574;352;1180;-828
65;17;2;Glória;17023;15735;1288;237;1377;-1140
65;17;2;Guarujá;4253;4075;178;349;633;-284
65;17;2;Higienópolis;10085;9626;459;468;1248;-780
65;17;2;Hípica;18933;17579;1354;-315;837;-1152
65;17;2;Humaitá;11570;10747;823;151;941;-790
65;17;2;Independência;7227;7082;145;701;1007;-306
65;17;2;Ipanema;13604;12630;974;42;949;-907
65;17;2;Jardim Botânico;11643;11252;391;715;1436;-721
65;17;2;Jardim Carvalho;26148;23895;2253;-300;1356;-1656
65;17;2;Jardim do Salso;3298;3279;19;491;734;-243
65;17;2;Jardim Dona Leopoldina;17485;16390;1095;238;1399;-1161
65;17;2;Jardim Europa;1409;1339;70;336;396;-60
65;17;2;Jardim Floresta;2486;2480;6;499;534;-35
65;17;2;Jardim Isabel;2149;2099;50;356;469;-113
65;17;2;Jardim Itu;17572;16377;1195;250;1410;-1160
65;17;2;Jardim Lindóia;6654;6516;138;725;961;-236
65;17;2;Jardim Sabará;13064;12162;902;488;1355;-867
65;17;2;Jardim São Pedro;3055;3024;31;444;591;-147
65;17;2;Lageado;3926;3780;146;277;498;-221
65;17;2;Lami;3894;3737;157;221;376;-155
65;17;2;Lomba do Pinheiro;62710;56867;5843;-2496;1053;-3549
65;17;2;Mário Quintana;40009;36449;3560;-1298;1177;-2475
65;17;2;Medianeira;10496;9896;600;564;1344;-780
65;17;2;Menino Deus;33164;30151;3013;-754;1287;-2041
65;17;2;Moinhos de Vento;11317;10825;492;581;1285;-704
65;17;2;MontSerrat;10600;9951;649;571;1277;-706
65;17;2;Morro Santana;19492;17962;1530;-80;1221;-1301
65;17;2;Navegantes;3761;3557;204;621;715;-94
65;17;2;Nonoai;25587;23515;2072;-232;1274;-1506
65;17;2;Parque Santa Fé;5251;5108;143;457;850;-393
65;17;2;Partenon;51314;46034;5280;-1707;1469;-3176
65;17;2;Passo DAreia;22344;20522;1822;-218;1232;-1450
65;17;2;Passo das Pedras;15620;14450;1170;424;1397;-973
65;17;2;Pedra Redonda;54;54;0;18;53;-35
65;17;2;Petrópolis;39121;35561;3560;-1340;1459;-2799
65;17;2;Pitinga;3911;3730;181;320;522;-202
65;17;2;Ponta Grossa;8441;7891;550;149;631;-482
65;17;2;Praia de Belas;1511;1448;63;406;402;4
65;17;2;Restinga;56408;52180;4228;-1945;1097;-3042
65;17;2;Rio Branco;17487;16079;1408;154;1397;-1243
65;17;2;Rubem Berta;34015;31326;2689;-736;1281;-2017
65;17;2;Santa Cecília;4606;4455;151;602;884;-282
65;17;2;Santa Maria Goretti;2645;2596;49;406;603;-197
65;17;2;Santa Rosa de Lima;36962;33796;3166;-999;1104;-2103
65;17;2;Santa Tereza;41501;37533;3968;-1537;1232;-2769
65;17;2;Santana;20945;19076;1869;70;1417;-1347
65;17;2;Santo Antônio;12708;11685;1023;455;1383;-928
65;17;2;São Caetano;625;404;221;66;119;-53
65;17;2;São Geraldo;8257;7656;601;381;1005;-624
65;17;2;São João;12019;11208;811;402;1113;-711
65;17;2;São Sebastião;6177;6006;171;700;988;-288
65;17;2;Sarandi;64262;58145;6117;-2645;1091;-3736
65;17;2;Serraria;5834;5403;431;267;647;-380
65;17;2;Sétimo Céu;677;639;38;167;240;-73
65;17;2;Teresópolis;14444;13213;1231;504;1354;-850
65;17;2;Três Figueiras;2972;2945;27;466;638;-172
65;17;2;Tristeza;16610;15386;1224;-112;964;-1076
65;17;2;Vila Assunção;3754;3573;181;158;661;-503
65;17;2;Vila Conceição;853;708;145;112;236;-124
65;17;2;Vila Ipiranga;18659;17046;1613;18;1302;-1284
65;17;2;Vila Jardim;12787;11727;1060;269;1302;-1033
65;17;2;Vila João Pessoa;12385;11441;944;463;1338;-875
65;17;2;Vila Nova;33317;30842;2475;-1341;1063;-2404
65;17;2;Vila São José;26986;24749;2237;-787;1185;-1972
66;18;2;Aberta dos Morros;6841;6427;414;58;-20;78
66;18;2;Agronomia;1852;1788;64;112;59;53
66;18;2;Anchieta;1541;1522;19;52;33;19
66;18;2;Arquipélago;8261;7738;523;-22;-44;22
66;18;2;Auxiliadora;9023;8602;421;122;-66;188
66;18;2;Azenha;13249;12598;651;269;-64;333
66;18;2;Bela Vista;11084;10536;548;95;-65;160
66;18;2;Belém Novo;10226;9498;728;42;-79;121
66;18;2;Belém Velho;10788;10045;743;-70;-47;-23
66;18;2;Boa Vista;9397;8939;458;101;-18;119
66;18;2;Boa Vista do Sul;2092;1931;161;160;53;107
66;18;2;Bom Fim;10943;10397;546;71;-92;163
66;18;2;Bom Jesus;29254;27220;2034;-536;-139;-397
66;18;2;Camaquã;17955;16763;1192;-156;-145;-11
66;18;2;Campo Novo;8533;7981;552;16;-10;26
66;18;2;Cascata;12926;12056;870;-80;-25;-55
66;18;2;Cavalhada;30193;28111;2082;-143;-87;-56
66;18;2;Centro;41037;37980;3057;-674;-221;-453
66;18;2;Chácara das Pedras;5841;5576;265;143;-55;198
66;18;2;Chapéu do Sol;2449;2334;115;106;30;76
66;18;2;Cidade Baixa;15144;14173;971;-59;-78;19
66;18;2;Coronel Aparício Borges;19210;17874;1336;-87;-50;-37
66;18;2;Costa e Silva;15393;14484;909;-49;-64;15
66;18;2;Cristal;32826;30271;2555;-705;-219;-486
66;18;2;Cristo Redentor;16304;15419;885;122;-22;144
66;18;2;Espírito Santo;5069;4760;309;131;21;110
66;18;2;Extrema;1803;1691;112;117;95;22
66;18;2;Farrapos;19449;17995;1454;-220;-164;-56
66;18;2;Farroupilha;315;315;0;-29;-29;0
66;18;2;Floresta;11204;10539;665;40;-51;91
66;18;2;Glória;16898;15705;1193;-125;-30;-95
66;18;2;Guarujá;4383;4086;297;130;11;119
66;18;2;Higienópolis;10139;9579;560;54;-47;101
66;18;2;Hípica;18882;17468;1414;-51;-111;60
66;18;2;Humaitá;11494;10667;827;-76;-80;4
66;18;2;Independência;7435;7059;376;208;-23;231
66;18;2;Ipanema;13672;12652;1020;68;22;46
66;18;2;Jardim Botânico;11920;11304;616;277;52;225
66;18;2;Jardim Carvalho;25845;23805;2040;-303;-90;-213
66;18;2;Jardim do Salso;3476;3342;134;178;63;115
66;18;2;Jardim Dona Leopoldina;17450;16375;1075;-35;-15;-20
66;18;2;Jardim Europa;1377;1376;1;-32;37;-69
66;18;2;Jardim Floresta;2579;2507;72;93;27;66
66;18;2;Jardim Isabel;2263;2151;112;114;52;62
66;18;2;Jardim Itu;17539;16363;1176;-33;-14;-19
66;18;2;Jardim Lindóia;6879;6544;335;225;28;197
66;18;2;Jardim Sabará;13010;12157;853;-54;-5;-49
66;18;2;Jardim São Pedro;3188;3046;142;133;22;111
66;18;2;Lageado;4160;3856;304;234;76;158
66;18;2;Lami;4118;3854;264;224;117;107
66;18;2;Lomba do Pinheiro;62181;56795;5386;-529;-72;-457
66;18;2;Mário Quintana;39181;36134;3047;-828;-315;-513
66;18;2;Medianeira;10502;9827;675;6;-69;75
66;18;2;Menino Deus;32626;29951;2675;-538;-200;-338
66;18;2;Moinhos de Vento;11465;10824;641;148;-1;149
66;18;2;MontSerrat;10563;9879;684;-37;-72;35
66;18;2;Morro Santana;19492;17997;1495;0;35;-35
66;18;2;Navegantes;3782;3610;172;21;53;-32
66;18;2;Nonoai;25343;23370;1973;-244;-145;-99
66;18;2;Parque Santa Fé;5426;5139;287;175;31;144
66;18;2;Partenon;50111;45622;4489;-1203;-412;-791
66;18;2;Passo DAreia;22209;20423;1786;-135;-99;-36
66;18;2;Passo das Pedras;15566;14420;1146;-54;-30;-24
66;18;2;Pedra Redonda;77;32;45;23;-22;45
66;18;2;Petrópolis;38786;35458;3328;-335;-103;-232
66;18;2;Pitinga;4097;3819;278;186;89;97
66;18;2;Ponta Grossa;8584;7981;603;143;90;53
66;18;2;Praia de Belas;1573;1493;80;62;45;17
66;18;2;Restinga;56229;52124;4105;-179;-56;-123
66;18;2;Rio Branco;17399;15949;1450;-88;-130;42
66;18;2;Rubem Berta;34069;31189;2880;54;-137;191
66;18;2;Santa Cecília;4792;4427;365;186;-28;214
66;18;2;Santa Maria Goretti;2871;2639;232;226;43;183
66;18;2;Santa Rosa de Lima;36592;33673;2919;-370;-123;-247
66;18;2;Santa Tereza;40789;37283;3506;-712;-250;-462
66;18;2;Santana;21030;19080;1950;85;4;81
66;18;2;Santo Antônio;12968;11749;1219;260;64;196
66;18;2;São Caetano;563;469;94;-62;65;-127
66;18;2;São Geraldo;8422;7692;730;165;36;129
66;18;2;São João;12273;11290;983;254;82;172
66;18;2;São Sebastião;6508;6114;394;331;108;223
66;18;2;Sarandi;63925;58045;5880;-337;-100;-237
66;18;2;Serraria;5978;5539;439;144;136;8
66;18;2;Sétimo Céu;726;659;67;49;20;29
66;18;2;Teresópolis;14619;13212;1407;175;-1;176
66;18;2;Três Figueiras;3350;3030;320;378;85;293
66;18;2;Tristeza;16711;15369;1342;101;-17;118
66;18;2;Vila Assunção;4022;3638;384;268;65;203
66;18;2;Vila Conceição;943;808;135;90;100;-10
66;18;2;Vila Ipiranga;18973;17141;1832;314;95;219
66;18;2;Vila Jardim;13115;11831;1284;328;104;224
66;18;2;Vila João Pessoa;12664;11513;1151;279;72;207
66;18;2;Vila Nova;33904;30897;3007;587;55;532
66;18;2;Vila São José;27443;24968;2475;457;219;238
67;19;2;Aberta dos Morros;6839;6439;400;-2;12;-14
67;19;2;Agronomia;1846;1804;42;-6;16;-22
67;19;2;Anchieta;1545;1540;5;4;18;-14
67;19;2;Arquipélago;8286;7770;516;25;32;-7
67;19;2;Auxiliadora;9015;8673;342;-8;71;-79
67;19;2;Azenha;13116;12649;467;-133;51;-184
67;19;2;Bela Vista;11048;10597;451;-36;61;-97
67;19;2;Belém Novo;10260;9524;736;34;26;8
67;19;2;Belém Velho;10837;10067;770;49;22;27
67;19;2;Boa Vista;9384;9002;382;-13;63;-76
67;19;2;Boa Vista do Sul;2103;1948;155;11;17;-6
67;19;2;Bom Fim;10905;10469;436;-38;72;-110
67;19;2;Bom Jesus;29407;27288;2119;153;68;85
67;19;2;Camaquã;18036;16850;1186;81;87;-6
67;19;2;Campo Novo;8561;8010;551;28;29;-1
67;19;2;Cascata;12992;12093;899;66;37;29
67;19;2;Cavalhada;30128;28130;1998;-65;19;-84
67;19;2;Centro;41093;38071;3022;56;91;-35
67;19;2;Chácara das Pedras;5772;5603;169;-69;27;-96
67;19;2;Chapéu do Sol;2436;2346;90;-13;12;-25
67;19;2;Cidade Baixa;15158;14216;942;14;43;-29
67;19;2;Coronel Aparício Borges;19206;17923;1283;-4;49;-53
67;19;2;Costa e Silva;15474;14539;935;81;55;26
67;19;2;Cristal;33062;30353;2709;236;82;154
67;19;2;Cristo Redentor;16275;15465;810;-29;46;-75
67;19;2;Espírito Santo;5065;4777;288;-4;17;-21
67;19;2;Extrema;1812;1698;114;9;7;2
67;19;2;Farrapos;19576;18073;1503;127;78;49
67;19;2;Farroupilha;386;386;0;71;71;0
67;19;2;Floresta;11190;10589;601;-14;50;-64
67;19;2;Glória;16964;15756;1208;66;51;15
67;19;2;Guarujá;4388;4101;287;5;15;-10
67;19;2;Higienópolis;10195;9659;536;56;80;-24
67;19;2;Hípica;18969;17484;1485;87;16;71
67;19;2;Humaitá;11519;10720;799;25;53;-28
67;19;2;Independência;7339;7084;255;-96;25;-121
67;19;2;Ipanema;13754;12679;1075;82;27;55
67;19;2;Jardim Botânico;11806;11329;477;-114;25;-139
67;19;2;Jardim Carvalho;26008;23881;2127;163;76;87
67;19;2;Jardim do Salso;3403;3368;35;-73;26;-99
67;19;2;Jardim Dona Leopoldina;17534;16444;1090;84;69;15
67;19;2;Jardim Europa;1447;1445;2;70;69;1
67;19;2;Jardim Floresta;2559;2559;0;-20;52;-72
67;19;2;Jardim Isabel;2227;2173;54;-36;22;-58
67;19;2;Jardim Itu;17660;16445;1215;121;82;39
67;19;2;Jardim Lindóia;6823;6584;239;-56;40;-96
67;19;2;Jardim Sabará;13122;12222;900;112;65;47
67;19;2;Jardim São Pedro;3149;3083;66;-39;37;-76
67;19;2;Lageado;4178;3883;295;18;27;-9
67;19;2;Lami;4119;3859;260;1;5;-4
67;19;2;Lomba do Pinheiro;62063;56814;5249;-118;19;-137
67;19;2;Mário Quintana;39431;36270;3161;250;136;114
67;19;2;Medianeira;10541;9891;650;39;64;-25
67;19;2;Menino Deus;32795;30064;2731;169;113;56
67;19;2;Moinhos de Vento;11492;10877;615;27;53;-26
67;19;2;MontSerrat;10578;9950;628;15;71;-56
67;19;2;Morro Santana;19648;18040;1608;156;43;113
67;19;2;Navegantes;3728;3633;95;-54;23;-77
67;19;2;Nonoai;25420;23388;2032;77;18;59
67;19;2;Parque Santa Fé;5406;5193;213;-20;54;-74
67;19;2;Partenon;50428;45781;4647;317;159;158
67;19;2;Passo DAreia;22320;20487;1833;111;64;47
67;19;2;Passo das Pedras;15589;14507;1082;23;87;-64
67;19;2;Pedra Redonda;61;55;6;-16;23;-39
67;19;2;Petrópolis;38892;35516;3376;106;58;48
67;19;2;Pitinga;4113;3822;291;16;3;13
67;19;2;Ponta Grossa;8605;7978;627;21;-3;24
67;19;2;Praia de Belas;1526;1526;0;-47;33;-80
67;19;2;Restinga;55915;52107;3808;-314;-17;-297
67;19;2;Rio Branco;17469;16040;1429;70;91;-21
67;19;2;Rubem Berta;33924;31177;2747;-145;-12;-133
67;19;2;Santa Cecília;4722;4475;247;-70;48;-118
67;19;2;Santa Maria Goretti;2811;2678;133;-60;39;-99
67;19;2;Santa Rosa de Lima;36558;33750;2808;-34;77;-111
67;19;2;Santa Tereza;40827;37358;3469;38;75;-37
67;19;2;Santana;21052;19128;1924;22;48;-26
67;19;2;Santo Antônio;12879;11747;1132;-89;-2;-87
67;19;2;São Caetano;567;470;97;4;1;3
67;19;2;São Geraldo;8385;7705;680;-37;13;-50
67;19;2;São João;12262;11335;927;-11;45;-56
67;19;2;São Sebastião;6442;6138;304;-66;24;-90
67;19;2;Sarandi;63506;58047;5459;-419;2;-421
67;19;2;Serraria;5991;5521;470;13;-18;31
67;19;2;Sétimo Céu;721;664;57;-5;5;-10
67;19;2;Teresópolis;14538;13226;1312;-81;14;-95
67;19;2;Três Figueiras;3222;3050;172;-128;20;-148
67;19;2;Tristeza;16729;15363;1366;18;-6;24
67;19;2;Vila Assunção;4026;3645;381;4;7;-3
67;19;2;Vila Conceição;947;806;141;4;-2;6
67;19;2;Vila Ipiranga;18783;17067;1716;-190;-74;-116
67;19;2;Vila Jardim;12943;11761;1182;-172;-70;-102
67;19;2;Vila João Pessoa;12668;11510;1158;4;-3;7
67;19;2;Vila Nova;33583;30841;2742;-321;-56;-265
67;19;2;Vila São José;27269;24872;2397;-174;-96;-78
68;20;2;Aberta dos Morros;7107;6898;209;268;459;-191
68;20;2;Agronomia;2540;2231;309;694;427;267
68;20;2;Anchieta;2137;1923;214;592;383;209
68;20;2;Arquipélago;8506;8248;258;220;478;-258
68;20;2;Auxiliadora;9520;9464;56;505;791;-286
68;20;2;Azenha;13517;13517;0;401;868;-467
68;20;2;Bela Vista;11577;11528;49;529;931;-402
68;20;2;Belém Novo;10279;9919;360;19;395;-376
68;20;2;Belém Velho;10957;10644;313;120;577;-457
68;20;2;Boa Vista;9882;9812;70;498;810;-312
68;20;2;Boa Vista do Sul;2421;2120;301;318;172;146
68;20;2;Bom Fim;11405;11355;50;500;886;-386
68;20;2;Bom Jesus;28585;28365;220;-822;1077;-1899
68;20;2;Camaquã;17819;17603;216;-217;753;-970
68;20;2;Campo Novo;8739;8507;232;178;497;-319
68;20;2;Cascata;13073;12791;282;81;698;-617
68;20;2;Cavalhada;29166;28986;180;-962;856;-1818
68;20;2;Centro;39167;38944;223;-1926;873;-2799
68;20;2;Chácara das Pedras;6496;6412;84;724;809;-85
68;20;2;Chapéu do Sol;2928;2686;242;492;340;152
68;20;2;Cidade Baixa;15294;15162;132;136;946;-810
68;20;2;Coronel Aparício Borges;19182;18957;225;-24;1034;-1058
68;20;2;Costa e Silva;15721;15561;160;247;1022;-775
68;20;2;Cristal;32121;31503;618;-941;1150;-2091
68;20;2;Cristo Redentor;16205;16195;10;-70;730;-800
68;20;2;Espírito Santo;5444;5271;173;379;494;-115
68;20;2;Extrema;2122;1856;266;310;158;152
68;20;2;Farrapos;19227;18807;420;-349;734;-1083
68;20;2;Farroupilha;971;805;166;585;419;166
68;20;2;Floresta;11500;11381;119;310;792;-482
68;20;2;Glória;16890;16706;184;-74;950;-1024
68;20;2;Guarujá;4802;4543;259;414;442;-28
68;20;2;Higienópolis;10577;10466;111;382;807;-425
68;20;2;Hípica;18597;18167;430;-372;683;-1055
68;20;2;Humaitá;11637;11336;301;118;616;-498
68;20;2;Independência;7962;7890;72;623;806;-183
68;20;2;Ipanema;13684;13341;343;-70;662;-732
68;20;2;Jardim Botânico;12273;12239;34;467;910;-443
68;20;2;Jardim Carvalho;25427;25018;409;-581;1137;-1718
68;20;2;Jardim do Salso;4361;4162;199;958;794;164
68;20;2;Jardim Dona Leopoldina;17808;17615;193;274;1171;-897
68;20;2;Jardim Europa;2208;2076;132;761;631;130
68;20;2;Jardim Floresta;3261;3095;166;702;536;166
68;20;2;Jardim Isabel;2802;2589;213;575;416;159
68;20;2;Jardim Itu;17626;17462;164;-34;1017;-1051
68;20;2;Jardim Lindóia;7273;7194;79;450;610;-160
68;20;2;Jardim Sabará;13340;13186;154;218;964;-746
68;20;2;Jardim São Pedro;3945;3752;193;796;669;127
68;20;2;Lageado;4544;4233;311;366;350;16
68;20;2;Lami;4347;4069;278;228;210;18
68;20;2;Lomba do Pinheiro;59006;57836;1170;-3057;1022;-4079
68;20;2;Mário Quintana;38325;37606;719;-1106;1336;-2442
68;20;2;Medianeira;11015;10887;128;474;996;-522
68;20;2;Menino Deus;31573;31230;343;-1222;1166;-2388
68;20;2;Moinhos de Vento;11762;11685;77;270;808;-538
68;20;2;MontSerrat;11080;10910;170;502;960;-458
68;20;2;Morro Santana;19405;18966;439;-243;926;-1169
68;20;2;Navegantes;4359;4163;196;631;530;101
68;20;2;Nonoai;25118;24652;466;-302;1264;-1566
68;20;2;Parque Santa Fé;6254;6075;179;848;882;-34
68;20;2;Partenon;48483;47374;1109;-1945;1593;-3538
68;20;2;Passo DAreia;21847;21529;318;-473;1042;-1515
68;20;2;Passo das Pedras;15789;15547;242;200;1040;-840
68;20;2;Pedra Redonda;353;119;234;292;64;228
68;20;2;Petrópolis;37541;36876;665;-1351;1360;-2711
68;20;2;Pitinga;4535;4192;343;422;370;52
68;20;2;Ponta Grossa;8778;8366;412;173;388;-215
68;20;2;Praia de Belas;2402;2131;271;876;605;271
68;20;2;Restinga;53615;52875;740;-2300;768;-3068
68;20;2;Rio Branco;17325;17104;221;-144;1064;-1208
68;20;2;Rubem Berta;33443;32651;792;-481;1474;-1955
68;20;2;Santa Cecília;5722;5429;293;1000;954;46
68;20;2;Santa Maria Goretti;3581;3277;304;770;599;171
68;20;2;Santa Rosa de Lima;35718;34849;869;-840;1099;-1939
68;20;2;Santa Tereza;39813;38792;1021;-1014;1434;-2448
68;20;2;Santana;20558;20246;312;-494;1118;-1612
68;20;2;Santo Antônio;13030;12729;301;151;982;-831
68;20;2;São Caetano;883;587;296;316;117;199
68;20;2;São Geraldo;8729;8410;319;344;705;-361
68;20;2;São João;12194;11984;210;-68;649;-717
68;20;2;São Sebastião;6989;6804;185;547;666;-119
68;20;2;Sarandi;60256;59108;1148;-3250;1061;-4311
68;20;2;Serraria;6284;5869;415;293;348;-55
68;20;2;Sétimo Céu;1200;999;201;479;335;144
68;20;2;Teresópolis;14631;14216;415;93;990;-897
68;20;2;Três Figueiras;4050;3780;270;828;730;98
68;20;2;Tristeza;16590;16112;478;-139;749;-888
68;20;2;Vila Assunção;4591;4135;456;565;490;75
68;20;2;Vila Conceição;1483;1117;366;536;311;225
68;20;2;Vila Ipiranga;18629;18150;479;-154;1083;-1237
68;20;2;Vila Jardim;13186;12733;453;243;972;-729
68;20;2;Vila João Pessoa;12951;12593;358;283;1083;-800
68;20;2;Vila Nova;32550;31699;851;-1033;858;-1891
68;20;2;Vila São José;26753;25905;848;-516;1033;-1549
69;21;2;Aberta dos Morros;7106;6949;157;-1;51;-52
69;21;2;Agronomia;2496;2256;240;-44;25;-69
69;21;2;Anchieta;2123;1965;158;-14;42;-56
69;21;2;Arquipélago;8438;8278;160;-68;30;-98
69;21;2;Auxiliadora;9563;9557;6;43;93;-50
69;21;2;Azenha;13640;13640;0;123;123;0
69;21;2;Bela Vista;11632;11615;17;55;87;-32
69;21;2;Belém Novo;10184;9956;228;-95;37;-132
69;21;2;Belém Velho;10889;10692;197;-68;48;-116
69;21;2;Boa Vista;9922;9911;11;40;99;-59
69;21;2;Boa Vista do Sul;2428;2150;278;7;30;-23
69;21;2;Bom Fim;11441;11434;7;36;79;-43
69;21;2;Bom Jesus;28758;28461;297;173;96;77
69;21;2;Camaquã;17837;17690;147;18;87;-69
69;21;2;Campo Novo;8725;8561;164;-14;54;-68
69;21;2;Cascata;13035;12850;185;-38;59;-97
69;21;2;Cavalhada;29194;29078;116;28;92;-64
69;21;2;Centro;39350;39027;323;183;83;100
69;21;2;Chácara das Pedras;6508;6507;1;12;95;-83
69;21;2;Chapéu do Sol;2932;2744;188;4;58;-54
69;21;2;Cidade Baixa;15322;15248;74;28;86;-58
69;21;2;Coronel Aparício Borges;19242;19057;185;60;100;-40
69;21;2;Costa e Silva;15715;15650;65;-6;89;-95
69;21;2;Cristal;31968;31662;306;-153;159;-312
69;21;2;Cristo Redentor;16353;16317;36;148;122;26
69;21;2;Espírito Santo;5497;5355;142;53;84;-31
69;21;2;Extrema;2133;1872;261;11;16;-5
69;21;2;Farrapos;19121;18890;231;-106;83;-189
69;21;2;Farroupilha;913;848;65;-58;43;-101
69;21;2;Floresta;11486;11455;31;-14;74;-88
69;21;2;Glória;16981;16825;156;91;119;-28
69;21;2;Guarujá;4826;4621;205;24;78;-54
69;21;2;Higienópolis;10614;10577;37;37;111;-74
69;21;2;Hípica;18575;18312;263;-22;145;-167
69;21;2;Humaitá;11584;11410;174;-53;74;-127
69;21;2;Independência;7957;7953;4;-5;63;-68
69;21;2;Ipanema;13697;13450;247;13;109;-96
69;21;2;Jardim Botânico;12341;12340;1;68;101;-33
69;21;2;Jardim Carvalho;25440;25155;285;13;137;-124
69;21;2;Jardim do Salso;4335;4237;98;-26;75;-101
69;21;2;Jardim Dona Leopoldina;17848;17752;96;40;137;-97
69;21;2;Jardim Europa;2249;2169;80;41;93;-52
69;21;2;Jardim Floresta;3291;3187;104;30;92;-62
69;21;2;Jardim Isabel;2813;2654;159;11;65;-54
69;21;2;Jardim Itu;17774;17641;133;148;179;-31
69;21;2;Jardim Lindóia;7299;7297;2;26;103;-77
69;21;2;Jardim Sabará;13461;13343;118;121;157;-36
69;21;2;Jardim São Pedro;3947;3847;100;2;95;-93
69;21;2;Lageado;4538;4282;256;-6;49;-55
69;21;2;Lami;4361;4104;257;14;35;-21
69;21;2;Lomba do Pinheiro;58722;57925;797;-284;89;-373
69;21;2;Mário Quintana;38305;37818;487;-20;212;-232
69;21;2;Medianeira;11069;11000;69;54;113;-59
69;21;2;Menino Deus;31795;31408;387;222;178;44
69;21;2;Moinhos de Vento;11791;11765;26;29;80;-51
69;21;2;MontSerrat;11078;11036;42;-2;126;-128
69;21;2;Morro Santana;19395;19142;253;-10;176;-186
69;21;2;Navegantes;4324;4231;93;-35;68;-103
69;21;2;Nonoai;25100;24835;265;-18;183;-201
69;21;2;Parque Santa Fé;6297;6193;104;43;118;-75
69;21;2;Partenon;48431;47716;715;-52;342;-394
69;21;2;Passo DAreia;21966;21743;223;119;214;-95
69;21;2;Passo das Pedras;15834;15698;136;45;151;-106
69;21;2;Pedra Redonda;349;146;203;-4;27;-31
69;21;2;Petrópolis;37591;37153;438;50;277;-227
69;21;2;Pitinga;4516;4222;294;-19;30;-49
69;21;2;Ponta Grossa;8759;8472;287;-19;106;-125
69;21;2;Praia de Belas;2279;2162;117;-123;31;-154
69;21;2;Restinga;53548;53055;493;-67;180;-247
69;21;2;Rio Branco;17526;17275;251;201;171;30
69;21;2;Rubem Berta;33323;32865;458;-120;214;-334
69;21;2;Santa Cecília;5619;5529;90;-103;100;-203
69;21;2;Santa Maria Goretti;3534;3369;165;-47;92;-139
69;21;2;Santa Rosa de Lima;35546;35055;491;-172;206;-378
69;21;2;Santa Tereza;39776;39112;664;-37;320;-357
69;21;2;Santana;20759;20456;303;201;210;-9
69;21;2;Santo Antônio;12996;12884;112;-34;155;-189
69;21;2;São Caetano;909;611;298;26;24;2
69;21;2;São Geraldo;8660;8515;145;-69;105;-174
69;21;2;São João;12149;12084;65;-45;100;-145
69;21;2;São Sebastião;6938;6895;43;-51;91;-142
69;21;2;Sarandi;59983;59391;592;-273;283;-556
69;21;2;Serraria;6319;5979;340;35;110;-75
69;21;2;Sétimo Céu;1218;1053;165;18;54;-36
69;21;2;Teresópolis;14634;14417;217;3;201;-198
69;21;2;Três Figueiras;3999;3903;96;-51;123;-174
69;21;2;Tristeza;16647;16321;326;57;209;-152
69;21;2;Vila Assunção;4530;4202;328;-61;67;-128
69;21;2;Vila Conceição;1503;1156;347;20;39;-19
69;21;2;Vila Ipiranga;18619;18376;243;-10;226;-236
69;21;2;Vila Jardim;13146;12932;214;-40;199;-239
69;21;2;Vila João Pessoa;12884;12709;175;-67;116;-183
69;21;2;Vila Nova;32445;31938;507;-105;239;-344
69;21;2;Vila São José;26658;26125;533;-95;220;-315
70;22;2;Aberta dos Morros;7138;6956;182;32;7;25
70;22;2;Agronomia;2560;2268;292;64;12;52
70;22;2;Anchieta;2171;1948;223;48;-17;65
70;22;2;Arquipélago;8427;8253;174;-11;-25;14
70;22;2;Auxiliadora;9634;9485;149;71;-72;143
70;22;2;Azenha;13735;13580;155;95;-60;155
70;22;2;Bela Vista;11712;11553;159;80;-62;142
70;22;2;Belém Novo;10195;9955;240;11;-1;12
70;22;2;Belém Velho;10891;10695;196;2;3;-1
70;22;2;Boa Vista;10007;9850;157;85;-61;146
70;22;2;Boa Vista do Sul;2462;2153;309;34;3;31
70;22;2;Bom Fim;11495;11356;139;54;-78;132
70;22;2;Bom Jesus;28619;28445;174;-139;-16;-123
70;22;2;Camaquã;17828;17659;169;-9;-31;22
70;22;2;Campo Novo;8758;8586;172;33;25;8
70;22;2;Cascata;13014;12846;168;-21;-4;-17
70;22;2;Cavalhada;29266;29060;206;72;-18;90
70;22;2;Centro;39279;38969;310;-71;-58;-13
70;22;2;Chácara das Pedras;6632;6481;151;124;-26;150
70;22;2;Chapéu do Sol;2977;2752;225;45;8;37
70;22;2;Cidade Baixa;15380;15204;176;58;-44;102
70;22;2;Coronel Aparício Borges;19233;19056;177;-9;-1;-8
70;22;2;Costa e Silva;15810;15654;156;95;4;91
70;22;2;Cristal;31912;31679;233;-56;17;-73
70;22;2;Cristo Redentor;16415;16248;167;62;-69;131
70;22;2;Espírito Santo;5529;5370;159;32;15;17
70;22;2;Extrema;2149;1869;280;16;-3;19
70;22;2;Farrapos;19044;18850;194;-77;-40;-37
70;22;2;Farroupilha;927;777;150;14;-71;85
70;22;2;Floresta;11564;11403;161;78;-52;130
70;22;2;Glória;17041;16842;199;60;17;43
70;22;2;Guarujá;4858;4634;224;32;13;19
70;22;2;Higienópolis;10687;10521;166;73;-56;129
70;22;2;Hípica;18599;18376;223;24;64;-40
70;22;2;Humaitá;11570;11383;187;-14;-27;13
70;22;2;Independência;8082;7911;171;125;-42;167
70;22;2;Ipanema;13654;13459;195;-43;9;-52
70;22;2;Jardim Botânico;12471;12306;165;130;-34;164
70;22;2;Jardim Carvalho;25405;25176;229;-35;21;-56
70;22;2;Jardim do Salso;4385;4235;150;50;-2;52
70;22;2;Jardim Dona Leopoldina;17944;17797;147;96;45;51
70;22;2;Jardim Europa;2277;2127;150;28;-42;70
70;22;2;Jardim Floresta;3290;3143;147;-1;-44;43
70;22;2;Jardim Isabel;2814;2635;179;1;-19;20
70;22;2;Jardim Itu;17790;17623;167;16;-18;34
70;22;2;Jardim Lindóia;7406;7255;151;107;-42;149
70;22;2;Jardim Sabará;13493;13328;165;32;-15;47
70;22;2;Jardim São Pedro;3943;3791;152;-4;-56;52
70;22;2;Lageado;4551;4292;259;13;10;3
70;22;2;Lami;4369;4092;277;8;-12;20
70;22;2;Lomba do Pinheiro;58467;57948;519;-255;23;-278
70;22;2;Mário Quintana;38166;37883;283;-139;65;-204
70;22;2;Medianeira;11161;10993;168;92;-7;99
70;22;2;Menino Deus;31632;31378;254;-163;-30;-133
70;22;2;Moinhos de Vento;11878;11692;186;87;-73;160
70;22;2;MontSerrat;11158;10994;164;80;-42;122
70;22;2;Morro Santana;19384;19172;212;-11;30;-41
70;22;2;Navegantes;4346;4196;150;22;-35;57
70;22;2;Nonoai;25096;24879;217;-4;44;-48
70;22;2;Parque Santa Fé;6363;6225;138;66;32;34
70;22;2;Partenon;48146;47721;425;-285;5;-290
70;22;2;Passo DAreia;21887;21693;194;-79;-50;-29
70;22;2;Passo das Pedras;15888;15713;175;54;15;39
70;22;2;Pedra Redonda;405;148;257;56;2;54
70;22;2;Petrópolis;37437;37160;277;-154;7;-161
70;22;2;Pitinga;4530;4228;302;14;6;8
70;22;2;Ponta Grossa;8787;8487;300;28;15;13
70;22;2;Praia de Belas;2321;2155;166;42;-7;49
70;22;2;Restinga;53287;53087;200;-261;32;-293
70;22;2;Rio Branco;17412;17190;222;-114;-85;-29
70;22;2;Rubem Berta;33206;32902;304;-117;37;-154
70;22;2;Santa Cecília;5642;5487;155;23;-42;65
70;22;2;Santa Maria Goretti;3507;3335;172;-27;-34;7
70;22;2;Santa Rosa de Lima;35399;35083;316;-147;28;-175
70;22;2;Santa Tereza;39629;39157;472;-147;45;-192
70;22;2;Santana;20659;20406;253;-100;-50;-50
70;22;2;Santo Antônio;13078;12894;184;82;10;72
70;22;2;São Caetano;886;578;308;-23;-33;10
70;22;2;São Geraldo;8638;8481;157;-22;-34;12
70;22;2;São João;12227;12046;181;78;-38;116
70;22;2;São Sebastião;7008;6870;138;70;-25;95
70;22;2;Sarandi;59807;59427;380;-176;36;-212
70;22;2;Serraria;6323;6001;322;4;22;-18
70;22;2;Sétimo Céu;1242;1057;185;24;4;20
70;22;2;Teresópolis;14664;14437;227;30;20;10
70;22;2;Três Figueiras;4037;3883;154;38;-20;58
70;22;2;Tristeza;16637;16330;307;-10;9;-19
70;22;2;Vila Assunção;4471;4214;257;-59;12;-71
70;22;2;Vila Conceição;1495;1133;362;-8;-23;15
70;22;2;Vila Ipiranga;18575;18366;209;-44;-10;-34
70;22;2;Vila Jardim;13140;12944;196;-6;12;-18
70;22;2;Vila João Pessoa;12932;12751;181;48;42;6
70;22;2;Vila Nova;32342;31973;369;-103;35;-138
70;22;2;Vila São José;26664;26201;463;6;76;-70
71;23;2;Aberta dos Morros;7146;7146;0;8;190;-182
71;23;2;Agronomia;2331;2331;0;-229;63;-292
71;23;2;Anchieta;2024;2024;0;-147;76;-223
71;23;2;Arquipélago;8330;8330;0;-97;77;-174
71;23;2;Auxiliadora;9683;9683;0;49;198;-149
71;23;2;Azenha;13804;13804;0;69;224;-155
71;23;2;Bela Vista;11787;11787;0;75;234;-159
71;23;2;Belém Novo;10100;10100;0;-95;145;-240
71;23;2;Belém Velho;10835;10835;0;-56;140;-196
71;23;2;Boa Vista;10053;10053;0;46;203;-157
71;23;2;Boa Vista do Sul;2309;2309;0;-153;156;-309
71;23;2;Bom Fim;11593;11593;0;98;237;-139
71;23;2;Bom Jesus;28675;28675;0;56;230;-174
71;23;2;Camaquã;17938;17938;0;110;279;-169
71;23;2;Campo Novo;8766;8766;0;8;180;-172
71;23;2;Cascata;13013;13013;0;-1;167;-168
71;23;2;Cavalhada;29299;29299;0;33;239;-206
71;23;2;Centro;39154;39154;0;-125;185;-310
71;23;2;Chácara das Pedras;6668;6668;0;36;187;-151
71;23;2;Chapéu do Sol;2913;2913;0;-64;161;-225
71;23;2;Cidade Baixa;15379;15379;0;-1;175;-176
71;23;2;Coronel Aparício Borges;19303;19303;0;70;247;-177
71;23;2;Costa e Silva;15842;15842;0;32;188;-156
71;23;2;Cristal;31946;31946;0;34;267;-233
71;23;2;Cristo Redentor;16455;16455;0;40;207;-167
71;23;2;Espírito Santo;5606;5606;0;77;236;-159
71;23;2;Extrema;1981;1981;0;-168;112;-280
71;23;2;Farrapos;18986;18986;0;-58;136;-194
71;23;2;Farroupilha;961;961;0;34;184;-150
71;23;2;Floresta;11596;11596;0;32;193;-161
71;23;2;Glória;17067;17067;0;26;225;-199
71;23;2;Guarujá;4811;4811;0;-47;177;-224
71;23;2;Higienópolis;10724;10724;0;37;203;-166
71;23;2;Hípica;18645;18645;0;46;269;-223
71;23;2;Humaitá;11502;11502;0;-68;119;-187
71;23;2;Independência;8112;8112;0;30;201;-171
71;23;2;Ipanema;13728;13728;0;74;269;-195
71;23;2;Jardim Botânico;12521;12521;0;50;215;-165
71;23;2;Jardim Carvalho;25386;25386;0;-19;210;-229
71;23;2;Jardim do Salso;4405;4405;0;20;170;-150
71;23;2;Jardim Dona Leopoldina;18016;18016;0;72;219;-147
71;23;2;Jardim Europa;2299;2299;0;22;172;-150
71;23;2;Jardim Floresta;3307;3307;0;17;164;-147
71;23;2;Jardim Isabel;2835;2835;0;21;200;-179
71;23;2;Jardim Itu;17853;17853;0;63;230;-167
71;23;2;Jardim Lindóia;7417;7417;0;11;162;-151
71;23;2;Jardim Sabará;13530;13530;0;37;202;-165
71;23;2;Jardim São Pedro;3967;3967;0;24;176;-152
71;23;2;Lageado;4481;4481;0;-70;189;-259
71;23;2;Lami;4289;4289;0;-80;197;-277
71;23;2;Lomba do Pinheiro;58106;58106;0;-361;158;-519
71;23;2;Mário Quintana;38116;38116;0;-50;233;-283
71;23;2;Medianeira;11223;11223;0;62;230;-168
71;23;2;Menino Deus;31650;31650;0;18;272;-254
71;23;2;Moinhos de Vento;11937;11937;0;59;245;-186
71;23;2;MontSerrat;11236;11236;0;78;242;-164
71;23;2;Morro Santana;19338;19338;0;-46;166;-212
71;23;2;Navegantes;4327;4327;0;-19;131;-150
71;23;2;Nonoai;25160;25160;0;64;281;-217
71;23;2;Parque Santa Fé;6376;6376;0;13;151;-138
71;23;2;Partenon;48160;48160;0;14;439;-425
71;23;2;Passo DAreia;21968;21968;0;81;275;-194
71;23;2;Passo das Pedras;15902;15902;0;14;189;-175
71;23;2;Pedra Redonda;274;274;0;-131;126;-257
71;23;2;Petrópolis;37496;37496;0;59;336;-277
71;23;2;Pitinga;4352;4352;0;-178;124;-302
71;23;2;Ponta Grossa;8722;8722;0;-65;235;-300
71;23;2;Praia de Belas;2281;2281;0;-40;126;-166
71;23;2;Restinga;53508;53508;0;221;421;-200
71;23;2;Rio Branco;17531;17531;0;119;341;-222
71;23;2;Rubem Berta;33168;33168;0;-38;266;-304
71;23;2;Santa Cecília;5768;5768;0;126;281;-155
71;23;2;Santa Maria Goretti;3509;3509;0;2;174;-172
71;23;2;Santa Rosa de Lima;35333;35333;0;-66;250;-316
71;23;2;Santa Tereza;39577;39577;0;-52;420;-472
71;23;2;Santana;20723;20723;0;64;317;-253
71;23;2;Santo Antônio;13161;13161;0;83;267;-184
71;23;2;São Caetano;757;757;0;-129;179;-308
71;23;2;São Geraldo;8681;8681;0;43;200;-157
71;23;2;São João;12226;12226;0;-1;180;-181
71;23;2;São Sebastião;7019;7019;0;11;149;-138
71;23;2;Sarandi;59711;59711;0;-96;284;-380
71;23;2;Serraria;6239;6239;0;-84;238;-322
71;23;2;Sétimo Céu;1329;1329;0;87;272;-185
71;23;2;Teresópolis;14707;14707;0;43;270;-227
71;23;2;Três Figueiras;4070;4070;0;33;187;-154
71;23;2;Tristeza;16692;16692;0;55;362;-307
71;23;2;Vila Assunção;4418;4418;0;-53;204;-257
71;23;2;Vila Conceição;1349;1349;0;-146;216;-362
71;23;2;Vila Ipiranga;18659;18659;0;84;293;-209
71;23;2;Vila Jardim;13189;13189;0;49;245;-196
71;23;2;Vila João Pessoa;13041;13041;0;109;290;-181
71;23;2;Vila Nova;32469;32469;0;127;496;-369
71;23;2;Vila São José;26522;26522;0;-142;321;-463
72;0;3;Aberta dos Morros;7115;7083;32;-31;-63;32
72;0;3;Agronomia;2336;2300;36;5;-31;36
72;0;3;Anchieta;2023;1976;47;-1;-48;47
72;0;3;Arquipélago;8333;8291;42;3;-39;42
72;0;3;Auxiliadora;9616;9555;61;-67;-128;61
72;0;3;Azenha;13728;13631;97;-76;-173;97
72;0;3;Bela Vista;11711;11649;62;-76;-138;62
72;0;3;Belém Novo;10085;10070;15;-15;-30;15
72;0;3;Belém Velho;10831;10792;39;-4;-43;39
72;0;3;Boa Vista;9999;9936;63;-54;-117;63
72;0;3;Boa Vista do Sul;2285;2270;15;-24;-39;15
72;0;3;Bom Fim;11469;11428;41;-124;-165;41
72;0;3;Bom Jesus;28644;28586;58;-31;-89;58
72;0;3;Camaquã;17901;17853;48;-37;-85;48
72;0;3;Campo Novo;8750;8708;42;-16;-58;42
72;0;3;Cascata;13005;12956;49;-8;-57;49
72;0;3;Cavalhada;29269;29217;52;-30;-82;52
72;0;3;Centro;39193;39076;117;39;-78;117
72;0;3;Chácara das Pedras;6641;6574;67;-27;-94;67
72;0;3;Chapéu do Sol;2902;2872;30;-11;-41;30
72;0;3;Cidade Baixa;15305;15243;62;-74;-136;62
72;0;3;Coronel Aparício Borges;19272;19212;60;-31;-91;60
72;0;3;Costa e Silva;15833;15781;52;-9;-61;52
72;0;3;Cristal;31929;31879;50;-17;-67;50
72;0;3;Cristo Redentor;16464;16317;147;9;-138;147
72;0;3;Espírito Santo;5586;5538;48;-20;-68;48
72;0;3;Extrema;1977;1968;9;-4;-13;9
72;0;3;Farrapos;19003;18948;55;17;-38;55
72;0;3;Farroupilha;955;810;145;-6;-151;145
72;0;3;Floresta;11544;11480;64;-52;-116;64
72;0;3;Glória;17106;16979;127;39;-88;127
72;0;3;Guarujá;4794;4747;47;-17;-64;47
72;0;3;Higienópolis;10695;10627;68;-29;-97;68
72;0;3;Hípica;18635;18593;42;-10;-52;42
72;0;3;Humaitá;11524;11464;60;22;-38;60
72;0;3;Independência;8139;7979;160;27;-133;160
72;0;3;Ipanema;13712;13661;51;-16;-67;51
72;0;3;Jardim Botânico;12553;12406;147;32;-115;147
72;0;3;Jardim Carvalho;25465;25327;138;79;-59;138
72;0;3;Jardim do Salso;4392;4326;66;-13;-79;66
72;0;3;Jardim Dona Leopoldina;18004;17948;56;-12;-68;56
72;0;3;Jardim Europa;2274;2206;68;-25;-93;68
72;0;3;Jardim Floresta;3292;3227;65;-15;-80;65
72;0;3;Jardim Isabel;2811;2758;53;-24;-77;53
72;0;3;Jardim Itu;17840;17776;64;-13;-77;64
72;0;3;Jardim Lindóia;7400;7331;69;-17;-86;69
72;0;3;Jardim Sabará;13523;13456;67;-7;-74;67
72;0;3;Jardim São Pedro;3946;3877;69;-21;-90;69
72;0;3;Lageado;4483;4451;32;2;-30;32
72;0;3;Lami;4283;4262;21;-6;-27;21
72;0;3;Lomba do Pinheiro;58134;58086;48;28;-20;48
72;0;3;Mário Quintana;38125;38070;55;9;-46;55
72;0;3;Medianeira;11182;11118;64;-41;-105;64
72;0;3;Menino Deus;31708;31547;161;58;-103;161
72;0;3;Moinhos de Vento;11995;11823;172;58;-114;172
72;0;3;MontSerrat;11189;11119;70;-47;-117;70
72;0;3;Morro Santana;19352;19287;65;14;-51;65
72;0;3;Navegantes;4337;4271;66;10;-56;66
72;0;3;Nonoai;25140;25081;59;-20;-79;59
72;0;3;Parque Santa Fé;6373;6315;58;-3;-61;58
72;0;3;Partenon;48149;48078;71;-11;-82;71
72;0;3;Passo DAreia;21944;21872;72;-24;-96;72
72;0;3;Passo das Pedras;15907;15840;67;5;-62;67
72;0;3;Pedra Redonda;252;197;55;-22;-77;55
72;0;3;Petrópolis;37468;37397;71;-28;-99;71
72;0;3;Pitinga;4375;4339;36;23;-13;36
72;0;3;Ponta Grossa;8735;8695;40;13;-27;40
72;0;3;Praia de Belas;2270;2202;68;-11;-79;68
72;0;3;Restinga;53594;53489;105;86;-19;105
72;0;3;Rio Branco;17589;17402;187;58;-129;187
72;0;3;Rubem Berta;33182;33113;69;14;-55;69
72;0;3;Santa Cecília;5837;5650;187;69;-118;187
72;0;3;Santa Maria Goretti;3513;3439;74;4;-70;74
72;0;3;Santa Rosa de Lima;35364;35305;59;31;-28;59
72;0;3;Santa Tereza;39570;39508;62;-7;-69;62
72;0;3;Santana;20804;20610;194;81;-113;194
72;0;3;Santo Antônio;13148;13070;78;-13;-91;78
72;0;3;São Caetano;773;739;34;16;-18;34
72;0;3;São Geraldo;8691;8613;78;10;-68;78
72;0;3;São João;12244;12162;82;18;-64;82
72;0;3;São Sebastião;7027;6955;72;8;-64;72
72;0;3;Sarandi;59733;59663;70;22;-48;70
72;0;3;Serraria;6254;6202;52;15;-37;52
72;0;3;Sétimo Céu;1307;1251;56;-22;-78;56
72;0;3;Teresópolis;14819;14641;178;112;-66;178
72;0;3;Três Figueiras;4071;3989;82;1;-81;82
72;0;3;Tristeza;16675;16618;57;-17;-74;57
72;0;3;Vila Assunção;4531;4381;150;113;-37;150
72;0;3;Vila Conceição;1366;1305;61;17;-44;61
72;0;3;Vila Ipiranga;18664;18584;80;5;-75;80
72;0;3;Vila Jardim;13199;13119;80;10;-70;80
72;0;3;Vila João Pessoa;13054;12978;76;13;-63;76
72;0;3;Vila Nova;32583;32427;156;114;-42;156
72;0;3;Vila São José;26549;26475;74;27;-47;74
73;1;3;Aberta dos Morros;7110;7073;37;-5;-10;5
73;1;3;Agronomia;2324;2286;38;-12;-14;2
73;1;3;Anchieta;2020;1972;48;-3;-4;1
73;1;3;Arquipélago;8339;8285;54;6;-6;12
73;1;3;Auxiliadora;9602;9535;67;-14;-20;6
73;1;3;Azenha;13735;13601;134;7;-30;37
73;1;3;Bela Vista;11703;11630;73;-8;-19;11
73;1;3;Belém Novo;10085;10066;19;0;-4;4
73;1;3;Belém Velho;10828;10778;50;-3;-14;11
73;1;3;Boa Vista;9993;9918;75;-6;-18;12
73;1;3;Boa Vista do Sul;2282;2265;17;-3;-5;2
73;1;3;Bom Fim;11442;11402;40;-27;-26;-1
73;1;3;Bom Jesus;28662;28569;93;18;-17;35
73;1;3;Camaquã;17905;17832;73;4;-21;25
73;1;3;Campo Novo;8744;8695;49;-6;-13;7
73;1;3;Cascata;13002;12934;68;-3;-22;19
73;1;3;Cavalhada;29280;29195;85;11;-22;33
73;1;3;Centro;39286;39071;215;93;-5;98
73;1;3;Chácara das Pedras;6617;6545;72;-24;-29;5
73;1;3;Chapéu do Sol;2892;2859;33;-10;-13;3
73;1;3;Cidade Baixa;15299;15225;74;-6;-18;12
73;1;3;Coronel Aparício Borges;19258;19182;76;-14;-30;16
73;1;3;Costa e Silva;15819;15750;69;-14;-31;17
73;1;3;Cristal;31954;31866;88;25;-13;38
73;1;3;Cristo Redentor;16490;16303;187;26;-14;40
73;1;3;Espírito Santo;5570;5517;53;-16;-21;5
73;1;3;Extrema;1975;1965;10;-2;-3;1
73;1;3;Farrapos;19022;18942;80;19;-6;25
73;1;3;Farroupilha;905;778;127;-50;-32;-18
73;1;3;Floresta;11532;11460;72;-12;-20;8
73;1;3;Glória;17098;16948;150;-8;-31;23
73;1;3;Guarujá;4790;4738;52;-4;-9;5
73;1;3;Higienópolis;10695;10610;85;0;-17;17
73;1;3;Hípica;18633;18576;57;-2;-17;15
73;1;3;Humaitá;11527;11455;72;3;-9;12
73;1;3;Independência;8114;7953;161;-25;-26;1
73;1;3;Ipanema;13713;13648;65;1;-13;14
73;1;3;Jardim Botânico;12542;12378;164;-11;-28;17
73;1;3;Jardim Carvalho;25500;25310;190;35;-17;52
73;1;3;Jardim do Salso;4366;4297;69;-26;-29;3
73;1;3;Jardim Dona Leopoldina;17995;17912;83;-9;-36;27
73;1;3;Jardim Europa;2249;2180;69;-25;-26;1
73;1;3;Jardim Floresta;3278;3209;69;-14;-18;4
73;1;3;Jardim Isabel;2798;2741;57;-13;-17;4
73;1;3;Jardim Itu;17827;17739;88;-13;-37;24
73;1;3;Jardim Lindóia;7389;7311;78;-11;-20;9
73;1;3;Jardim Sabará;13515;13426;89;-8;-30;22
73;1;3;Jardim São Pedro;3928;3855;73;-18;-22;4
73;1;3;Lageado;4478;4444;34;-5;-7;2
73;1;3;Lami;4280;4258;22;-3;-4;1
73;1;3;Lomba do Pinheiro;58180;58081;99;46;-5;51
73;1;3;Mário Quintana;38151;38050;101;26;-20;46
73;1;3;Medianeira;11160;11090;70;-22;-28;6
73;1;3;Menino Deus;31758;31525;233;50;-22;72
73;1;3;Moinhos de Vento;11996;11799;197;1;-24;25
73;1;3;MontSerrat;11177;11094;83;-12;-25;13
73;1;3;Morro Santana;19356;19268;88;4;-19;23
73;1;3;Navegantes;4327;4256;71;-10;-15;5
73;1;3;Nonoai;25142;25056;86;2;-25;27
73;1;3;Parque Santa Fé;6343;6277;66;-30;-38;8
73;1;3;Partenon;48199;48057;142;50;-21;71
73;1;3;Passo DAreia;21965;21857;108;21;-15;36
73;1;3;Passo das Pedras;15902;15814;88;-5;-26;21
73;1;3;Pedra Redonda;238;183;55;-14;-14;0
73;1;3;Petrópolis;37509;37382;127;41;-15;56
73;1;3;Pitinga;4368;4330;38;-7;-9;2
73;1;3;Ponta Grossa;8730;8687;43;-5;-8;3
73;1;3;Praia de Belas;2240;2173;67;-30;-29;-1
73;1;3;Restinga;53673;53484;189;79;-5;84
73;1;3;Rio Branco;17594;17374;220;5;-28;33
73;1;3;Rubem Berta;33196;33084;112;14;-29;43
73;1;3;Santa Cecília;5809;5623;186;-28;-27;-1
73;1;3;Santa Maria Goretti;3499;3421;78;-14;-18;4
73;1;3;Santa Rosa de Lima;35385;35291;94;21;-14;35
73;1;3;Santa Tereza;39600;39489;111;30;-19;49
73;1;3;Santana;20817;20583;234;13;-27;40
73;1;3;Santo Antônio;13124;13032;92;-24;-38;14
73;1;3;São Caetano;767;733;34;-6;-6;0
73;1;3;São Geraldo;8681;8591;90;-10;-22;12
73;1;3;São João;12249;12146;103;5;-16;21
73;1;3;São Sebastião;7013;6930;83;-14;-25;11
73;1;3;Sarandi;59793;59647;146;60;-16;76
73;1;3;Serraria;6247;6190;57;-7;-12;5
73;1;3;Sétimo Céu;1291;1235;56;-16;-16;0
73;1;3;Teresópolis;14811;14614;197;-8;-27;19
73;1;3;Três Figueiras;4058;3972;86;-13;-17;4
73;1;3;Tristeza;16678;16602;76;3;-16;19
73;1;3;Vila Assunção;4519;4369;150;-12;-12;0
73;1;3;Vila Conceição;1360;1299;61;-6;-6;0
73;1;3;Vila Ipiranga;18657;18550;107;-7;-34;27
73;1;3;Vila Jardim;13183;13089;94;-16;-30;14
73;1;3;Vila João Pessoa;13032;12945;87;-22;-33;11
73;1;3;Vila Nova;32629;32415;214;46;-12;58
73;1;3;Vila São José;26555;26449;106;6;-26;32
74;2;3;Aberta dos Morros;7107;7070;37;-3;-3;0
74;2;3;Agronomia;2341;2302;39;17;16;1
74;2;3;Anchieta;2027;1977;50;7;5;2
74;2;3;Arquipélago;8333;8283;50;-6;-2;-4
74;2;3;Auxiliadora;9610;9555;55;8;20;-12
74;2;3;Azenha;13773;13641;132;38;40;-2
74;2;3;Bela Vista;11699;11642;57;-4;12;-16
74;2;3;Belém Novo;10088;10067;21;3;1;2
74;2;3;Belém Velho;10832;10782;50;4;4;0
74;2;3;Boa Vista;10002;9935;67;9;17;-8
74;2;3;Boa Vista do Sul;2283;2267;16;1;2;-1
74;2;3;Bom Fim;11445;11423;22;3;21;-18
74;2;3;Bom Jesus;28660;28584;76;-2;15;-17
74;2;3;Camaquã;17918;17849;69;13;17;-4
74;2;3;Campo Novo;8748;8696;52;4;1;3
74;2;3;Cascata;13000;12938;62;-2;4;-6
74;2;3;Cavalhada;29282;29207;75;2;12;-10
74;2;3;Centro;39317;39088;229;31;17;14
74;2;3;Chácara das Pedras;6621;6564;57;4;19;-15
74;2;3;Chapéu do Sol;2898;2865;33;6;6;0
74;2;3;Cidade Baixa;15301;15244;57;2;19;-17
74;2;3;Coronel Aparício Borges;19264;19198;66;6;16;-10
74;2;3;Costa e Silva;15841;15772;69;22;22;0
74;2;3;Cristal;31956;31871;85;2;5;-3
74;2;3;Cristo Redentor;16467;16314;153;-23;11;-34
74;2;3;Espírito Santo;5572;5521;51;2;4;-2
74;2;3;Extrema;1977;1966;11;2;1;1
74;2;3;Farrapos;19022;18942;80;0;0;0
74;2;3;Farroupilha;923;807;116;18;29;-11
74;2;3;Floresta;11534;11477;57;2;17;-15
74;2;3;Glória;17114;16950;164;16;2;14
74;2;3;Guarujá;4788;4737;51;-2;-1;-1
74;2;3;Higienópolis;10688;10612;76;-7;2;-9
74;2;3;Hípica;18640;18584;56;7;8;-1
74;2;3;Humaitá;11527;11455;72;0;0;0
74;2;3;Independência;8120;7968;152;6;15;-9
74;2;3;Ipanema;13720;13653;67;7;5;2
74;2;3;Jardim Botânico;12555;12403;152;13;25;-12
74;2;3;Jardim Carvalho;25486;25310;176;-14;0;-14
74;2;3;Jardim do Salso;4374;4311;63;8;14;-6
74;2;3;Jardim Dona Leopoldina;18008;17940;68;13;28;-15
74;2;3;Jardim Europa;2256;2193;63;7;13;-6
74;2;3;Jardim Floresta;3286;3216;70;8;7;1
74;2;3;Jardim Isabel;2800;2745;55;2;4;-2
74;2;3;Jardim Itu;17836;17758;78;9;19;-10
74;2;3;Jardim Lindóia;7389;7321;68;0;10;-10
74;2;3;Jardim Sabará;13517;13438;79;2;12;-10
74;2;3;Jardim São Pedro;3942;3873;69;14;18;-4
74;2;3;Lageado;4481;4447;34;3;3;0
74;2;3;Lami;4286;4262;24;6;4;2
74;2;3;Lomba do Pinheiro;58158;58080;78;-22;-1;-21
74;2;3;Mário Quintana;38148;38062;86;-3;12;-15
74;2;3;Medianeira;11156;11103;53;-4;13;-17
74;2;3;Menino Deus;31742;31537;205;-16;12;-28
74;2;3;Moinhos de Vento;11991;11821;170;-5;22;-27
74;2;3;MontSerrat;11184;11113;71;7;19;-12
74;2;3;Morro Santana;19357;19269;88;1;1;0
74;2;3;Navegantes;4326;4254;72;-1;-2;1
74;2;3;Nonoai;25146;25063;83;4;7;-3
74;2;3;Parque Santa Fé;6349;6290;59;6;13;-7
74;2;3;Partenon;48172;48064;108;-27;7;-34
74;2;3;Passo DAreia;21970;21866;104;5;9;-4
74;2;3;Passo das Pedras;15901;15823;78;-1;9;-10
74;2;3;Pedra Redonda;239;185;54;1;2;-1
74;2;3;Petrópolis;37488;37385;103;-21;3;-24
74;2;3;Pitinga;4373;4332;41;5;2;3
74;2;3;Ponta Grossa;8733;8686;47;3;-1;4
74;2;3;Praia de Belas;2248;2189;59;8;16;-8
74;2;3;Restinga;53632;53482;150;-41;-2;-39
74;2;3;Rio Branco;17572;17376;196;-22;2;-24
74;2;3;Rubem Berta;33180;33099;81;-16;15;-31
74;2;3;Santa Cecília;5797;5624;173;-12;1;-13
74;2;3;Santa Maria Goretti;3501;3422;79;2;1;1
74;2;3;Santa Rosa de Lima;35386;35293;93;1;2;-1
74;2;3;Santa Tereza;39583;39488;95;-17;-1;-16
74;2;3;Santana;20805;20585;220;-12;2;-14
74;2;3;Santo Antônio;13107;13040;67;-17;8;-25
74;2;3;São Caetano;765;731;34;-2;-2;0
74;2;3;São Geraldo;8681;8597;84;0;6;-6
74;2;3;São João;12244;12147;97;-5;1;-6
74;2;3;São Sebastião;7015;6939;76;2;9;-7
74;2;3;Sarandi;59761;59649;112;-32;2;-34
74;2;3;Serraria;6248;6191;57;1;1;0
74;2;3;Sétimo Céu;1299;1243;56;8;8;0
74;2;3;Teresópolis;14806;14616;190;-5;2;-7
74;2;3;Três Figueiras;4060;3973;87;2;1;1
74;2;3;Tristeza;16679;16606;73;1;4;-3
74;2;3;Vila Assunção;4507;4364;143;-12;-5;-7
74;2;3;Vila Conceição;1362;1300;62;2;1;1
74;2;3;Vila Ipiranga;18652;18558;94;-5;8;-13
74;2;3;Vila Jardim;13181;13093;88;-2;4;-6
74;2;3;Vila João Pessoa;13032;12956;76;0;11;-11
74;2;3;Vila Nova;32606;32415;191;-23;0;-23
74;2;3;Vila São José;26555;26453;102;0;4;-4
75;3;3;Aberta dos Morros;7106;7068;38;-1;-2;1
75;3;3;Agronomia;2338;2301;37;-3;-1;-2
75;3;3;Anchieta;2030;1980;50;3;3;0
75;3;3;Arquipélago;8340;8287;53;7;4;3
75;3;3;Auxiliadora;9615;9573;42;5;18;-13
75;3;3;Azenha;13811;13688;123;38;47;-9
75;3;3;Bela Vista;11702;11666;36;3;24;-21
75;3;3;Belém Novo;10088;10068;20;0;1;-1
75;3;3;Belém Velho;10839;10788;51;7;6;1
75;3;3;Boa Vista;10007;9955;52;5;20;-15
75;3;3;Boa Vista do Sul;2283;2267;16;0;0;0
75;3;3;Bom Fim;11460;11443;17;15;20;-5
75;3;3;Bom Jesus;28670;28603;67;10;19;-9
75;3;3;Camaquã;17921;17869;52;3;20;-17
75;3;3;Campo Novo;8749;8700;49;1;4;-3
75;3;3;Cascata;13003;12951;52;3;13;-10
75;3;3;Cavalhada;29293;29226;67;11;19;-8
75;3;3;Centro;39286;39087;199;-31;-1;-30
75;3;3;Chácara das Pedras;6635;6587;48;14;23;-9
75;3;3;Chapéu do Sol;2902;2869;33;4;4;0
75;3;3;Cidade Baixa;15285;15257;28;-16;13;-29
75;3;3;Coronel Aparício Borges;19258;19221;37;-6;23;-29
75;3;3;Costa e Silva;15841;15794;47;0;22;-22
75;3;3;Cristal;31941;31883;58;-15;12;-27
75;3;3;Cristo Redentor;16495;16349;146;28;35;-7
75;3;3;Espírito Santo;5572;5525;47;0;4;-4
75;3;3;Extrema;1976;1964;12;-1;-2;1
75;3;3;Farrapos;19018;18943;75;-4;1;-5
75;3;3;Farroupilha;941;832;109;18;25;-7
75;3;3;Floresta;11537;11494;43;3;17;-14
75;3;3;Glória;17129;16980;149;15;30;-15
75;3;3;Guarujá;4789;4738;51;1;1;0
75;3;3;Higienópolis;10692;10625;67;4;13;-9
75;3;3;Hípica;18638;18589;49;-2;5;-7
75;3;3;Humaitá;11527;11457;70;0;2;-2
75;3;3;Independência;8133;7993;140;13;25;-12
75;3;3;Ipanema;13721;13656;65;1;3;-2
75;3;3;Jardim Botânico;12556;12425;131;1;22;-21
75;3;3;Jardim Carvalho;25525;25335;190;39;25;14
75;3;3;Jardim do Salso;4373;4323;50;-1;12;-13
75;3;3;Jardim Dona Leopoldina;18008;17965;43;0;25;-25
75;3;3;Jardim Europa;2264;2212;52;8;19;-11
75;3;3;Jardim Floresta;3296;3232;64;10;16;-6
75;3;3;Jardim Isabel;2804;2750;54;4;5;-1
75;3;3;Jardim Itu;17822;17772;50;-14;14;-28
75;3;3;Jardim Lindóia;7399;7338;61;10;17;-7
75;3;3;Jardim Sabará;13514;13458;56;-3;20;-23
75;3;3;Jardim São Pedro;3943;3881;62;1;8;-7
75;3;3;Lageado;4484;4450;34;3;3;0
75;3;3;Lami;4282;4259;23;-4;-3;-1
75;3;3;Lomba do Pinheiro;58163;58080;83;5;0;5
75;3;3;Mário Quintana;38143;38078;65;-5;16;-21
75;3;3;Medianeira;11149;11116;33;-7;13;-20
75;3;3;Menino Deus;31754;31556;198;12;19;-7
75;3;3;Moinhos de Vento;11988;11826;162;-3;5;-8
75;3;3;MontSerrat;11175;11121;54;-9;8;-17
75;3;3;Morro Santana;19351;19282;69;-6;13;-19
75;3;3;Navegantes;4330;4259;71;4;5;-1
75;3;3;Nonoai;25127;25080;47;-19;17;-36
75;3;3;Parque Santa Fé;6375;6326;49;26;36;-10
75;3;3;Partenon;48167;48081;86;-5;17;-22
75;3;3;Passo DAreia;21959;21876;83;-11;10;-21
75;3;3;Passo das Pedras;15890;15836;54;-11;13;-24
75;3;3;Pedra Redonda;241;190;51;2;5;-3
75;3;3;Petrópolis;37480;37393;87;-8;8;-16
75;3;3;Pitinga;4378;4335;43;5;3;2
75;3;3;Ponta Grossa;8732;8685;47;-1;-1;0
75;3;3;Praia de Belas;2255;2208;47;7;19;-12
75;3;3;Restinga;53631;53482;149;-1;0;-1
75;3;3;Rio Branco;17580;17396;184;8;20;-12
75;3;3;Rubem Berta;33160;33114;46;-20;15;-35
75;3;3;Santa Cecília;5797;5649;148;0;25;-25
75;3;3;Santa Maria Goretti;3502;3431;71;1;9;-8
75;3;3;Santa Rosa de Lima;35364;35296;68;-22;3;-25
75;3;3;Santa Tereza;39571;39502;69;-12;14;-26
75;3;3;Santana;20795;20600;195;-10;15;-25
75;3;3;Santo Antônio;13098;13058;40;-9;18;-27
75;3;3;São Caetano;767;733;34;2;2;0
75;3;3;São Geraldo;8678;8607;71;-3;10;-13
75;3;3;São João;12241;12154;87;-3;7;-10
75;3;3;São Sebastião;7012;6951;61;-3;12;-15
75;3;3;Sarandi;59748;59657;91;-13;8;-21
75;3;3;Serraria;6247;6190;57;-1;-1;0
75;3;3;Sétimo Céu;1304;1249;55;5;6;-1
75;3;3;Teresópolis;14792;14622;170;-14;6;-20
75;3;3;Três Figueiras;4058;3982;76;-2;9;-11
75;3;3;Tristeza;16673;16614;59;-6;8;-14
75;3;3;Vila Assunção;4505;4369;136;-2;5;-7
75;3;3;Vila Conceição;1362;1299;63;0;-1;1
75;3;3;Vila Ipiranga;18637;18574;63;-15;16;-31
75;3;3;Vila Jardim;13180;13110;70;-1;17;-18
75;3;3;Vila João Pessoa;13024;12967;57;-8;11;-19
75;3;3;Vila Nova;32600;32419;181;-6;4;-10
75;3;3;Vila São José;26527;26459;68;-28;6;-34
76;4;3;Aberta dos Morros;6816;6446;370;-290;-622;332
76;4;3;Agronomia;1735;1671;64;-603;-630;27
76;4;3;Anchieta;1397;1362;35;-633;-618;-15
76;4;3;Arquipélago;8149;7669;480;-191;-618;427
76;4;3;Auxiliadora;9167;8637;530;-448;-936;488
76;4;3;Azenha;13464;12665;799;-347;-1023;676
76;4;3;Bela Vista;11320;10627;693;-382;-1039;657
76;4;3;Belém Novo;10043;9568;475;-45;-500;455
76;4;3;Belém Velho;10705;10068;637;-134;-720;586
76;4;3;Boa Vista;9555;8984;571;-452;-971;519
76;4;3;Boa Vista do Sul;1814;1773;41;-469;-494;25
76;4;3;Bom Fim;11000;10370;630;-460;-1073;613
76;4;3;Bom Jesus;29332;27556;1776;662;-1047;1709
76;4;3;Camaquã;18015;16981;1034;94;-888;982
76;4;3;Campo Novo;8428;7980;448;-321;-720;399
76;4;3;Cascata;12868;12130;738;-135;-821;686
76;4;3;Cavalhada;30044;28331;1713;751;-895;1646
76;4;3;Centro;40508;38241;2267;1222;-846;2068
76;4;3;Chácara das Pedras;5854;5544;310;-781;-1043;262
76;4;3;Chapéu do Sol;2327;2269;58;-575;-600;25
76;4;3;Cidade Baixa;15126;14238;888;-159;-1019;860
76;4;3;Coronel Aparício Borges;19316;18190;1126;58;-1031;1089
76;4;3;Costa e Silva;15647;14800;847;-194;-994;800
76;4;3;Cristal;32917;31063;1854;976;-820;1796
76;4;3;Cristo Redentor;16253;15298;955;-242;-1051;809
76;4;3;Espírito Santo;5050;4801;249;-522;-724;202
76;4;3;Extrema;1578;1544;34;-398;-420;22
76;4;3;Farrapos;19328;18267;1061;310;-676;986
76;4;3;Farroupilha;437;437;0;-504;-395;-109
76;4;3;Floresta;11213;10556;657;-324;-938;614
76;4;3;Glória;16972;15955;1017;-157;-1025;868
76;4;3;Guarujá;4265;4065;200;-524;-673;149
76;4;3;Higienópolis;10266;9635;631;-426;-990;564
76;4;3;Hípica;18937;17940;997;299;-649;948
76;4;3;Humaitá;11408;10767;641;-119;-690;571
76;4;3;Independência;7397;6946;451;-736;-1047;311
76;4;3;Ipanema;13693;12947;746;-28;-709;681
76;4;3;Jardim Botânico;12041;11295;746;-515;-1130;615
76;4;3;Jardim Carvalho;25983;24395;1588;458;-940;1398
76;4;3;Jardim do Salso;3473;3291;182;-900;-1032;132
76;4;3;Jardim Dona Leopoldina;17932;16898;1034;-76;-1067;991
76;4;3;Jardim Europa;1308;1288;20;-956;-924;-32
76;4;3;Jardim Floresta;2480;2387;93;-816;-845;29
76;4;3;Jardim Isabel;2068;2033;35;-736;-717;-19
76;4;3;Jardim Itu;17874;16798;1076;52;-974;1026
76;4;3;Jardim Lindóia;6810;6414;396;-589;-924;335
76;4;3;Jardim Sabará;13298;12488;810;-216;-970;754
76;4;3;Jardim São Pedro;3162;2982;180;-781;-899;118
76;4;3;Lageado;4042;3848;194;-442;-602;160
76;4;3;Lami;3989;3777;212;-293;-482;189
76;4;3;Lomba do Pinheiro;60698;57425;3273;2535;-655;3190
76;4;3;Mário Quintana;39414;37267;2147;1271;-811;2082
76;4;3;Medianeira;10753;10112;641;-396;-1004;608
76;4;3;Menino Deus;32652;30628;2024;898;-928;1826
76;4;3;Moinhos de Vento;11562;10822;740;-426;-1004;578
76;4;3;MontSerrat;10779;10109;670;-396;-1012;616
76;4;3;Morro Santana;19622;18474;1148;271;-808;1079
76;4;3;Navegantes;3674;3472;202;-656;-787;131
76;4;3;Nonoai;25661;24177;1484;534;-903;1437
76;4;3;Parque Santa Fé;5682;5370;312;-693;-956;263
76;4;3;Partenon;49913;47085;2828;1746;-996;2742
76;4;3;Passo DAreia;22318;20954;1364;359;-922;1281
76;4;3;Passo das Pedras;15819;14910;909;-71;-926;855
76;4;3;Pedra Redonda;155;128;27;-86;-62;-24
76;4;3;Petrópolis;38776;36409;2367;1296;-984;2280
76;4;3;Pitinga;3963;3749;214;-415;-586;171
76;4;3;Ponta Grossa;8608;8169;439;-124;-516;392
76;4;3;Praia de Belas;1528;1405;123;-727;-803;76
76;4;3;Restinga;55898;52973;2925;2267;-509;2776
76;4;3;Rio Branco;17516;16376;1140;-64;-1020;956
76;4;3;Rubem Berta;34202;32285;1917;1042;-829;1871
76;4;3;Santa Cecília;4894;4581;313;-903;-1068;165
76;4;3;Santa Maria Goretti;2830;2597;233;-672;-834;162
76;4;3;Santa Rosa de Lima;36639;34597;2042;1275;-699;1974
76;4;3;Santa Tereza;41010;38637;2373;1439;-865;2304
76;4;3;Santana;21030;19632;1398;235;-968;1203
76;4;3;Santo Antônio;12996;12123;873;-102;-935;833
76;4;3;São Caetano;604;406;198;-163;-327;164
76;4;3;São Geraldo;8417;7822;595;-261;-785;524
76;4;3;São João;12256;11375;881;15;-779;794
76;4;3;São Sebastião;6495;6067;428;-517;-884;367
76;4;3;Sarandi;62632;58982;3650;2884;-675;3559
76;4;3;Serraria;6093;5711;382;-154;-479;325
76;4;3;Sétimo Céu;756;660;96;-548;-589;41
76;4;3;Teresópolis;14794;13734;1060;2;-888;890
76;4;3;Três Figueiras;3431;3048;383;-627;-934;307
76;4;3;Tristeza;16922;15903;1019;249;-711;960
76;4;3;Vila Assunção;4059;3699;360;-446;-670;224
76;4;3;Vila Conceição;932;759;173;-430;-540;110
76;4;3;Vila Ipiranga;19003;17700;1303;366;-874;1240
76;4;3;Vila Jardim;13228;12232;996;48;-878;926
76;4;3;Vila João Pessoa;12910;12022;888;-114;-945;831
76;4;3;Vila Nova;33915;31869;2046;1315;-550;1865
76;4;3;Vila São José;27508;25770;1738;981;-689;1670
77;5;3;Aberta dos Morros;6813;6442;371;-3;-4;1
77;5;3;Agronomia;1728;1669;59;-7;-2;-5
77;5;3;Anchieta;1392;1359;33;-5;-3;-2
77;5;3;Arquipélago;8158;7666;492;9;-3;12
77;5;3;Auxiliadora;9168;8635;533;1;-2;3
77;5;3;Azenha;13439;12630;809;-25;-35;10
77;5;3;Bela Vista;11308;10620;688;-12;-7;-5
77;5;3;Belém Novo;10049;9567;482;6;-1;7
77;5;3;Belém Velho;10703;10058;645;-2;-10;8
77;5;3;Boa Vista;9557;8982;575;2;-2;4
77;5;3;Boa Vista do Sul;1809;1771;38;-5;-2;-3
77;5;3;Bom Fim;10978;10361;617;-22;-9;-13
77;5;3;Bom Jesus;29359;27529;1830;27;-27;54
77;5;3;Camaquã;18023;16965;1058;8;-16;24
77;5;3;Campo Novo;8420;7964;456;-8;-16;8
77;5;3;Cascata;12884;12122;762;16;-8;24
77;5;3;Cavalhada;30087;28317;1770;43;-14;57
77;5;3;Centro;40571;38231;2340;63;-10;73
77;5;3;Chácara das Pedras;5834;5534;300;-20;-10;-10
77;5;3;Chapéu do Sol;2315;2265;50;-12;-4;-8
77;5;3;Cidade Baixa;15137;14219;918;11;-19;30
77;5;3;Coronel Aparício Borges;19323;18171;1152;7;-19;26
77;5;3;Costa e Silva;15643;14774;869;-4;-26;22
77;5;3;Cristal;32963;31051;1912;46;-12;58
77;5;3;Cristo Redentor;16244;15278;966;-9;-20;11
77;5;3;Espírito Santo;5044;4798;246;-6;-3;-3
77;5;3;Extrema;1578;1545;33;0;1;-1
77;5;3;Farrapos;19347;18261;1086;19;-6;25
77;5;3;Farroupilha;440;440;0;3;3;0
77;5;3;Floresta;11212;10536;676;-1;-20;19
77;5;3;Glória;16982;15925;1057;10;-30;40
77;5;3;Guarujá;4263;4060;203;-2;-5;3
77;5;3;Higienópolis;10277;9632;645;11;-3;14
77;5;3;Hípica;18949;17928;1021;12;-12;24
77;5;3;Humaitá;11421;10763;658;13;-4;17
77;5;3;Independência;7392;6946;446;-5;0;-5
77;5;3;Ipanema;13702;12940;762;9;-7;16
77;5;3;Jardim Botânico;12043;11276;767;2;-19;21
77;5;3;Jardim Carvalho;26017;24380;1637;34;-15;49
77;5;3;Jardim do Salso;3461;3286;175;-12;-5;-7
77;5;3;Jardim Dona Leopoldina;17924;16861;1063;-8;-37;29
77;5;3;Jardim Europa;1285;1280;5;-23;-8;-15
77;5;3;Jardim Floresta;2469;2382;87;-11;-5;-6
77;5;3;Jardim Isabel;2060;2032;28;-8;-1;-7
77;5;3;Jardim Itu;17878;16770;1108;4;-28;32
77;5;3;Jardim Lindóia;6816;6416;400;6;2;4
77;5;3;Jardim Sabará;13299;12472;827;1;-16;17
77;5;3;Jardim São Pedro;3159;2981;178;-3;-1;-2
77;5;3;Lageado;4037;3845;192;-5;-3;-2
77;5;3;Lami;3991;3780;211;2;3;-1
77;5;3;Lomba do Pinheiro;60768;57424;3344;70;-1;71
77;5;3;Mário Quintana;39454;37250;2204;40;-17;57
77;5;3;Medianeira;10744;10085;659;-9;-27;18
77;5;3;Menino Deus;32683;30602;2081;31;-26;57
77;5;3;Moinhos de Vento;11543;10796;747;-19;-26;7
77;5;3;MontSerrat;10779;10087;692;0;-22;22
77;5;3;Morro Santana;19641;18454;1187;19;-20;39
77;5;3;Navegantes;3670;3473;197;-4;1;-5
77;5;3;Nonoai;25678;24158;1520;17;-19;36
77;5;3;Parque Santa Fé;5662;5346;316;-20;-24;4
77;5;3;Partenon;49981;47060;2921;68;-25;93
77;5;3;Passo DAreia;22343;20946;1397;25;-8;33
77;5;3;Passo das Pedras;15828;14895;933;9;-15;24
77;5;3;Pedra Redonda;143;124;19;-12;-4;-8
77;5;3;Petrópolis;38831;36389;2442;55;-20;75
77;5;3;Pitinga;3948;3743;205;-15;-6;-9
77;5;3;Ponta Grossa;8593;8154;439;-15;-15;0
77;5;3;Praia de Belas;1488;1398;90;-40;-7;-33
77;5;3;Restinga;55935;52965;2970;37;-8;45
77;5;3;Rio Branco;17494;16337;1157;-22;-39;17
77;5;3;Rubem Berta;34214;32266;1948;12;-19;31
77;5;3;Santa Cecília;4873;4574;299;-21;-7;-14
77;5;3;Santa Maria Goretti;2816;2591;225;-14;-6;-8
77;5;3;Santa Rosa de Lima;36648;34582;2066;9;-15;24
77;5;3;Santa Tereza;41025;38616;2409;15;-21;36
77;5;3;Santana;21005;19588;1417;-25;-44;19
77;5;3;Santo Antônio;12958;12090;868;-38;-33;-5
77;5;3;São Caetano;600;406;194;-4;0;-4
77;5;3;São Geraldo;8401;7800;601;-16;-22;6
77;5;3;São João;12243;11355;888;-13;-20;7
77;5;3;São Sebastião;6478;6056;422;-17;-11;-6
77;5;3;Sarandi;62627;58957;3670;-5;-25;20
77;5;3;Serraria;6090;5701;389;-3;-10;7
77;5;3;Sétimo Céu;746;657;89;-10;-3;-7
77;5;3;Teresópolis;14761;13704;1057;-33;-30;-3
77;5;3;Três Figueiras;3402;3028;374;-29;-20;-9
77;5;3;Tristeza;16922;15895;1027;0;-8;8
77;5;3;Vila Assunção;4028;3689;339;-31;-10;-21
77;5;3;Vila Conceição;921;749;172;-11;-10;-1
77;5;3;Vila Ipiranga;18975;17659;1316;-28;-41;13
77;5;3;Vila Jardim;13182;12178;1004;-46;-54;8
77;5;3;Vila João Pessoa;12888;11994;894;-22;-28;6
77;5;3;Vila Nova;33908;31847;2061;-7;-22;15
77;5;3;Vila São José;27483;25731;1752;-25;-39;14
78;6;3;Aberta dos Morros;6638;5881;757;-175;-561;386
78;6;3;Agronomia;1342;1168;174;-386;-501;115
78;6;3;Anchieta;1126;1004;122;-266;-355;89
78;6;3;Arquipélago;8065;7101;964;-93;-565;472
78;6;3;Auxiliadora;8825;7704;1121;-343;-931;588
78;6;3;Azenha;13224;11596;1628;-215;-1034;819
78;6;3;Bela Vista;10991;9604;1387;-317;-1016;699
78;6;3;Belém Novo;10131;9163;968;82;-404;486
78;6;3;Belém Velho;10609;9396;1213;-94;-662;568
78;6;3;Boa Vista;9178;8016;1162;-379;-966;587
78;6;3;Boa Vista do Sul;1486;1391;95;-323;-380;57
78;6;3;Bom Fim;10618;9336;1282;-360;-1025;665
78;6;3;Bom Jesus;30053;26576;3477;694;-953;1647
78;6;3;Camaquã;18143;16146;1997;120;-819;939
78;6;3;Campo Novo;8196;7313;883;-224;-651;427
78;6;3;Cascata;12816;11356;1460;-68;-766;698
78;6;3;Cavalhada;30738;27446;3292;651;-871;1522
78;6;3;Centro;41723;37393;4330;1152;-838;1990
78;6;3;Chácara das Pedras;5179;4529;650;-655;-1005;350
78;6;3;Chapéu do Sol;1882;1751;131;-433;-514;81
78;6;3;Cidade Baixa;15064;13269;1795;-73;-950;877
78;6;3;Coronel Aparício Borges;19419;17188;2231;96;-983;1079
78;6;3;Costa e Silva;15572;13836;1736;-71;-938;867
78;6;3;Cristal;33858;30259;3599;895;-792;1687
78;6;3;Cristo Redentor;16214;14308;1906;-30;-970;940
78;6;3;Espírito Santo;4666;4171;495;-378;-627;249
78;6;3;Extrema;1222;1171;51;-356;-374;18
78;6;3;Farrapos;19759;17649;2110;412;-612;1024
78;6;3;Farroupilha;440;440;0;0;0;0
78;6;3;Floresta;10941;9653;1288;-271;-883;612
78;6;3;Glória;16967;14994;1973;-15;-931;916
78;6;3;Guarujá;3867;3496;371;-396;-564;168
78;6;3;Higienópolis;9928;8710;1218;-349;-922;573
78;6;3;Hípica;19303;17345;1958;354;-583;937
78;6;3;Humaitá;11310;10112;1198;-111;-651;540
78;6;3;Independência;6788;5955;833;-604;-991;387
78;6;3;Ipanema;13713;12252;1461;11;-688;699
78;6;3;Jardim Botânico;11637;10224;1413;-406;-1052;646
78;6;3;Jardim Carvalho;26445;23445;3000;428;-935;1363
78;6;3;Jardim do Salso;2632;2263;369;-829;-1023;194
78;6;3;Jardim Dona Leopoldina;17864;15824;2040;-60;-1037;977
78;6;3;Jardim Europa;1207;1121;86;-78;-159;81
78;6;3;Jardim Floresta;1872;1660;212;-597;-722;125
78;6;3;Jardim Isabel;1529;1435;94;-531;-597;66
78;6;3;Jardim Itu;17884;15781;2103;6;-989;995
78;6;3;Jardim Lindóia;6300;5539;761;-516;-877;361
78;6;3;Jardim Sabará;13049;11497;1552;-250;-975;725
78;6;3;Jardim São Pedro;2436;2099;337;-723;-882;159
78;6;3;Lageado;3680;3362;318;-357;-483;126
78;6;3;Lami;3686;3383;303;-305;-397;92
78;6;3;Lomba do Pinheiro;62957;56740;6217;2189;-684;2873
78;6;3;Mário Quintana;40714;36414;4300;1260;-836;2096
78;6;3;Medianeira;10371;9111;1260;-373;-974;601
78;6;3;Menino Deus;33404;29623;3781;721;-979;1700
78;6;3;Moinhos de Vento;11253;9871;1382;-290;-925;635
78;6;3;MontSerrat;10384;9094;1290;-395;-993;598
78;6;3;Morro Santana;19882;17622;2260;241;-832;1073
78;6;3;Navegantes;3101;2728;373;-569;-745;176
78;6;3;Nonoai;26139;23247;2892;461;-911;1372
78;6;3;Parque Santa Fé;4987;4395;592;-675;-951;276
78;6;3;Partenon;51584;46005;5579;1603;-1055;2658
78;6;3;Passo DAreia;22688;20001;2687;345;-945;1290
78;6;3;Passo das Pedras;15728;13912;1816;-100;-983;883
78;6;3;Pedra Redonda;124;124;0;-19;0;-19
78;6;3;Petrópolis;40011;35362;4649;1180;-1027;2207
78;6;3;Pitinga;3547;3206;341;-401;-537;136
78;6;3;Ponta Grossa;8406;7608;798;-187;-546;359
78;6;3;Praia de Belas;1249;1121;128;-239;-277;38
78;6;3;Restinga;57563;52211;5352;1628;-754;2382
78;6;3;Rio Branco;17437;15316;2121;-57;-1021;964
78;6;3;Rubem Berta;35014;31360;3654;800;-906;1706
78;6;3;Santa Cecília;4101;3574;527;-772;-1000;228
78;6;3;Santa Maria Goretti;2092;1800;292;-724;-791;67
78;6;3;Santa Rosa de Lima;37655;33819;3836;1007;-763;1770
78;6;3;Santa Tereza;42258;37695;4563;1233;-921;2154
78;6;3;Santana;21069;18515;2554;64;-1073;1137
78;6;3;Santo Antônio;12635;11075;1560;-323;-1015;692
78;6;3;São Caetano;532;375;157;-68;-31;-37
78;6;3;São Geraldo;7994;6986;1008;-407;-814;407
78;6;3;São João;11992;10512;1480;-251;-843;592
78;6;3;São Sebastião;5891;5165;726;-587;-891;304
78;6;3;Sarandi;64720;58101;6619;2093;-856;2949
78;6;3;Serraria;5679;5086;593;-411;-615;204
78;6;3;Sétimo Céu;709;651;58;-37;-6;-31
78;6;3;Teresópolis;14459;12710;1749;-302;-994;692
78;6;3;Três Figueiras;2550;2105;445;-852;-923;71
78;6;3;Tristeza;16995;15164;1831;73;-731;804
78;6;3;Vila Assunção;3352;2950;402;-676;-739;63
78;6;3;Vila Conceição;836;670;166;-85;-79;-6
78;6;3;Vila Ipiranga;18974;16662;2312;-1;-997;996
78;6;3;Vila Jardim;12822;11186;1636;-360;-992;632
78;6;3;Vila João Pessoa;12537;10966;1571;-351;-1028;677
78;6;3;Vila Nova;34757;31083;3674;849;-764;1613
78;6;3;Vila São José;27984;24845;3139;501;-886;1387
79;7;3;Aberta dos Morros;6239;4826;1413;-399;-1055;656
79;7;3;Agronomia;1254;920;334;-88;-248;160
79;7;3;Anchieta;1025;771;254;-101;-233;132
79;7;3;Arquipélago;7589;5871;1718;-476;-1230;754
79;7;3;Auxiliadora;8221;6154;2067;-604;-1550;946
79;7;3;Azenha;12501;9334;3167;-723;-2262;1539
79;7;3;Bela Vista;10287;7713;2574;-704;-1891;1187
79;7;3;Belém Novo;10055;8410;1645;-76;-753;677
79;7;3;Belém Velho;10047;7890;2157;-562;-1506;944
79;7;3;Boa Vista;8565;6377;2188;-613;-1639;1026
79;7;3;Boa Vista do Sul;1429;1233;196;-57;-158;101
79;7;3;Bom Fim;9890;7434;2456;-728;-1902;1174
79;7;3;Bom Jesus;30688;24192;6496;635;-2384;3019
79;7;3;Camaquã;17982;14227;3755;-161;-1919;1758
79;7;3;Campo Novo;7721;6096;1625;-475;-1217;742
79;7;3;Cascata;12224;9548;2676;-592;-1808;1216
79;7;3;Cavalhada;31730;25539;6191;992;-1907;2899
79;7;3;Centro;44014;35606;8408;2291;-1787;4078
79;7;3;Chácara das Pedras;4785;3529;1256;-394;-1000;606
79;7;3;Chapéu do Sol;1786;1471;315;-96;-280;184
79;7;3;Cidade Baixa;14348;11117;3231;-716;-2152;1436
79;7;3;Coronel Aparício Borges;19003;14802;4201;-416;-2386;1970
79;7;3;Costa e Silva;14876;11605;3271;-696;-2231;1535
79;7;3;Cristal;35162;28547;6615;1304;-1712;3016
79;7;3;Cristo Redentor;15755;11999;3756;-459;-2309;1850
79;7;3;Espírito Santo;4384;3430;954;-282;-741;459
79;7;3;Extrema;1210;1048;162;-12;-123;111
79;7;3;Farrapos;20080;16252;3828;321;-1397;1718
79;7;3;Farroupilha;325;228;97;-115;-212;97
79;7;3;Floresta;10287;7923;2364;-654;-1730;1076
79;7;3;Glória;16467;12786;3681;-500;-2208;1708
79;7;3;Guarujá;3677;2938;739;-190;-558;368
79;7;3;Higienópolis;9343;7035;2308;-585;-1675;1090
79;7;3;Hípica;19570;16123;3447;267;-1222;1489
79;7;3;Humaitá;10835;8656;2179;-475;-1456;981
79;7;3;Independência;6544;4707;1837;-244;-1248;1004
79;7;3;Ipanema;13504;10867;2637;-209;-1385;1176
79;7;3;Jardim Botânico;11078;8257;2821;-559;-1967;1408
79;7;3;Jardim Carvalho;26841;21373;5468;396;-2072;2468
79;7;3;Jardim do Salso;2403;1506;897;-229;-757;528
79;7;3;Jardim Dona Leopoldina;17134;13393;3741;-730;-2431;1701
79;7;3;Jardim Europa;1197;647;550;-10;-474;464
79;7;3;Jardim Floresta;1696;1114;582;-176;-546;370
79;7;3;Jardim Isabel;1455;1009;446;-74;-426;352
79;7;3;Jardim Itu;17221;13447;3774;-663;-2334;1671
79;7;3;Jardim Lindóia;6073;4440;1633;-227;-1099;872
79;7;3;Jardim Sabará;12268;9454;2814;-781;-2043;1262
79;7;3;Jardim São Pedro;2255;1455;800;-181;-644;463
79;7;3;Lageado;3485;2918;567;-195;-444;249
79;7;3;Lami;3536;3039;497;-150;-344;194
79;7;3;Lomba do Pinheiro;66437;55458;10979;3480;-1282;4762
79;7;3;Mário Quintana;42480;34555;7925;1766;-1859;3625
79;7;3;Medianeira;9725;7371;2354;-646;-1740;1094
79;7;3;Menino Deus;34293;27475;6818;889;-2148;3037
79;7;3;Moinhos de Vento;10789;7987;2802;-464;-1884;1420
79;7;3;MontSerrat;9790;7412;2378;-594;-1682;1088
79;7;3;Morro Santana;19672;15695;3977;-210;-1927;1717
79;7;3;Navegantes;3117;1980;1137;16;-748;764
79;7;3;Nonoai;26500;21214;5286;361;-2033;2394
79;7;3;Parque Santa Fé;4654;3282;1372;-333;-1113;780
79;7;3;Partenon;54134;43624;10510;2550;-2381;4931
79;7;3;Passo DAreia;22739;17775;4964;51;-2226;2277
79;7;3;Passo das Pedras;15014;11684;3330;-714;-2228;1514
79;7;3;Pedra Redonda;82;54;28;-42;-70;28
79;7;3;Petrópolis;41358;33011;8347;1347;-2351;3698
79;7;3;Pitinga;3366;2601;765;-181;-605;424
79;7;3;Ponta Grossa;8027;6686;1341;-379;-922;543
79;7;3;Praia de Belas;1330;703;627;81;-418;499
79;7;3;Restinga;60093;51122;8971;2530;-1089;3619
79;7;3;Rio Branco;16751;12919;3832;-686;-2397;1711
79;7;3;Rubem Berta;36076;29350;6726;1062;-2010;3072
79;7;3;Santa Cecília;3846;2572;1274;-255;-1002;747
79;7;3;Santa Maria Goretti;1945;1206;739;-147;-594;447
79;7;3;Santa Rosa de Lima;38817;32207;6610;1162;-1612;2774
79;7;3;Santa Tereza;44062;35752;8310;1804;-1943;3747
79;7;3;Santana;20765;16131;4634;-304;-2384;2080
79;7;3;Santo Antônio;11895;9131;2764;-740;-1944;1204
79;7;3;São Caetano;494;252;242;-38;-123;85
79;7;3;São Geraldo;7495;5425;2070;-499;-1561;1062
79;7;3;São João;11478;8824;2654;-514;-1688;1174
79;7;3;São Sebastião;5725;3893;1832;-166;-1272;1106
79;7;3;Sarandi;67576;56274;11302;2856;-1827;4683
79;7;3;Serraria;5379;4187;1192;-300;-899;599
79;7;3;Sétimo Céu;581;389;192;-128;-262;134
79;7;3;Teresópolis;13670;10652;3018;-789;-2058;1269
79;7;3;Três Figueiras;2600;1444;1156;50;-661;711
79;7;3;Tristeza;16681;13635;3046;-314;-1529;1215
79;7;3;Vila Assunção;3184;2210;974;-168;-740;572
79;7;3;Vila Conceição;745;431;314;-91;-239;148
79;7;3;Vila Ipiranga;18268;14357;3911;-706;-2305;1599
79;7;3;Vila Jardim;12103;9010;3093;-719;-2176;1457
79;7;3;Vila João Pessoa;11802;8823;2979;-735;-2143;1408
79;7;3;Vila Nova;35619;29494;6125;862;-1589;2451
79;7;3;Vila São José;28150;22702;5448;166;-2143;2309
80;8;3;Aberta dos Morros;6262;5009;1253;23;183;-160
80;8;3;Agronomia;1305;1110;195;51;190;-139
80;8;3;Anchieta;1067;901;166;42;130;-88
80;8;3;Arquipélago;7718;6077;1641;129;206;-77
80;8;3;Auxiliadora;8199;6382;1817;-22;228;-250
80;8;3;Azenha;12339;9696;2643;-162;362;-524
80;8;3;Bela Vista;10291;7990;2301;4;277;-273
80;8;3;Belém Novo;10110;8436;1674;55;26;29
80;8;3;Belém Velho;10153;8042;2111;106;152;-46
80;8;3;Boa Vista;8576;6639;1937;11;262;-251
80;8;3;Boa Vista do Sul;1444;1308;136;15;75;-60
80;8;3;Bom Fim;9954;7792;2162;64;358;-294
80;8;3;Bom Jesus;30900;24369;6531;212;177;35
80;8;3;Camaquã;18072;14390;3682;90;163;-73
80;8;3;Campo Novo;7747;6213;1534;26;117;-91
80;8;3;Cascata;12283;9665;2618;59;117;-58
80;8;3;Cavalhada;31674;25677;5997;-56;138;-194
80;8;3;Centro;44201;35851;8350;187;245;-58
80;8;3;Chácara das Pedras;4791;3806;985;6;277;-271
80;8;3;Chapéu do Sol;1774;1567;207;-12;96;-108
80;8;3;Cidade Baixa;14523;11425;3098;175;308;-133
80;8;3;Coronel Aparício Borges;19141;14966;4175;138;164;-26
80;8;3;Costa e Silva;14975;11783;3192;99;178;-79
80;8;3;Cristal;35290;28661;6629;128;114;14
80;8;3;Cristo Redentor;15649;12267;3382;-106;268;-374
80;8;3;Espírito Santo;4265;3551;714;-119;121;-240
80;8;3;Extrema;1333;1165;168;123;117;6
80;8;3;Farrapos;20281;16444;3837;201;192;9
80;8;3;Farroupilha;200;170;30;-125;-58;-67
80;8;3;Floresta;10338;8124;2214;51;201;-150
80;8;3;Glória;16495;13002;3493;28;216;-188
80;8;3;Guarujá;3581;3022;559;-96;84;-180
80;8;3;Higienópolis;9366;7256;2110;23;221;-198
80;8;3;Hípica;19560;16171;3389;-10;48;-58
80;8;3;Humaitá;11006;8834;2172;171;178;-7
80;8;3;Independência;6261;4948;1313;-283;241;-524
80;8;3;Ipanema;13484;10909;2575;-20;42;-62
80;8;3;Jardim Botânico;10800;8448;2352;-278;191;-469
80;8;3;Jardim Carvalho;26992;21558;5434;151;185;-34
80;8;3;Jardim do Salso;2417;1796;621;14;290;-276
80;8;3;Jardim Dona Leopoldina;17175;13560;3615;41;167;-126
80;8;3;Jardim Europa;841;608;233;-356;-39;-317
80;8;3;Jardim Floresta;1700;1274;426;4;160;-156
80;8;3;Jardim Isabel;1487;1155;332;32;146;-114
80;8;3;Jardim Itu;17279;13632;3647;58;185;-127
80;8;3;Jardim Lindóia;5765;4591;1174;-308;151;-459
80;8;3;Jardim Sabará;12284;9592;2692;16;138;-122
80;8;3;Jardim São Pedro;2293;1721;572;38;266;-228
80;8;3;Lageado;3397;2954;443;-88;36;-124
80;8;3;Lami;3438;3072;366;-98;33;-131
80;8;3;Lomba do Pinheiro;66196;55404;10792;-241;-54;-187
80;8;3;Mário Quintana;42541;34609;7932;61;54;7
80;8;3;Medianeira;9667;7548;2119;-58;177;-235
80;8;3;Menino Deus;34432;27680;6752;139;205;-66
80;8;3;Moinhos de Vento;10506;8165;2341;-283;178;-461
80;8;3;MontSerrat;9748;7593;2155;-42;181;-223
80;8;3;Morro Santana;19739;15807;3932;67;112;-45
80;8;3;Navegantes;2876;2171;705;-241;191;-432
80;8;3;Nonoai;26541;21316;5225;41;102;-61
80;8;3;Parque Santa Fé;4581;3513;1068;-73;231;-304
80;8;3;Partenon;54251;43722;10529;117;98;19
80;8;3;Passo DAreia;22776;17904;4872;37;129;-92
80;8;3;Passo das Pedras;15012;11807;3205;-2;123;-125
80;8;3;Pedra Redonda;52;29;23;-30;-25;-5
80;8;3;Petrópolis;41410;33119;8291;52;108;-56
80;8;3;Pitinga;3316;2695;621;-50;94;-144
80;8;3;Ponta Grossa;7983;6700;1283;-44;14;-58
80;8;3;Praia de Belas;1040;718;322;-290;15;-305
80;8;3;Restinga;60256;51148;9108;163;26;137
80;8;3;Rio Branco;16674;13066;3608;-77;147;-224
80;8;3;Rubem Berta;36000;29415;6585;-76;65;-141
80;8;3;Santa Cecília;3795;2857;938;-51;285;-336
80;8;3;Santa Maria Goretti;2009;1438;571;64;232;-168
80;8;3;Santa Rosa de Lima;38918;32306;6612;101;99;2
80;8;3;Santa Tereza;44050;35859;8191;-12;107;-119
80;8;3;Santana;20742;16321;4421;-23;190;-213
80;8;3;Santo Antônio;11869;9306;2563;-26;175;-201
80;8;3;São Caetano;596;267;329;102;15;87
80;8;3;São Geraldo;7524;5563;1961;29;138;-109
80;8;3;São João;11343;8888;2455;-135;64;-199
80;8;3;São Sebastião;5358;4016;1342;-367;123;-490
80;8;3;Sarandi;67744;56239;11505;168;-35;203
80;8;3;Serraria;5347;4222;1125;-32;35;-67
80;8;3;Sétimo Céu;573;358;215;-8;-31;23
80;8;3;Teresópolis;13692;10757;2935;22;105;-83
80;8;3;Três Figueiras;2539;1745;794;-61;301;-362
80;8;3;Tristeza;16671;13663;3008;-10;28;-38
80;8;3;Vila Assunção;3240;2378;862;56;168;-112
80;8;3;Vila Conceição;881;451;430;136;20;116
80;8;3;Vila Ipiranga;18281;14447;3834;13;90;-77
80;8;3;Vila Jardim;12226;9144;3082;123;134;-11
80;8;3;Vila João Pessoa;11786;8891;2895;-16;68;-84
80;8;3;Vila Nova;35713;29461;6252;94;-33;127
80;8;3;Vila São José;28381;22759;5622;231;57;174
81;9;3;Aberta dos Morros;6241;5000;1241;-21;-9;-12
81;9;3;Agronomia;1275;1098;177;-30;-12;-18
81;9;3;Anchieta;1079;904;175;12;3;9
81;9;3;Arquipélago;7710;6049;1661;-8;-28;20
81;9;3;Auxiliadora;8151;6349;1802;-48;-33;-15
81;9;3;Azenha;12269;9584;2685;-70;-112;42
81;9;3;Bela Vista;10212;7934;2278;-79;-56;-23
81;9;3;Belém Novo;10092;8438;1654;-18;2;-20
81;9;3;Belém Velho;10182;8048;2134;29;6;23
81;9;3;Boa Vista;8538;6612;1926;-38;-27;-11
81;9;3;Boa Vista do Sul;1463;1318;145;19;10;9
81;9;3;Bom Fim;9841;7699;2142;-113;-93;-20
81;9;3;Bom Jesus;31000;24287;6713;100;-82;182
81;9;3;Camaquã;18087;14352;3735;15;-38;53
81;9;3;Campo Novo;7728;6193;1535;-19;-20;1
81;9;3;Cascata;12327;9640;2687;44;-25;69
81;9;3;Cavalhada;31684;25622;6062;10;-55;65
81;9;3;Centro;44442;35797;8645;241;-54;295
81;9;3;Chácara das Pedras;4737;3780;957;-54;-26;-28
81;9;3;Chapéu do Sol;1751;1549;202;-23;-18;-5
81;9;3;Cidade Baixa;14495;11338;3157;-28;-87;59
81;9;3;Coronel Aparício Borges;19190;14898;4292;49;-68;117
81;9;3;Costa e Silva;14984;11710;3274;9;-73;82
81;9;3;Cristal;35342;28611;6731;52;-50;102
81;9;3;Cristo Redentor;15784;12284;3500;135;17;118
81;9;3;Espírito Santo;4276;3553;723;11;2;9
81;9;3;Extrema;1349;1176;173;16;11;5
81;9;3;Farrapos;20292;16423;3869;11;-21;32
81;9;3;Farroupilha;189;189;0;-11;19;-30
81;9;3;Floresta;10352;8066;2286;14;-58;72
81;9;3;Glória;16610;12966;3644;115;-36;151
81;9;3;Guarujá;3597;3021;576;16;-1;17
81;9;3;Higienópolis;9374;7228;2146;8;-28;36
81;9;3;Hípica;19585;16137;3448;25;-34;59
81;9;3;Humaitá;11050;8814;2236;44;-20;64
81;9;3;Independência;6212;4877;1335;-49;-71;22
81;9;3;Ipanema;13523;10902;2621;39;-7;46
81;9;3;Jardim Botânico;10819;8391;2428;19;-57;76
81;9;3;Jardim Carvalho;27150;21527;5623;158;-31;189
81;9;3;Jardim do Salso;2316;1786;530;-101;-10;-91
81;9;3;Jardim Dona Leopoldina;17134;13467;3667;-41;-93;52
81;9;3;Jardim Europa;802;619;183;-39;11;-50
81;9;3;Jardim Floresta;1652;1289;363;-48;15;-63
81;9;3;Jardim Isabel;1512;1191;321;25;36;-11
81;9;3;Jardim Itu;17330;13580;3750;51;-52;103
81;9;3;Jardim Lindóia;5782;4583;1199;17;-8;25
81;9;3;Jardim Sabará;12263;9550;2713;-21;-42;21
81;9;3;Jardim São Pedro;2252;1719;533;-41;-2;-39
81;9;3;Lageado;3394;2964;430;-3;10;-13
81;9;3;Lami;3432;3076;356;-6;4;-10
81;9;3;Lomba do Pinheiro;66380;55394;10986;184;-10;194
81;9;3;Mário Quintana;42572;34523;8049;31;-86;117
81;9;3;Medianeira;9677;7513;2164;10;-35;45
81;9;3;Menino Deus;34525;27573;6952;93;-107;200
81;9;3;Moinhos de Vento;10519;8113;2406;13;-52;65
81;9;3;MontSerrat;9720;7523;2197;-28;-70;42
81;9;3;Morro Santana;19726;15709;4017;-13;-98;85
81;9;3;Navegantes;2857;2163;694;-19;-8;-11
81;9;3;Nonoai;26589;21233;5356;48;-83;131
81;9;3;Parque Santa Fé;4445;3467;978;-136;-46;-90
81;9;3;Partenon;54513;43650;10863;262;-72;334
81;9;3;Passo DAreia;22829;17872;4957;53;-32;85
81;9;3;Passo das Pedras;15052;11708;3344;40;-99;139
81;9;3;Pedra Redonda;51;42;9;-1;13;-14
81;9;3;Petrópolis;41570;32989;8581;160;-130;290
81;9;3;Pitinga;3315;2692;623;-1;-3;2
81;9;3;Ponta Grossa;7985;6688;1297;2;-12;14
81;9;3;Praia de Belas;941;685;256;-99;-33;-66
81;9;3;Restinga;60188;51138;9050;-68;-10;-58
81;9;3;Rio Branco;16719;12957;3762;45;-109;154
81;9;3;Rubem Berta;36150;29345;6805;150;-70;220
81;9;3;Santa Cecília;3688;2814;874;-107;-43;-64
81;9;3;Santa Maria Goretti;1951;1410;541;-58;-28;-30
81;9;3;Santa Rosa de Lima;38992;32256;6736;74;-50;124
81;9;3;Santa Tereza;44141;35777;8364;91;-82;173
81;9;3;Santana;20780;16198;4582;38;-123;161
81;9;3;Santo Antônio;11824;9204;2620;-45;-102;57
81;9;3;São Caetano;587;274;313;-9;7;-16
81;9;3;São Geraldo;7471;5536;1935;-53;-27;-26
81;9;3;São João;11353;8861;2492;10;-27;37
81;9;3;São Sebastião;5286;3991;1295;-72;-25;-47
81;9;3;Sarandi;67705;56147;11558;-39;-92;53
81;9;3;Serraria;5336;4198;1138;-11;-24;13
81;9;3;Sétimo Céu;535;374;161;-38;16;-54
81;9;3;Teresópolis;13594;10656;2938;-98;-101;3
81;9;3;Três Figueiras;2451;1684;767;-88;-61;-27
81;9;3;Tristeza;16699;13692;3007;28;29;-1
81;9;3;Vila Assunção;3147;2350;797;-93;-28;-65
81;9;3;Vila Conceição;830;458;372;-51;7;-58
81;9;3;Vila Ipiranga;18152;14322;3830;-129;-125;-4
81;9;3;Vila Jardim;12131;9069;3062;-95;-75;-20
81;9;3;Vila João Pessoa;11746;8832;2914;-40;-59;19
81;9;3;Vila Nova;35584;29409;6175;-129;-52;-77
81;9;3;Vila São José;28194;22635;5559;-187;-124;-63
82;10;3;Aberta dos Morros;6280;5181;1099;39;181;-142
82;10;3;Agronomia;1451;1174;277;176;76;100
82;10;3;Anchieta;1237;991;246;158;87;71
82;10;3;Arquipélago;7779;6257;1522;69;208;-139
82;10;3;Auxiliadora;8191;6616;1575;40;267;-227
82;10;3;Azenha;12325;9878;2447;56;294;-238
82;10;3;Bela Vista;10252;8225;2027;40;291;-251
82;10;3;Belém Novo;10076;8627;1449;-16;189;-205
82;10;3;Belém Velho;10203;8261;1942;21;213;-192
82;10;3;Boa Vista;8650;6934;1716;112;322;-210
82;10;3;Boa Vista do Sul;1731;1519;212;268;201;67
82;10;3;Bom Fim;9918;8024;1894;77;325;-248
82;10;3;Bom Jesus;30944;24596;6348;-56;309;-365
82;10;3;Camaquã;18020;14574;3446;-67;222;-289
82;10;3;Campo Novo;7791;6463;1328;63;270;-207
82;10;3;Cascata;12267;9873;2394;-60;233;-293
82;10;3;Cavalhada;31730;25748;5982;46;126;-80
82;10;3;Centro;44340;35763;8577;-102;-34;-68
82;10;3;Chácara das Pedras;5151;4173;978;414;393;21
82;10;3;Chapéu do Sol;2068;1761;307;317;212;105
82;10;3;Cidade Baixa;14439;11626;2813;-56;288;-344
82;10;3;Coronel Aparício Borges;19019;15158;3861;-171;260;-431
82;10;3;Costa e Silva;14880;11978;2902;-104;268;-372
82;10;3;Cristal;35166;28717;6449;-176;106;-282
82;10;3;Cristo Redentor;15695;12571;3124;-89;287;-376
82;10;3;Espírito Santo;4517;3787;730;241;234;7
82;10;3;Extrema;1500;1300;200;151;124;27
82;10;3;Farrapos;20235;16552;3683;-57;129;-186
82;10;3;Farroupilha;190;190;0;1;1;0
82;10;3;Floresta;10310;8387;1923;-42;321;-363
82;10;3;Glória;16398;13197;3201;-212;231;-443
82;10;3;Guarujá;3885;3271;614;288;250;38
82;10;3;Higienópolis;9360;7529;1831;-14;301;-315
82;10;3;Hípica;19392;16206;3186;-193;69;-262
82;10;3;Humaitá;11005;8989;2016;-45;175;-220
82;10;3;Independência;6620;5197;1423;408;320;88
82;10;3;Ipanema;13419;11093;2326;-104;191;-295
82;10;3;Jardim Botânico;10896;8737;2159;77;346;-269
82;10;3;Jardim Carvalho;26867;21660;5207;-283;133;-416
82;10;3;Jardim do Salso;2726;2162;564;410;376;34
82;10;3;Jardim Dona Leopoldina;16929;13716;3213;-205;249;-454
82;10;3;Jardim Europa;965;646;319;163;27;136
82;10;3;Jardim Floresta;1958;1543;415;306;254;52
82;10;3;Jardim Isabel;1784;1425;359;272;234;38
82;10;3;Jardim Itu;17178;13808;3370;-152;228;-380
82;10;3;Jardim Lindóia;6082;4830;1252;300;247;53
82;10;3;Jardim Sabará;12295;9895;2400;32;345;-313
82;10;3;Jardim São Pedro;2538;2014;524;286;295;-9
82;10;3;Lageado;3603;3162;441;209;198;11
82;10;3;Lami;3654;3249;405;222;173;49
82;10;3;Lomba do Pinheiro;65998;55308;10690;-382;-86;-296
82;10;3;Mário Quintana;42153;34648;7505;-419;125;-544
82;10;3;Medianeira;9655;7855;1800;-22;342;-364
82;10;3;Menino Deus;34156;27637;6519;-369;64;-433
82;10;3;Moinhos de Vento;10478;8347;2131;-41;234;-275
82;10;3;MontSerrat;9715;7869;1846;-5;346;-351
82;10;3;Morro Santana;19541;15834;3707;-185;125;-310
82;10;3;Navegantes;3277;2428;849;420;265;155
82;10;3;Nonoai;26400;21389;5011;-189;156;-345
82;10;3;Parque Santa Fé;4608;3703;905;163;236;-73
82;10;3;Partenon;54243;43783;10460;-270;133;-403
82;10;3;Passo DAreia;22675;18108;4567;-154;236;-390
82;10;3;Passo das Pedras;14881;11919;2962;-171;211;-382
82;10;3;Pedra Redonda;44;40;4;-7;-2;-5
82;10;3;Petrópolis;41320;33171;8149;-250;182;-432
82;10;3;Pitinga;3493;2838;655;178;146;32
82;10;3;Ponta Grossa;7914;6864;1050;-71;176;-247
82;10;3;Praia de Belas;1186;783;403;245;98;147
82;10;3;Restinga;59222;50984;8238;-966;-154;-812
82;10;3;Rio Branco;16547;13236;3311;-172;279;-451
82;10;3;Rubem Berta;35816;29368;6448;-334;23;-357
82;10;3;Santa Cecília;4054;3181;873;366;367;-1
82;10;3;Santa Maria Goretti;2203;1695;508;252;285;-33
82;10;3;Santa Rosa de Lima;38670;32205;6465;-322;-51;-271
82;10;3;Santa Tereza;43868;35842;8026;-273;65;-338
82;10;3;Santana;20573;16440;4133;-207;242;-449
82;10;3;Santo Antônio;11800;9486;2314;-24;282;-306
82;10;3;São Caetano;483;272;211;-104;-2;-102
82;10;3;São Geraldo;7444;5832;1612;-27;296;-323
82;10;3;São João;11478;9156;2322;125;295;-170
82;10;3;São Sebastião;5587;4276;1311;301;285;16
82;10;3;Sarandi;67653;56216;11437;-52;69;-121
82;10;3;Serraria;5388;4418;970;52;220;-168
82;10;3;Sétimo Céu;498;365;133;-37;-9;-28
82;10;3;Teresópolis;13422;10873;2549;-172;217;-389
82;10;3;Três Figueiras;2847;2008;839;396;324;72
82;10;3;Tristeza;16585;13866;2719;-114;174;-288
82;10;3;Vila Assunção;3399;2620;779;252;270;-18
82;10;3;Vila Conceição;737;492;245;-93;34;-127
82;10;3;Vila Ipiranga;18079;14542;3537;-73;220;-293
82;10;3;Vila Jardim;12158;9450;2708;27;381;-354
82;10;3;Vila João Pessoa;11693;9210;2483;-53;378;-431
82;10;3;Vila Nova;35311;29503;5808;-273;94;-367
82;10;3;Vila São José;28190;22896;5294;-4;261;-265
83;11;3;Aberta dos Morros;6631;6090;541;351;909;-558
83;11;3;Agronomia;1414;1298;116;-37;124;-161
83;11;3;Anchieta;1171;1081;90;-66;90;-156
83;11;3;Arquipélago;8224;7304;920;445;1047;-602
83;11;3;Auxiliadora;8558;7902;656;367;1286;-919
83;11;3;Azenha;12996;11864;1132;671;1986;-1315
83;11;3;Bela Vista;10753;9779;974;501;1554;-1053
83;11;3;Belém Novo;10133;9298;835;57;671;-614
83;11;3;Belém Velho;10712;9571;1141;509;1310;-801
83;11;3;Boa Vista;8983;8264;719;333;1330;-997
83;11;3;Boa Vista do Sul;1732;1626;106;1;107;-106
83;11;3;Bom Fim;10328;9547;781;410;1523;-1113
83;11;3;Bom Jesus;30488;26554;3934;-456;1958;-2414
83;11;3;Camaquã;18175;16181;1994;155;1607;-1452
83;11;3;Campo Novo;8181;7488;693;390;1025;-635
83;11;3;Cascata;12832;11411;1421;565;1538;-973
83;11;3;Cavalhada;31052;27355;3697;-678;1607;-2285
83;11;3;Centro;42559;37288;5271;-1781;1525;-3306
83;11;3;Chácara das Pedras;5235;4861;374;84;688;-604
83;11;3;Chapéu do Sol;2080;1948;132;12;187;-175
83;11;3;Cidade Baixa;14939;13400;1539;500;1774;-1274
83;11;3;Coronel Aparício Borges;19345;17087;2258;326;1929;-1603
83;11;3;Costa e Silva;15453;13811;1642;573;1833;-1260
83;11;3;Cristal;34238;30145;4093;-928;1428;-2356
83;11;3;Cristo Redentor;16228;14459;1769;533;1888;-1355
83;11;3;Espírito Santo;4694;4345;349;177;558;-381
83;11;3;Extrema;1495;1395;100;-5;95;-100
83;11;3;Farrapos;20034;17746;2288;-201;1194;-1395
83;11;3;Farroupilha;271;271;0;81;81;0
83;11;3;Floresta;10787;9748;1039;477;1361;-884
83;11;3;Glória;16823;15020;1803;425;1823;-1398
83;11;3;Guarujá;3983;3692;291;98;421;-323
83;11;3;Higienópolis;9716;8832;884;356;1303;-947
83;11;3;Hípica;19281;17234;2047;-111;1028;-1139
83;11;3;Humaitá;11407;10210;1197;402;1221;-819
83;11;3;Independência;6844;6124;720;224;927;-703
83;11;3;Ipanema;13584;12254;1330;165;1161;-996
83;11;3;Jardim Botânico;11385;10340;1045;489;1603;-1114
83;11;3;Jardim Carvalho;26619;23329;3290;-248;1669;-1917
83;11;3;Jardim do Salso;2778;2575;203;52;413;-361
83;11;3;Jardim Dona Leopoldina;17479;15618;1861;550;1902;-1352
83;11;3;Jardim Europa;1183;868;315;218;222;-4
83;11;3;Jardim Floresta;1973;1868;105;15;325;-310
83;11;3;Jardim Isabel;1785;1677;108;1;252;-251
83;11;3;Jardim Itu;17752;15720;2032;574;1912;-1338
83;11;3;Jardim Lindóia;6314;5643;671;232;813;-581
83;11;3;Jardim Sabará;12883;11491;1392;588;1596;-1008
83;11;3;Jardim São Pedro;2545;2356;189;7;342;-335
83;11;3;Lageado;3704;3490;214;101;328;-227
83;11;3;Lami;3771;3549;222;117;300;-183
83;11;3;Lomba do Pinheiro;63357;56454;6903;-2641;1146;-3787
83;11;3;Mário Quintana;40873;36170;4703;-1280;1522;-2802
83;11;3;Medianeira;10105;9187;918;450;1332;-882
83;11;3;Menino Deus;33490;29376;4114;-666;1739;-2405
83;11;3;Moinhos de Vento;10985;9863;1122;507;1516;-1009
83;11;3;MontSerrat;10098;9135;963;383;1266;-883
83;11;3;Morro Santana;19804;17415;2389;263;1581;-1318
83;11;3;Navegantes;3425;2925;500;148;497;-349
83;11;3;Nonoai;26105;23033;3072;-295;1644;-1939
83;11;3;Parque Santa Fé;4796;4442;354;188;739;-551
83;11;3;Partenon;52304;45750;6554;-1939;1967;-3906
83;11;3;Passo DAreia;22593;19844;2749;-82;1736;-1818
83;11;3;Passo das Pedras;15462;13697;1765;581;1778;-1197
83;11;3;Pedra Redonda;64;64;0;20;24;-4
83;11;3;Petrópolis;40196;35042;5154;-1124;1871;-2995
83;11;3;Pitinga;3586;3325;261;93;487;-394
83;11;3;Ponta Grossa;8241;7651;590;327;787;-460
83;11;3;Praia de Belas;1342;969;373;156;186;-30
83;11;3;Restinga;57298;51935;5363;-1924;951;-2875
83;11;3;Rio Branco;17021;15090;1931;474;1854;-1380
83;11;3;Rubem Berta;35029;30950;4079;-787;1582;-2369
83;11;3;Santa Cecília;4156;3771;385;102;590;-488
83;11;3;Santa Maria Goretti;2179;1982;197;-24;287;-311
83;11;3;Santa Rosa de Lima;37804;33537;4267;-866;1332;-2198
83;11;3;Santa Tereza;42541;37438;5103;-1327;1596;-2923
83;11;3;Santana;20822;18325;2497;249;1885;-1636
83;11;3;Santo Antônio;12325;10986;1339;525;1500;-975
83;11;3;São Caetano;506;346;160;23;74;-51
83;11;3;São Geraldo;7747;7009;738;303;1177;-874
83;11;3;São João;11981;10409;1572;503;1253;-750
83;11;3;São Sebastião;5846;5193;653;259;917;-658
83;11;3;Sarandi;65357;57574;7783;-2296;1358;-3654
83;11;3;Serraria;5601;5144;457;213;726;-513
83;11;3;Sétimo Céu;547;491;56;49;126;-77
83;11;3;Teresópolis;14103;12542;1561;681;1669;-988
83;11;3;Três Figueiras;2889;2283;606;42;275;-233
83;11;3;Tristeza;16766;15021;1745;181;1155;-974
83;11;3;Vila Assunção;3522;3139;383;123;519;-396
83;11;3;Vila Conceição;760;597;163;23;105;-82
83;11;3;Vila Ipiranga;18611;16306;2305;532;1764;-1232
83;11;3;Vila Jardim;12704;11144;1560;546;1694;-1148
83;11;3;Vila João Pessoa;12295;10923;1372;602;1713;-1111
83;11;3;Vila Nova;34635;30761;3874;-676;1258;-1934
83;11;3;Vila São José;27950;24580;3370;-240;1684;-1924
84;12;3;Aberta dos Morros;6531;5559;972;-100;-531;431
84;12;3;Agronomia;1360;1133;227;-54;-165;111
84;12;3;Anchieta;1125;950;175;-46;-131;85
84;12;3;Arquipélago;8039;6728;1311;-185;-576;391
84;12;3;Auxiliadora;8366;7000;1366;-192;-902;710
84;12;3;Azenha;12889;10898;1991;-107;-966;859
84;12;3;Bela Vista;10438;8753;1685;-315;-1026;711
84;12;3;Belém Novo;10214;8944;1270;81;-354;435
84;12;3;Belém Velho;10595;8924;1671;-117;-647;530
84;12;3;Boa Vista;8751;7369;1382;-232;-895;663
84;12;3;Boa Vista do Sul;1548;1437;111;-184;-189;5
84;12;3;Bom Fim;10198;8604;1594;-130;-943;813
84;12;3;Bom Jesus;31156;25609;5547;668;-945;1613
84;12;3;Camaquã;18304;15489;2815;129;-692;821
84;12;3;Campo Novo;7992;6876;1116;-189;-612;423
84;12;3;Cascata;12621;10636;1985;-211;-775;564
84;12;3;Cavalhada;31803;26761;5042;751;-594;1345
84;12;3;Centro;44067;36664;7403;1508;-624;2132
84;12;3;Chácara das Pedras;5073;4273;800;-162;-588;426
84;12;3;Chapéu do Sol;1938;1784;154;-142;-164;22
84;12;3;Cidade Baixa;14723;12556;2167;-216;-844;628
84;12;3;Coronel Aparício Borges;19394;16183;3211;49;-904;953
84;12;3;Costa e Silva;15156;12855;2301;-297;-956;659
84;12;3;Cristal;34928;29399;5529;690;-746;1436
84;12;3;Cristo Redentor;15905;13598;2307;-323;-861;538
84;12;3;Espírito Santo;4381;3845;536;-313;-500;187
84;12;3;Extrema;1322;1229;93;-173;-166;-7
84;12;3;Farrapos;20403;17135;3268;369;-611;980
84;12;3;Farroupilha;227;175;52;-44;-96;52
84;12;3;Floresta;10493;8928;1565;-294;-820;526
84;12;3;Glória;16615;14114;2501;-208;-906;698
84;12;3;Guarujá;3705;3235;470;-278;-457;179
84;12;3;Higienópolis;9372;7903;1469;-344;-929;585
84;12;3;Hípica;19430;16685;2745;149;-549;698
84;12;3;Humaitá;11236;9572;1664;-171;-638;467
84;12;3;Independência;6536;5462;1074;-308;-662;354
84;12;3;Ipanema;13427;11577;1850;-157;-677;520
84;12;3;Jardim Botânico;11031;9349;1682;-354;-991;637
84;12;3;Jardim Carvalho;26882;22453;4429;263;-876;1139
84;12;3;Jardim do Salso;2787;2225;562;9;-350;359
84;12;3;Jardim Dona Leopoldina;17200;14613;2587;-279;-1005;726
84;12;3;Jardim Europa;910;678;232;-273;-190;-83
84;12;3;Jardim Floresta;1921;1571;350;-52;-297;245
84;12;3;Jardim Isabel;1620;1355;265;-165;-322;157
84;12;3;Jardim Itu;17372;14653;2719;-380;-1067;687
84;12;3;Jardim Lindóia;5955;5026;929;-359;-617;258
84;12;3;Jardim Sabará;12338;10460;1878;-545;-1031;486
84;12;3;Jardim São Pedro;2530;2028;502;-15;-328;313
84;12;3;Lageado;3424;3088;336;-280;-402;122
84;12;3;Lami;3522;3211;311;-249;-338;89
84;12;3;Lomba do Pinheiro;65213;55668;9545;1856;-786;2642
84;12;3;Mário Quintana;41826;35264;6562;953;-906;1859
84;12;3;Medianeira;9769;8261;1508;-336;-926;590
84;12;3;Menino Deus;34049;28570;5479;559;-806;1365
84;12;3;Moinhos de Vento;10652;8995;1657;-333;-868;535
84;12;3;MontSerrat;9759;8219;1540;-339;-916;577
84;12;3;Morro Santana;19808;16631;3177;4;-784;788
84;12;3;Navegantes;3171;2515;656;-254;-410;156
84;12;3;Nonoai;26393;22159;4234;288;-874;1162
84;12;3;Parque Santa Fé;4625;3868;757;-171;-574;403
84;12;3;Partenon;53714;44677;9037;1410;-1073;2483
84;12;3;Passo DAreia;22585;18892;3693;-8;-952;944
84;12;3;Passo das Pedras;15058;12804;2254;-404;-893;489
84;12;3;Pedra Redonda;51;19;32;-13;-45;32
84;12;3;Petrópolis;40886;33928;6958;690;-1114;1804
84;12;3;Pitinga;3360;2979;381;-226;-346;120
84;12;3;Ponta Grossa;8090;7156;934;-151;-495;344
84;12;3;Praia de Belas;1081;747;334;-261;-222;-39
84;12;3;Restinga;58636;51014;7622;1338;-921;2259
84;12;3;Rio Branco;16652;14083;2569;-369;-1007;638
84;12;3;Rubem Berta;35347;30027;5320;318;-923;1241
84;12;3;Santa Cecília;4019;3196;823;-137;-575;438
84;12;3;Santa Maria Goretti;2122;1613;509;-57;-369;312
84;12;3;Santa Rosa de Lima;38463;32710;5753;659;-827;1486
84;12;3;Santa Tereza;43438;36386;7052;897;-1052;1949
84;12;3;Santana;20328;17255;3073;-494;-1070;576
84;12;3;Santo Antônio;11880;10010;1870;-445;-976;531
84;12;3;São Caetano;559;249;310;53;-97;150
84;12;3;São Geraldo;7481;6259;1222;-266;-750;484
84;12;3;São João;11380;9631;1749;-601;-778;177
84;12;3;São Sebastião;5588;4511;1077;-258;-682;424
84;12;3;Sarandi;67012;56700;10312;1655;-874;2529
84;12;3;Serraria;5336;4572;764;-265;-572;307
84;12;3;Sétimo Céu;560;362;198;13;-129;142
84;12;3;Teresópolis;13610;11567;2043;-493;-975;482
84;12;3;Três Figueiras;2639;1922;717;-250;-361;111
84;12;3;Tristeza;16521;14242;2279;-245;-779;534
84;12;3;Vila Assunção;3425;2685;740;-97;-454;357
84;12;3;Vila Conceição;815;422;393;55;-175;230
84;12;3;Vila Ipiranga;18293;15356;2937;-318;-950;632
84;12;3;Vila Jardim;12176;10155;2021;-528;-989;461
84;12;3;Vila João Pessoa;11743;9909;1834;-552;-1014;462
84;12;3;Vila Nova;35177;29863;5314;542;-898;1440
84;12;3;Vila São José;28308;23607;4701;358;-973;1331
85;13;3;Aberta dos Morros;6474;5522;952;-57;-37;-20
85;13;3;Agronomia;1303;1117;186;-57;-16;-41
85;13;3;Anchieta;1084;935;149;-41;-15;-26
85;13;3;Arquipélago;8048;6714;1334;9;-14;23
85;13;3;Auxiliadora;8273;7008;1265;-93;8;-101
85;13;3;Azenha;12711;10827;1884;-178;-71;-107
85;13;3;Bela Vista;10271;8723;1548;-167;-30;-137
85;13;3;Belém Novo;10234;8938;1296;20;-6;26
85;13;3;Belém Velho;10562;8856;1706;-33;-68;35
85;13;3;Boa Vista;8584;7326;1258;-167;-43;-124
85;13;3;Boa Vista do Sul;1546;1428;118;-2;-9;7
85;13;3;Bom Fim;9976;8523;1453;-222;-81;-141
85;13;3;Bom Jesus;31262;25503;5759;106;-106;212
85;13;3;Camaquã;18297;15408;2889;-7;-81;74
85;13;3;Campo Novo;7938;6815;1123;-54;-61;7
85;13;3;Cascata;12575;10541;2034;-46;-95;49
85;13;3;Cavalhada;32019;26652;5367;216;-109;325
85;13;3;Centro;44411;36611;7800;344;-53;397
85;13;3;Chácara das Pedras;4913;4216;697;-160;-57;-103
85;13;3;Chapéu do Sol;1889;1755;134;-49;-29;-20
85;13;3;Cidade Baixa;14666;12413;2253;-57;-143;86
85;13;3;Coronel Aparício Borges;19305;16010;3295;-89;-173;84
85;13;3;Costa e Silva;15078;12741;2337;-78;-114;36
85;13;3;Cristal;35125;29295;5830;197;-104;301
85;13;3;Cristo Redentor;15942;13611;2331;37;13;24
85;13;3;Espírito Santo;4340;3791;549;-41;-54;13
85;13;3;Extrema;1327;1228;99;5;-1;6
85;13;3;Farrapos;20488;17102;3386;85;-33;118
85;13;3;Farroupilha;154;154;0;-73;-21;-52
85;13;3;Floresta;10430;8837;1593;-63;-91;28
85;13;3;Glória;16605;13974;2631;-10;-140;130
85;13;3;Guarujá;3672;3204;468;-33;-31;-2
85;13;3;Higienópolis;9287;7831;1456;-85;-72;-13
85;13;3;Hípica;19514;16651;2863;84;-34;118
85;13;3;Humaitá;11323;9565;1758;87;-7;94
85;13;3;Independência;6455;5399;1056;-81;-63;-18
85;13;3;Ipanema;13483;11552;1931;56;-25;81
85;13;3;Jardim Botânico;10831;9196;1635;-200;-153;-47
85;13;3;Jardim Carvalho;27050;22343;4707;168;-110;278
85;13;3;Jardim do Salso;2599;2167;432;-188;-58;-130
85;13;3;Jardim Dona Leopoldina;17085;14438;2647;-115;-175;60
85;13;3;Jardim Europa;928;681;247;18;3;15
85;13;3;Jardim Floresta;1812;1572;240;-109;1;-110
85;13;3;Jardim Isabel;1602;1322;280;-18;-33;15
85;13;3;Jardim Itu;17403;14539;2864;31;-114;145
85;13;3;Jardim Lindóia;5902;5003;899;-53;-23;-30
85;13;3;Jardim Sabará;12343;10367;1976;5;-93;98
85;13;3;Jardim São Pedro;2353;1985;368;-177;-43;-134
85;13;3;Lageado;3414;3078;336;-10;-10;0
85;13;3;Lami;3509;3211;298;-13;0;-13
85;13;3;Lomba do Pinheiro;65488;55652;9836;275;-16;291
85;13;3;Mário Quintana;41891;35107;6784;65;-157;222
85;13;3;Medianeira;9654;8103;1551;-115;-158;43
85;13;3;Menino Deus;34376;28433;5943;327;-137;464
85;13;3;Moinhos de Vento;10601;8927;1674;-51;-68;17
85;13;3;MontSerrat;9719;8107;1612;-40;-112;72
85;13;3;Morro Santana;19829;16478;3351;21;-153;174
85;13;3;Navegantes;3110;2471;639;-61;-44;-17
85;13;3;Nonoai;26480;21979;4501;87;-180;267
85;13;3;Parque Santa Fé;4456;3731;725;-169;-137;-32
85;13;3;Partenon;54263;44543;9720;549;-134;683
85;13;3;Passo DAreia;22754;18788;3966;169;-104;273
85;13;3;Passo das Pedras;15028;12619;2409;-30;-185;155
85;13;3;Pedra Redonda;22;19;3;-29;0;-29
85;13;3;Petrópolis;41206;33784;7422;320;-144;464
85;13;3;Pitinga;3329;2955;374;-31;-24;-7
85;13;3;Ponta Grossa;8067;7135;932;-23;-21;-2
85;13;3;Praia de Belas;1016;717;299;-65;-30;-35
85;13;3;Restinga;58834;50982;7852;198;-32;230
85;13;3;Rio Branco;16819;14000;2819;167;-83;250
85;13;3;Rubem Berta;35512;29888;5624;165;-139;304
85;13;3;Santa Cecília;3793;3076;717;-226;-120;-106
85;13;3;Santa Maria Goretti;1979;1573;406;-143;-40;-103
85;13;3;Santa Rosa de Lima;38656;32630;6026;193;-80;273
85;13;3;Santa Tereza;43630;36244;7386;192;-142;334
85;13;3;Santana;20462;17108;3354;134;-147;281
85;13;3;Santo Antônio;11829;9837;1992;-51;-173;122
85;13;3;São Caetano;531;246;285;-28;-3;-25
85;13;3;São Geraldo;7473;6185;1288;-8;-74;66
85;13;3;São João;11384;9596;1788;4;-35;39
85;13;3;São Sebastião;5520;4485;1035;-68;-26;-42
85;13;3;Sarandi;67376;56614;10762;364;-86;450
85;13;3;Serraria;5334;4545;789;-2;-27;25
85;13;3;Sétimo Céu;506;370;136;-54;8;-62
85;13;3;Teresópolis;13623;11417;2206;13;-150;163
85;13;3;Três Figueiras;2385;1827;558;-254;-95;-159
85;13;3;Tristeza;16580;14243;2337;59;1;58
85;13;3;Vila Assunção;3289;2620;669;-136;-65;-71
85;13;3;Vila Conceição;778;433;345;-37;11;-48
85;13;3;Vila Ipiranga;18305;15229;3076;12;-127;139
85;13;3;Vila Jardim;12103;10008;2095;-73;-147;74
85;13;3;Vila João Pessoa;11663;9737;1926;-80;-172;92
85;13;3;Vila Nova;35102;29747;5355;-75;-116;41
85;13;3;Vila São José;28201;23409;4792;-107;-198;91
86;14;3;Aberta dos Morros;6582;5574;1008;108;52;56
86;14;3;Agronomia;1472;1217;255;169;100;69
86;14;3;Anchieta;1243;1043;200;159;108;51
86;14;3;Arquipélago;8015;6751;1264;-33;37;-70
86;14;3;Auxiliadora;8470;7110;1360;197;102;95
86;14;3;Azenha;12792;10977;1815;81;150;-69
86;14;3;Bela Vista;10498;8830;1668;227;107;120
86;14;3;Belém Novo;10305;9036;1269;71;98;-27
86;14;3;Belém Velho;10600;8965;1635;38;109;-71
86;14;3;Boa Vista;8824;7427;1397;240;101;139
86;14;3;Boa Vista do Sul;1736;1542;194;190;114;76
86;14;3;Bom Fim;10298;8685;1613;322;162;160
86;14;3;Bom Jesus;30911;25633;5278;-351;130;-481
86;14;3;Camaquã;18185;15525;2660;-112;117;-229
86;14;3;Campo Novo;8115;6916;1199;177;101;76
86;14;3;Cascata;12608;10652;1956;33;111;-78
86;14;3;Cavalhada;31610;26866;4744;-409;214;-623
86;14;3;Centro;43905;36696;7209;-506;85;-591
86;14;3;Chácara das Pedras;5156;4346;810;243;130;113
86;14;3;Chapéu do Sol;2113;1871;242;224;116;108
86;14;3;Cidade Baixa;14831;12566;2265;165;153;12
86;14;3;Coronel Aparício Borges;19144;16161;2983;-161;151;-312
86;14;3;Costa e Silva;15068;12857;2211;-10;116;-126
86;14;3;Cristal;34686;29297;5389;-439;2;-441
86;14;3;Cristo Redentor;16346;13854;2492;404;243;161
86;14;3;Espírito Santo;4562;3917;645;222;126;96
86;14;3;Extrema;1511;1379;132;184;151;33
86;14;3;Farrapos;20134;17115;3019;-354;13;-367
86;14;3;Farroupilha;164;164;0;10;10;0
86;14;3;Floresta;10656;9000;1656;226;163;63
86;14;3;Glória;16640;14049;2591;35;75;-40
86;14;3;Guarujá;3881;3326;555;209;122;87
86;14;3;Higienópolis;9531;7988;1543;244;157;87
86;14;3;Hípica;19005;16643;2362;-509;-8;-501
86;14;3;Humaitá;11185;9622;1563;-138;57;-195
86;14;3;Independência;6776;5638;1138;321;239;82
86;14;3;Ipanema;13506;11680;1826;23;128;-105
86;14;3;Jardim Botânico;11135;9444;1691;304;248;56
86;14;3;Jardim Carvalho;26526;22402;4124;-524;59;-583
86;14;3;Jardim do Salso;2772;2296;476;173;129;44
86;14;3;Jardim Dona Leopoldina;17168;14643;2525;83;205;-122
86;14;3;Jardim Europa;954;787;167;26;106;-80
86;14;3;Jardim Floresta;2022;1733;289;210;161;49
86;14;3;Jardim Isabel;1832;1503;329;230;181;49
86;14;3;Jardim Itu;17348;14701;2647;-55;162;-217
86;14;3;Jardim Lindóia;6181;5238;943;279;235;44
86;14;3;Jardim Sabará;12487;10508;1979;144;141;3
86;14;3;Jardim São Pedro;2558;2152;406;205;167;38
86;14;3;Lageado;3650;3257;393;236;179;57
86;14;3;Lami;3755;3383;372;246;172;74
86;14;3;Lomba do Pinheiro;64872;55625;9247;-616;-27;-589
86;14;3;Mário Quintana;41368;35100;6268;-523;-7;-516
86;14;3;Medianeira;9826;8256;1570;172;153;19
86;14;3;Menino Deus;33816;28406;5410;-560;-27;-533
86;14;3;Moinhos de Vento;10900;9159;1741;299;232;67
86;14;3;MontSerrat;9868;8287;1581;149;180;-31
86;14;3;Morro Santana;19471;16577;2894;-358;99;-457
86;14;3;Navegantes;3354;2664;690;244;193;51
86;14;3;Nonoai;25918;22000;3918;-562;21;-583
86;14;3;Parque Santa Fé;4698;3929;769;242;198;44
86;14;3;Partenon;53401;44473;8928;-862;-70;-792
86;14;3;Passo DAreia;22414;18958;3456;-340;170;-510
86;14;3;Passo das Pedras;15016;12787;2229;-12;168;-180
86;14;3;Pedra Redonda;18;14;4;-4;-5;1
86;14;3;Petrópolis;40635;33836;6799;-571;52;-623
86;14;3;Pitinga;3556;3094;462;227;139;88
86;14;3;Ponta Grossa;8274;7301;973;207;166;41
86;14;3;Praia de Belas;1100;908;192;84;191;-107
86;14;3;Restinga;58384;50904;7480;-450;-78;-372
86;14;3;Rio Branco;16906;14185;2721;87;185;-98
86;14;3;Rubem Berta;35163;29884;5279;-349;-4;-345
86;14;3;Santa Cecília;3984;3262;722;191;186;5
86;14;3;Santa Maria Goretti;2207;1799;408;228;226;2
86;14;3;Santa Rosa de Lima;38180;32618;5562;-476;-12;-464
86;14;3;Santa Tereza;43055;36260;6795;-575;16;-591
86;14;3;Santana;20421;17201;3220;-41;93;-134
86;14;3;Santo Antônio;12018;9999;2019;189;162;27
86;14;3;São Caetano;474;292;182;-57;46;-103
86;14;3;São Geraldo;7650;6351;1299;177;166;11
86;14;3;São João;11666;9816;1850;282;220;62
86;14;3;São Sebastião;5742;4776;966;222;291;-69
86;14;3;Sarandi;67057;56815;10242;-319;201;-520
86;14;3;Serraria;5544;4788;756;210;243;-33
86;14;3;Sétimo Céu;508;402;106;2;32;-30
86;14;3;Teresópolis;13750;11545;2205;127;128;-1
86;14;3;Três Figueiras;2610;2092;518;225;265;-40
86;14;3;Tristeza;16509;14330;2179;-71;87;-158
86;14;3;Vila Assunção;3498;2792;706;209;172;37
86;14;3;Vila Conceição;757;530;227;-21;97;-118
86;14;3;Vila Ipiranga;18313;15430;2883;8;201;-193
86;14;3;Vila Jardim;12265;10160;2105;162;152;10
86;14;3;Vila João Pessoa;11780;9858;1922;117;121;-4
86;14;3;Vila Nova;34921;29946;4975;-181;199;-380
86;14;3;Vila São José;28032;23526;4506;-169;117;-286
87;15;3;Aberta dos Morros;6534;5553;981;-48;-21;-27
87;15;3;Agronomia;1399;1208;191;-73;-9;-64
87;15;3;Anchieta;1158;1042;116;-85;-1;-84
87;15;3;Arquipélago;8089;6758;1331;74;7;67
87;15;3;Auxiliadora;8322;7180;1142;-148;70;-218
87;15;3;Azenha;12332;10977;1355;-460;0;-460
87;15;3;Bela Vista;10354;8885;1469;-144;55;-199
87;15;3;Belém Novo;10295;9016;1279;-10;-20;10
87;15;3;Belém Velho;10648;8979;1669;48;14;34
87;15;3;Boa Vista;8662;7457;1205;-162;30;-192
87;15;3;Boa Vista do Sul;1718;1532;186;-18;-10;-8
87;15;3;Bom Fim;10166;8766;1400;-132;81;-213
87;15;3;Bom Jesus;31131;25641;5490;220;8;212
87;15;3;Camaquã;18170;15589;2581;-15;64;-79
87;15;3;Campo Novo;8122;6922;1200;7;6;1
87;15;3;Cascata;12619;10656;1963;11;4;7
87;15;3;Cavalhada;31611;26835;4776;1;-31;32
87;15;3;Centro;44153;36805;7348;248;109;139
87;15;3;Chácara das Pedras;4981;4372;609;-175;26;-201
87;15;3;Chapéu do Sol;2077;1864;213;-36;-7;-29
87;15;3;Cidade Baixa;14865;12587;2278;34;21;13
87;15;3;Coronel Aparício Borges;19117;16107;3010;-27;-54;27
87;15;3;Costa e Silva;15076;12887;2189;8;30;-22
87;15;3;Cristal;34859;29204;5655;173;-93;266
87;15;3;Cristo Redentor;16052;13909;2143;-294;55;-349
87;15;3;Espírito Santo;4536;3895;641;-26;-22;-4
87;15;3;Extrema;1502;1373;129;-9;-6;-3
87;15;3;Farrapos;20325;17127;3198;191;12;179
87;15;3;Farroupilha;167;167;0;3;3;0
87;15;3;Floresta;10714;9075;1639;58;75;-17
87;15;3;Glória;16651;13996;2655;11;-53;64
87;15;3;Guarujá;3855;3308;547;-26;-18;-8
87;15;3;Higienópolis;9530;8047;1483;-1;59;-60
87;15;3;Hípica;19080;16604;2476;75;-39;114
87;15;3;Humaitá;11268;9613;1655;83;-9;92
87;15;3;Independência;6470;5702;768;-306;64;-370
87;15;3;Ipanema;13519;11629;1890;13;-51;64
87;15;3;Jardim Botânico;10787;9443;1344;-348;-1;-347
87;15;3;Jardim Carvalho;26752;22306;4446;226;-96;322
87;15;3;Jardim do Salso;2596;2277;319;-176;-19;-157
87;15;3;Jardim Dona Leopoldina;17101;14607;2494;-67;-36;-31
87;15;3;Jardim Europa;990;812;178;36;25;11
87;15;3;Jardim Floresta;1904;1782;122;-118;49;-167
87;15;3;Jardim Isabel;1726;1482;244;-106;-21;-85
87;15;3;Jardim Itu;17364;14747;2617;16;46;-30
87;15;3;Jardim Lindóia;5894;5325;569;-287;87;-374
87;15;3;Jardim Sabará;12455;10491;1964;-32;-17;-15
87;15;3;Jardim São Pedro;2459;2209;250;-99;57;-156
87;15;3;Lageado;3646;3231;415;-4;-26;22
87;15;3;Lami;3730;3362;368;-25;-21;-4
87;15;3;Lomba do Pinheiro;65267;55608;9659;395;-17;412
87;15;3;Mário Quintana;41613;35026;6587;245;-74;319
87;15;3;Medianeira;9738;8229;1509;-88;-27;-61
87;15;3;Menino Deus;34020;28388;5632;204;-18;222
87;15;3;Moinhos de Vento;10680;9222;1458;-220;63;-283
87;15;3;MontSerrat;9890;8336;1554;22;49;-27
87;15;3;Morro Santana;19588;16522;3066;117;-55;172
87;15;3;Navegantes;3100;2662;438;-254;-2;-252
87;15;3;Nonoai;25981;21905;4076;63;-95;158
87;15;3;Parque Santa Fé;4535;3906;629;-163;-23;-140
87;15;3;Partenon;53703;44394;9309;302;-79;381
87;15;3;Passo DAreia;22662;19005;3657;248;47;201
87;15;3;Passo das Pedras;15076;12750;2326;60;-37;97
87;15;3;Pedra Redonda;16;16;0;-2;2;-4
87;15;3;Petrópolis;41068;33805;7263;433;-31;464
87;15;3;Pitinga;3569;3090;479;13;-4;17
87;15;3;Ponta Grossa;8280;7269;1011;6;-32;38
87;15;3;Praia de Belas;1053;883;170;-47;-25;-22
87;15;3;Restinga;58377;50870;7507;-7;-34;27
87;15;3;Rio Branco;17172;14269;2903;266;84;182
87;15;3;Rubem Berta;35389;29839;5550;226;-45;271
87;15;3;Santa Cecília;3797;3239;558;-187;-23;-164
87;15;3;Santa Maria Goretti;2095;1785;310;-112;-14;-98
87;15;3;Santa Rosa de Lima;38323;32605;5718;143;-13;156
87;15;3;Santa Tereza;43331;36146;7185;276;-114;390
87;15;3;Santana;20693;17221;3472;272;20;252
87;15;3;Santo Antônio;12012;9987;2025;-6;-12;6
87;15;3;São Caetano;464;270;194;-10;-22;12
87;15;3;São Geraldo;7719;6391;1328;69;40;29
87;15;3;São João;11663;9826;1837;-3;10;-13
87;15;3;São Sebastião;5498;4811;687;-244;35;-279
87;15;3;Sarandi;67274;56802;10472;217;-13;230
87;15;3;Serraria;5544;4738;806;0;-50;50
87;15;3;Sétimo Céu;461;385;76;-47;-17;-30
87;15;3;Teresópolis;13835;11468;2367;85;-77;162
87;15;3;Três Figueiras;2228;2034;194;-382;-58;-324
87;15;3;Tristeza;16578;14310;2268;69;-20;89
87;15;3;Vila Assunção;3456;2742;714;-42;-50;8
87;15;3;Vila Conceição;688;461;227;-69;-69;0
87;15;3;Vila Ipiranga;18432;15435;2997;119;5;114
87;15;3;Vila Jardim;12235;10100;2135;-30;-60;30
87;15;3;Vila João Pessoa;11789;9806;1983;9;-52;61
87;15;3;Vila Nova;34995;29842;5153;74;-104;178
87;15;3;Vila São José;27933;23379;4554;-99;-147;48
88;16;3;Aberta dos Morros;6513;5673;840;-21;120;-141
88;16;3;Agronomia;1433;1326;107;34;118;-84
88;16;3;Anchieta;1222;1169;53;64;127;-63
88;16;3;Arquipélago;8160;6978;1182;71;220;-149
88;16;3;Auxiliadora;8346;7472;874;24;292;-268
88;16;3;Azenha;12387;11306;1081;55;329;-274
88;16;3;Bela Vista;10421;9241;1180;67;356;-289
88;16;3;Belém Novo;10307;9067;1240;12;51;-39
88;16;3;Belém Velho;10661;9156;1505;13;177;-164
88;16;3;Boa Vista;8782;7786;996;120;329;-209
88;16;3;Boa Vista do Sul;1700;1572;128;-18;40;-58
88;16;3;Bom Fim;10237;9149;1088;71;383;-312
88;16;3;Bom Jesus;30636;25992;4644;-495;351;-846
88;16;3;Camaquã;18179;15782;2397;9;193;-184
88;16;3;Campo Novo;8207;7135;1072;85;213;-128
88;16;3;Cascata;12726;10917;1809;107;261;-154
88;16;3;Cavalhada;31205;27071;4134;-406;236;-642
88;16;3;Centro;43717;37089;6628;-436;284;-720
88;16;3;Chácara das Pedras;5131;4676;455;150;304;-154
88;16;3;Chapéu do Sol;2061;1953;108;-16;89;-105
88;16;3;Cidade Baixa;14977;12973;2004;112;386;-274
88;16;3;Coronel Aparício Borges;19267;16528;2739;150;421;-271
88;16;3;Costa e Silva;15248;13248;2000;172;361;-189
88;16;3;Cristal;34419;29360;5059;-440;156;-596
88;16;3;Cristo Redentor;16033;14223;1810;-19;314;-333
88;16;3;Espírito Santo;4546;4036;510;10;141;-131
88;16;3;Extrema;1516;1399;117;14;26;-12
88;16;3;Farrapos;20142;17245;2897;-183;118;-301
88;16;3;Farroupilha;146;146;0;-21;-21;0
88;16;3;Floresta;10812;9414;1398;98;339;-241
88;16;3;Glória;16808;14383;2425;157;387;-230
88;16;3;Guarujá;3881;3439;442;26;131;-105
88;16;3;Higienópolis;9649;8416;1233;119;369;-250
88;16;3;Hípica;19215;16722;2493;135;118;17
88;16;3;Humaitá;11379;9785;1594;111;172;-61
88;16;3;Independência;6514;6074;440;44;372;-328
88;16;3;Ipanema;13542;11669;1873;23;40;-17
88;16;3;Jardim Botânico;10935;9839;1096;148;396;-248
88;16;3;Jardim Carvalho;26461;22538;3923;-291;232;-523
88;16;3;Jardim do Salso;2805;2553;252;209;276;-67
88;16;3;Jardim Dona Leopoldina;17208;14982;2226;107;375;-268
88;16;3;Jardim Europa;1021;903;118;31;91;-60
88;16;3;Jardim Floresta;1980;1938;42;76;156;-80
88;16;3;Jardim Isabel;1789;1623;166;63;141;-78
88;16;3;Jardim Itu;17435;15057;2378;71;310;-239
88;16;3;Jardim Lindóia;5950;5578;372;56;253;-197
88;16;3;Jardim Sabará;12578;10804;1774;123;313;-190
88;16;3;Jardim São Pedro;2598;2425;173;139;216;-77
88;16;3;Lageado;3639;3273;366;-7;42;-49
88;16;3;Lami;3674;3361;313;-56;-1;-55
88;16;3;Lomba do Pinheiro;65232;55824;9408;-35;216;-251
88;16;3;Mário Quintana;41320;35314;6006;-293;288;-581
88;16;3;Medianeira;9922;8545;1377;184;316;-132
88;16;3;Menino Deus;33874;28876;4998;-146;488;-634
88;16;3;Moinhos de Vento;10800;9589;1211;120;367;-247
88;16;3;MontSerrat;10085;8703;1382;195;367;-172
88;16;3;Morro Santana;19538;16748;2790;-50;226;-276
88;16;3;Navegantes;3146;2835;311;46;173;-127
88;16;3;Nonoai;25834;22260;3574;-147;355;-502
88;16;3;Parque Santa Fé;4786;4248;538;251;342;-91
88;16;3;Partenon;53073;44612;8461;-630;218;-848
88;16;3;Passo DAreia;22600;19295;3305;-62;290;-352
88;16;3;Passo das Pedras;15281;13121;2160;205;371;-166
88;16;3;Pedra Redonda;36;0;36;20;-16;36
88;16;3;Petrópolis;40453;34074;6379;-615;269;-884
88;16;3;Pitinga;3583;3193;390;14;103;-89
88;16;3;Ponta Grossa;8285;7254;1031;5;-15;20
88;16;3;Praia de Belas;1086;1023;63;33;140;-107
88;16;3;Restinga;58319;51036;7283;-58;166;-224
88;16;3;Rio Branco;17320;14675;2645;148;406;-258
88;16;3;Rubem Berta;34762;30085;4677;-627;246;-873
88;16;3;Santa Cecília;3998;3563;435;201;324;-123
88;16;3;Santa Maria Goretti;2219;1988;231;124;203;-79
88;16;3;Santa Rosa de Lima;37985;32745;5240;-338;140;-478
88;16;3;Santa Tereza;43046;36310;6736;-285;164;-449
88;16;3;Santana;20839;17606;3233;146;385;-239
88;16;3;Santo Antônio;12227;10295;1932;215;308;-93
88;16;3;São Caetano;562;272;290;98;2;96
88;16;3;São Geraldo;7872;6652;1220;153;261;-108
88;16;3;São João;11621;10084;1537;-42;258;-300
88;16;3;São Sebastião;5518;5057;461;20;246;-226
88;16;3;Sarandi;66820;57014;9806;-454;212;-666
88;16;3;Serraria;5587;4765;822;43;27;16
88;16;3;Sétimo Céu;499;390;109;38;5;33
88;16;3;Teresópolis;13911;11829;2082;76;361;-285
88;16;3;Três Figueiras;2520;2311;209;292;277;15
88;16;3;Tristeza;16712;14422;2290;134;112;22
88;16;3;Vila Assunção;3601;2937;664;145;195;-50
88;16;3;Vila Conceição;737;471;266;49;10;39
88;16;3;Vila Ipiranga;18627;15733;2894;195;298;-103
88;16;3;Vila Jardim;12524;10440;2084;289;340;-51
88;16;3;Vila João Pessoa;11923;10127;1796;134;321;-187
88;16;3;Vila Nova;34675;29791;4884;-320;-51;-269
88;16;3;Vila São José;27795;23573;4222;-138;194;-332
89;17;3;Aberta dos Morros;6774;6438;336;261;765;-504
89;17;3;Agronomia;1739;1729;10;306;403;-97
89;17;3;Anchieta;1494;1494;0;272;325;-53
89;17;3;Arquipélago;8301;7801;500;141;823;-682
89;17;3;Auxiliadora;8882;8640;242;536;1168;-632
89;17;3;Azenha;12966;12651;315;579;1345;-766
89;17;3;Bela Vista;10974;10587;387;553;1346;-793
89;17;3;Belém Novo;10166;9564;602;-141;497;-638
89;17;3;Belém Velho;10862;10094;768;201;938;-737
89;17;3;Boa Vista;9334;8993;341;552;1207;-655
89;17;3;Boa Vista do Sul;1911;1860;51;211;288;-77
89;17;3;Bom Fim;10891;10501;390;654;1352;-698
89;17;3;Bom Jesus;29796;27356;2440;-840;1364;-2204
89;17;3;Camaquã;18118;16905;1213;-61;1123;-1184
89;17;3;Campo Novo;8525;7993;532;318;858;-540
89;17;3;Cascata;12996;12067;929;270;1150;-880
89;17;3;Cavalhada;30303;28175;2128;-902;1104;-2006
89;17;3;Centro;41696;38200;3496;-2021;1111;-3132
89;17;3;Chácara das Pedras;5671;5602;69;540;926;-386
89;17;3;Chapéu do Sol;2350;2309;41;289;356;-67
89;17;3;Cidade Baixa;15208;14251;957;231;1278;-1047
89;17;3;Coronel Aparício Borges;19291;17916;1375;24;1388;-1364
89;17;3;Costa e Silva;15479;14578;901;231;1330;-1099
89;17;3;Cristal;33570;30518;3052;-849;1158;-2007
89;17;3;Cristo Redentor;16186;15449;737;153;1226;-1073
89;17;3;Espírito Santo;4947;4746;201;401;710;-309
89;17;3;Extrema;1688;1598;90;172;199;-27
89;17;3;Farrapos;19669;18155;1514;-473;910;-1383
89;17;3;Farroupilha;357;357;0;211;211;0
89;17;3;Floresta;11181;10605;576;369;1191;-822
89;17;3;Glória;17017;15730;1287;209;1347;-1138
89;17;3;Guarujá;4237;4067;170;356;628;-272
89;17;3;Higienópolis;10107;9643;464;458;1227;-769
89;17;3;Hípica;18922;17579;1343;-293;857;-1150
89;17;3;Humaitá;11554;10731;823;175;946;-771
89;17;3;Independência;7218;7079;139;704;1005;-301
89;17;3;Ipanema;13591;12619;972;49;950;-901
89;17;3;Jardim Botânico;11666;11278;388;731;1439;-708
89;17;3;Jardim Carvalho;26144;23874;2270;-317;1336;-1653
89;17;3;Jardim do Salso;3301;3284;17;496;731;-235
89;17;3;Jardim Dona Leopoldina;17491;16393;1098;283;1411;-1128
89;17;3;Jardim Europa;1367;1308;59;346;405;-59
89;17;3;Jardim Floresta;2468;2460;8;488;522;-34
89;17;3;Jardim Isabel;2159;2110;49;370;487;-117
89;17;3;Jardim Itu;17637;16438;1199;202;1381;-1179
89;17;3;Jardim Lindóia;6649;6527;122;699;949;-250
89;17;3;Jardim Sabará;13068;12168;900;490;1364;-874
89;17;3;Jardim São Pedro;3043;3013;30;445;588;-143
89;17;3;Lageado;3917;3770;147;278;497;-219
89;17;3;Lami;3907;3739;168;233;378;-145
89;17;3;Lomba do Pinheiro;62722;56876;5846;-2510;1052;-3562
89;17;3;Mário Quintana;40014;36466;3548;-1306;1152;-2458
89;17;3;Medianeira;10434;9835;599;512;1290;-778
89;17;3;Menino Deus;33165;30176;2989;-709;1300;-2009
89;17;3;Moinhos de Vento;11311;10833;478;511;1244;-733
89;17;3;MontSerrat;10587;9943;644;502;1240;-738
89;17;3;Morro Santana;19469;17947;1522;-69;1199;-1268
89;17;3;Navegantes;3778;3554;224;632;719;-87
89;17;3;Nonoai;25593;23523;2070;-241;1263;-1504
89;17;3;Parque Santa Fé;5238;5098;140;452;850;-398
89;17;3;Partenon;51317;46042;5275;-1756;1430;-3186
89;17;3;Passo DAreia;22357;20535;1822;-243;1240;-1483
89;17;3;Passo das Pedras;15668;14505;1163;387;1384;-997
89;17;3;Pedra Redonda;60;60;0;24;60;-36
89;17;3;Petrópolis;39133;35562;3571;-1320;1488;-2808
89;17;3;Pitinga;3895;3715;180;312;522;-210
89;17;3;Ponta Grossa;8417;7881;536;132;627;-495
89;17;3;Praia de Belas;1477;1415;62;391;392;-1
89;17;3;Restinga;56361;52141;4220;-1958;1105;-3063
89;17;3;Rio Branco;17490;16073;1417;170;1398;-1228
89;17;3;Rubem Berta;33995;31324;2671;-767;1239;-2006
89;17;3;Santa Cecília;4609;4453;156;611;890;-279
89;17;3;Santa Maria Goretti;2639;2592;47;420;604;-184
89;17;3;Santa Rosa de Lima;37002;33854;3148;-983;1109;-2092
89;17;3;Santa Tereza;41514;37542;3972;-1532;1232;-2764
89;17;3;Santana;20894;19029;1865;55;1423;-1368
89;17;3;Santo Antônio;12692;11668;1024;465;1373;-908
89;17;3;São Caetano;619;394;225;57;122;-65
89;17;3;São Geraldo;8278;7665;613;406;1013;-607
89;17;3;São João;12029;11210;819;408;1126;-718
89;17;3;São Sebastião;6217;6046;171;699;989;-290
89;17;3;Sarandi;64244;58123;6121;-2576;1109;-3685
89;17;3;Serraria;5839;5401;438;252;636;-384
89;17;3;Sétimo Céu;693;654;39;194;264;-70
89;17;3;Teresópolis;14423;13201;1222;512;1372;-860
89;17;3;Três Figueiras;2983;2959;24;463;648;-185
89;17;3;Tristeza;16602;15392;1210;-110;970;-1080
89;17;3;Vila Assunção;3760;3573;187;159;636;-477
89;17;3;Vila Conceição;851;710;141;114;239;-125
89;17;3;Vila Ipiranga;18662;17054;1608;35;1321;-1286
89;17;3;Vila Jardim;12802;11730;1072;278;1290;-1012
89;17;3;Vila João Pessoa;12416;11470;946;493;1343;-850
89;17;3;Vila Nova;33314;30827;2487;-1361;1036;-2397
89;17;3;Vila São José;27000;24759;2241;-795;1186;-1981
90;18;3;Aberta dos Morros;6846;6437;409;72;-1;73
90;18;3;Agronomia;1852;1785;67;113;56;57
90;18;3;Anchieta;1537;1519;18;43;25;18
90;18;3;Arquipélago;8275;7750;525;-26;-51;25
90;18;3;Auxiliadora;9013;8589;424;131;-51;182
90;18;3;Azenha;13206;12556;650;240;-95;335
90;18;3;Bela Vista;11095;10540;555;121;-47;168
90;18;3;Belém Novo;10223;9496;727;57;-68;125
90;18;3;Belém Velho;10780;10034;746;-82;-60;-22
90;18;3;Boa Vista;9440;8987;453;106;-6;112
90;18;3;Boa Vista do Sul;2102;1936;166;191;76;115
90;18;3;Bom Fim;10956;10413;543;65;-88;153
90;18;3;Bom Jesus;29245;27195;2050;-551;-161;-390
90;18;3;Camaquã;17926;16749;1177;-192;-156;-36
90;18;3;Campo Novo;8531;7972;559;6;-21;27
90;18;3;Cascata;12919;12041;878;-77;-26;-51
90;18;3;Cavalhada;30135;28072;2063;-168;-103;-65
90;18;3;Centro;41042;37998;3044;-654;-202;-452
90;18;3;Chácara das Pedras;5850;5591;259;179;-11;190
90;18;3;Chapéu do Sol;2445;2325;120;95;16;79
90;18;3;Cidade Baixa;15123;14169;954;-85;-82;-3
90;18;3;Coronel Aparício Borges;19211;17874;1337;-80;-42;-38
90;18;3;Costa e Silva;15393;14484;909;-86;-94;8
90;18;3;Cristal;32823;30282;2541;-747;-236;-511
90;18;3;Cristo Redentor;16298;15410;888;112;-39;151
90;18;3;Espírito Santo;5063;4758;305;116;12;104
90;18;3;Extrema;1812;1693;119;124;95;29
90;18;3;Farrapos;19461;18007;1454;-208;-148;-60
90;18;3;Farroupilha;326;326;0;-31;-31;0
90;18;3;Floresta;11236;10563;673;55;-42;97
90;18;3;Glória;16885;15690;1195;-132;-40;-92
90;18;3;Guarujá;4365;4069;296;128;2;126
90;18;3;Higienópolis;10165;9601;564;58;-42;100
90;18;3;Hípica;18908;17497;1411;-14;-82;68
90;18;3;Humaitá;11490;10666;824;-64;-65;1
90;18;3;Independência;7450;7072;378;232;-7;239
90;18;3;Ipanema;13666;12652;1014;75;33;42
90;18;3;Jardim Botânico;11943;11323;620;277;45;232
90;18;3;Jardim Carvalho;25867;23818;2049;-277;-56;-221
90;18;3;Jardim do Salso;3488;3355;133;187;71;116
90;18;3;Jardim Dona Leopoldina;17468;16387;1081;-23;-6;-17
90;18;3;Jardim Europa;1359;1358;1;-8;50;-58
90;18;3;Jardim Floresta;2561;2489;72;93;29;64
90;18;3;Jardim Isabel;2249;2146;103;90;36;54
90;18;3;Jardim Itu;17539;16377;1162;-98;-61;-37
90;18;3;Jardim Lindóia;6905;6572;333;256;45;211
90;18;3;Jardim Sabará;12997;12143;854;-71;-25;-46
90;18;3;Jardim São Pedro;3202;3064;138;159;51;108
90;18;3;Lageado;4160;3853;307;243;83;160
90;18;3;Lami;4129;3857;272;222;118;104
90;18;3;Lomba do Pinheiro;62170;56799;5371;-552;-77;-475
90;18;3;Mário Quintana;39174;36131;3043;-840;-335;-505
90;18;3;Medianeira;10474;9805;669;40;-30;70
90;18;3;Menino Deus;32608;29926;2682;-557;-250;-307
90;18;3;Moinhos de Vento;11468;10829;639;157;-4;161
90;18;3;MontSerrat;10558;9874;684;-29;-69;40
90;18;3;Morro Santana;19466;17978;1488;-3;31;-34
90;18;3;Navegantes;3786;3603;183;8;49;-41
90;18;3;Nonoai;25329;23360;1969;-264;-163;-101
90;18;3;Parque Santa Fé;5431;5144;287;193;46;147
90;18;3;Partenon;50102;45584;4518;-1215;-458;-757
90;18;3;Passo DAreia;22281;20463;1818;-76;-72;-4
90;18;3;Passo das Pedras;15619;14468;1151;-49;-37;-12
90;18;3;Pedra Redonda;79;36;43;19;-24;43
90;18;3;Petrópolis;38786;35453;3333;-347;-109;-238
90;18;3;Pitinga;4076;3807;269;181;92;89
90;18;3;Ponta Grossa;8548;7959;589;131;78;53
90;18;3;Praia de Belas;1579;1495;84;102;80;22
90;18;3;Restinga;56255;52131;4124;-106;-10;-96
90;18;3;Rio Branco;17366;15917;1449;-124;-156;32
90;18;3;Rubem Berta;34078;31185;2893;83;-139;222
90;18;3;Santa Cecília;4780;4414;366;171;-39;210
90;18;3;Santa Maria Goretti;2871;2632;239;232;40;192
90;18;3;Santa Rosa de Lima;36582;33653;2929;-420;-201;-219
90;18;3;Santa Tereza;40782;37281;3501;-732;-261;-471
90;18;3;Santana;20995;19047;1948;101;18;83
90;18;3;Santo Antônio;12924;11708;1216;232;40;192
90;18;3;São Caetano;567;471;96;-52;77;-129
90;18;3;São Geraldo;8405;7674;731;127;9;118
90;18;3;São João;12300;11300;1000;271;90;181
90;18;3;São Sebastião;6500;6110;390;283;64;219
90;18;3;Sarandi;63875;58067;5808;-369;-56;-313
90;18;3;Serraria;5981;5538;443;142;137;5
90;18;3;Sétimo Céu;734;663;71;41;9;32
90;18;3;Teresópolis;14629;13230;1399;206;29;177
90;18;3;Três Figueiras;3367;3059;308;384;100;284
90;18;3;Tristeza;16718;15360;1358;116;-32;148
90;18;3;Vila Assunção;4017;3640;377;257;67;190
90;18;3;Vila Conceição;957;823;134;106;113;-7
90;18;3;Vila Ipiranga;18999;17172;1827;337;118;219
90;18;3;Vila Jardim;13120;11839;1281;318;109;209
90;18;3;Vila João Pessoa;12682;11531;1151;266;61;205
90;18;3;Vila Nova;33891;30880;3011;577;53;524
90;18;3;Vila São José;27482;24988;2494;482;229;253
91;19;3;Aberta dos Morros;6850;6446;404;4;9;-5
91;19;3;Agronomia;1844;1801;43;-8;16;-24
91;19;3;Anchieta;1536;1534;2;-1;15;-16
91;19;3;Arquipélago;8317;7793;524;42;43;-1
91;19;3;Auxiliadora;8993;8644;349;-20;55;-75
91;19;3;Azenha;13073;12609;464;-133;53;-186
91;19;3;Bela Vista;11062;10608;454;-33;68;-101
91;19;3;Belém Novo;10264;9523;741;41;27;14
91;19;3;Belém Velho;10823;10046;777;43;12;31
91;19;3;Boa Vista;9420;9029;391;-20;42;-62
91;19;3;Boa Vista do Sul;2114;1954;160;12;18;-6
91;19;3;Bom Fim;10928;10494;434;-28;81;-109
91;19;3;Bom Jesus;29403;27280;2123;158;85;73
91;19;3;Camaquã;18004;16829;1175;78;80;-2
91;19;3;Campo Novo;8536;7985;551;5;13;-8
91;19;3;Cascata;12966;12062;904;47;21;26
91;19;3;Cavalhada;30073;28086;1987;-62;14;-76
91;19;3;Centro;41115;38084;3031;73;86;-13
91;19;3;Chácara das Pedras;5786;5613;173;-64;22;-86
91;19;3;Chapéu do Sol;2428;2335;93;-17;10;-27
91;19;3;Cidade Baixa;15164;14218;946;41;49;-8
91;19;3;Coronel Aparício Borges;19219;17928;1291;8;54;-46
91;19;3;Costa e Silva;15493;14552;941;100;68;32
91;19;3;Cristal;33079;30373;2706;256;91;165
91;19;3;Cristo Redentor;16267;15469;798;-31;59;-90
91;19;3;Espírito Santo;5092;4810;282;29;52;-23
91;19;3;Extrema;1809;1694;115;-3;1;-4
91;19;3;Farrapos;19594;18083;1511;133;76;57
91;19;3;Farroupilha;388;388;0;62;62;0
91;19;3;Floresta;11197;10591;606;-39;28;-67
91;19;3;Glória;16941;15735;1206;56;45;11
91;19;3;Guarujá;4383;4093;290;18;24;-6
91;19;3;Higienópolis;10197;9663;534;32;62;-30
91;19;3;Hípica;18999;17513;1486;91;16;75
91;19;3;Humaitá;11515;10724;791;25;58;-33
91;19;3;Independência;7341;7092;249;-109;20;-129
91;19;3;Ipanema;13740;12669;1071;74;17;57
91;19;3;Jardim Botânico;11839;11355;484;-104;32;-136
91;19;3;Jardim Carvalho;26031;23893;2138;164;75;89
91;19;3;Jardim do Salso;3436;3398;38;-52;43;-95
91;19;3;Jardim Dona Leopoldina;17541;16454;1087;73;67;6
91;19;3;Jardim Europa;1423;1423;0;64;65;-1
91;19;3;Jardim Floresta;2539;2538;1;-22;49;-71
91;19;3;Jardim Isabel;2209;2157;52;-40;11;-51
91;19;3;Jardim Itu;17679;16472;1207;140;95;45
91;19;3;Jardim Lindóia;6844;6607;237;-61;35;-96
91;19;3;Jardim Sabará;13111;12209;902;114;66;48
91;19;3;Jardim São Pedro;3170;3112;58;-32;48;-80
91;19;3;Lageado;4173;3875;298;13;22;-9
91;19;3;Lami;4132;3862;270;3;5;-2
91;19;3;Lomba do Pinheiro;62043;56810;5233;-127;11;-138
91;19;3;Mário Quintana;39431;36277;3154;257;146;111
91;19;3;Medianeira;10529;9875;654;55;70;-15
91;19;3;Menino Deus;32753;30021;2732;145;95;50
91;19;3;Moinhos de Vento;11482;10862;620;14;33;-19
91;19;3;MontSerrat;10558;9931;627;0;57;-57
91;19;3;Morro Santana;19616;18017;1599;150;39;111
91;19;3;Navegantes;3731;3634;97;-55;31;-86
91;19;3;Nonoai;25407;23383;2024;78;23;55
91;19;3;Parque Santa Fé;5395;5182;213;-36;38;-74
91;19;3;Partenon;50420;45755;4665;318;171;147
91;19;3;Passo DAreia;22381;20535;1846;100;72;28
91;19;3;Passo das Pedras;15651;14564;1087;32;96;-64
91;19;3;Pedra Redonda;58;54;4;-21;18;-39
91;19;3;Petrópolis;38930;35554;3376;144;101;43
91;19;3;Pitinga;4100;3810;290;24;3;21
91;19;3;Ponta Grossa;8576;7959;617;28;0;28
91;19;3;Praia de Belas;1520;1520;0;-59;25;-84
91;19;3;Restinga;55940;52116;3824;-315;-15;-300
91;19;3;Rio Branco;17464;16034;1430;98;117;-19
91;19;3;Rubem Berta;33934;31196;2738;-144;11;-155
91;19;3;Santa Cecília;4709;4467;242;-71;53;-124
91;19;3;Santa Maria Goretti;2800;2668;132;-71;36;-107
91;19;3;Santa Rosa de Lima;36541;33721;2820;-41;68;-109
91;19;3;Santa Tereza;40819;37338;3481;37;57;-20
91;19;3;Santana;20998;19073;1925;3;26;-23
91;19;3;Santo Antônio;12850;11729;1121;-74;21;-95
91;19;3;São Caetano;576;479;97;9;8;1
91;19;3;São Geraldo;8378;7700;678;-27;26;-53
91;19;3;São João;12277;11330;947;-23;30;-53
91;19;3;São Sebastião;6444;6137;307;-56;27;-83
91;19;3;Sarandi;63451;58067;5384;-424;0;-424
91;19;3;Serraria;5979;5508;471;-2;-30;28
91;19;3;Sétimo Céu;736;682;54;2;19;-17
91;19;3;Teresópolis;14531;13227;1304;-98;-3;-95
91;19;3;Três Figueiras;3237;3076;161;-130;17;-147
91;19;3;Tristeza;16717;15343;1374;-1;-17;16
91;19;3;Vila Assunção;4021;3642;379;4;2;2
91;19;3;Vila Conceição;949;809;140;-8;-14;6
91;19;3;Vila Ipiranga;18812;17099;1713;-187;-73;-114
91;19;3;Vila Jardim;12960;11776;1184;-160;-63;-97
91;19;3;Vila João Pessoa;12697;11544;1153;15;13;2
91;19;3;Vila Nova;33560;30821;2739;-331;-59;-272
91;19;3;Vila São José;27310;24890;2420;-172;-98;-74
92;20;3;Aberta dos Morros;7118;6902;216;268;456;-188
92;20;3;Agronomia;2530;2221;309;686;420;266
92;20;3;Anchieta;2151;1934;217;615;400;215
92;20;3;Arquipélago;8512;8253;259;195;460;-265
92;20;3;Auxiliadora;9493;9436;57;500;792;-292
92;20;3;Azenha;13526;13526;0;453;917;-464
92;20;3;Bela Vista;11562;11509;53;500;901;-401
92;20;3;Belém Novo;10282;9916;366;18;393;-375
92;20;3;Belém Velho;10974;10644;330;151;598;-447
92;20;3;Boa Vista;9895;9819;76;475;790;-315
92;20;3;Boa Vista do Sul;2411;2122;289;297;168;129
92;20;3;Bom Fim;11426;11377;49;498;883;-385
92;20;3;Bom Jesus;28587;28367;220;-816;1087;-1903
92;20;3;Camaquã;17819;17610;209;-185;781;-966
92;20;3;Campo Novo;8747;8515;232;211;530;-319
92;20;3;Cascata;13060;12783;277;94;721;-627
92;20;3;Cavalhada;29166;28990;176;-907;904;-1811
92;20;3;Centro;39196;38972;224;-1919;888;-2807
92;20;3;Chácara das Pedras;6510;6425;85;724;812;-88
92;20;3;Chapéu do Sol;2914;2675;239;486;340;146
92;20;3;Cidade Baixa;15299;15166;133;135;948;-813
92;20;3;Coronel Aparício Borges;19201;18975;226;-18;1047;-1065
92;20;3;Costa e Silva;15693;15532;161;200;980;-780
92;20;3;Cristal;32140;31524;616;-939;1151;-2090
92;20;3;Cristo Redentor;16206;16201;5;-61;732;-793
92;20;3;Espírito Santo;5466;5290;176;374;480;-106
92;20;3;Extrema;2119;1849;270;310;155;155
92;20;3;Farrapos;19213;18795;418;-381;712;-1093
92;20;3;Farroupilha;990;823;167;602;435;167
92;20;3;Floresta;11503;11383;120;306;792;-486
92;20;3;Glória;16894;16709;185;-47;974;-1021
92;20;3;Guarujá;4815;4556;259;432;463;-31
92;20;3;Higienópolis;10595;10488;107;398;825;-427
92;20;3;Hípica;18609;18179;430;-390;666;-1056
92;20;3;Humaitá;11636;11339;297;121;615;-494
92;20;3;Independência;7974;7908;66;633;816;-183
92;20;3;Ipanema;13677;13332;345;-63;663;-726
92;20;3;Jardim Botânico;12249;12224;25;410;869;-459
92;20;3;Jardim Carvalho;25411;24985;426;-620;1092;-1712
92;20;3;Jardim do Salso;4359;4165;194;923;767;156
92;20;3;Jardim Dona Leopoldina;17798;17612;186;257;1158;-901
92;20;3;Jardim Europa;2211;2077;134;788;654;134
92;20;3;Jardim Floresta;3268;3103;165;729;565;164
92;20;3;Jardim Isabel;2787;2574;213;578;417;161
92;20;3;Jardim Itu;17643;17480;163;-36;1008;-1044
92;20;3;Jardim Lindóia;7287;7204;83;443;597;-154
92;20;3;Jardim Sabará;13328;13176;152;217;967;-750
92;20;3;Jardim São Pedro;3927;3739;188;757;627;130
92;20;3;Lageado;4528;4220;308;355;345;10
92;20;3;Lami;4353;4076;277;221;214;7
92;20;3;Lomba do Pinheiro;59011;57840;1171;-3032;1030;-4062
92;20;3;Mário Quintana;38305;37603;702;-1126;1326;-2452
92;20;3;Medianeira;10997;10876;121;468;1001;-533
92;20;3;Menino Deus;31574;31227;347;-1179;1206;-2385
92;20;3;Moinhos de Vento;11750;11666;84;268;804;-536
92;20;3;MontSerrat;11079;10908;171;521;977;-456
92;20;3;Morro Santana;19431;18986;445;-185;969;-1154
92;20;3;Navegantes;4351;4157;194;620;523;97
92;20;3;Nonoai;25118;24659;459;-289;1276;-1565
92;20;3;Parque Santa Fé;6234;6059;175;839;877;-38
92;20;3;Partenon;48510;47388;1122;-1910;1633;-3543
92;20;3;Passo DAreia;21867;21549;318;-514;1014;-1528
92;20;3;Passo das Pedras;15785;15536;249;134;972;-838
92;20;3;Pedra Redonda;356;123;233;298;69;229
92;20;3;Petrópolis;37586;36937;649;-1344;1383;-2727
92;20;3;Pitinga;4530;4181;349;430;371;59
92;20;3;Ponta Grossa;8752;8358;394;176;399;-223
92;20;3;Praia de Belas;2399;2133;266;879;613;266
92;20;3;Restinga;53607;52869;738;-2333;753;-3086
92;20;3;Rio Branco;17344;17124;220;-120;1090;-1210
92;20;3;Rubem Berta;33425;32637;788;-509;1441;-1950
92;20;3;Santa Cecília;5719;5422;297;1010;955;55
92;20;3;Santa Maria Goretti;3564;3264;300;764;596;168
92;20;3;Santa Rosa de Lima;35740;34871;869;-801;1150;-1951
92;20;3;Santa Tereza;39801;38767;1034;-1018;1429;-2447
92;20;3;Santana;20535;20214;321;-463;1141;-1604
92;20;3;Santo Antônio;13020;12719;301;170;990;-820
92;20;3;São Caetano;888;593;295;312;114;198
92;20;3;São Geraldo;8729;8415;314;351;715;-364
92;20;3;São João;12167;11954;213;-110;624;-734
92;20;3;São Sebastião;6996;6811;185;552;674;-122
92;20;3;Sarandi;60254;59110;1144;-3197;1043;-4240
92;20;3;Serraria;6281;5860;421;302;352;-50
92;20;3;Sétimo Céu;1231;1023;208;495;341;154
92;20;3;Teresópolis;14613;14198;415;82;971;-889
92;20;3;Três Figueiras;4058;3784;274;821;708;113
92;20;3;Tristeza;16585;16122;463;-132;779;-911
92;20;3;Vila Assunção;4600;4149;451;579;507;72
92;20;3;Vila Conceição;1488;1122;366;539;313;226
92;20;3;Vila Ipiranga;18645;18155;490;-167;1056;-1223
92;20;3;Vila Jardim;13204;12740;464;244;964;-720
92;20;3;Vila João Pessoa;12900;12541;359;203;997;-794
92;20;3;Vila Nova;32514;31670;844;-1046;849;-1895
92;20;3;Vila São José;26750;25912;838;-560;1022;-1582
93;21;3;Aberta dos Morros;7106;6951;155;-12;49;-61
93;21;3;Agronomia;2487;2246;241;-43;25;-68
93;21;3;Anchieta;2145;1983;162;-6;49;-55
93;21;3;Arquipélago;8449;8281;168;-63;28;-91
93;21;3;Auxiliadora;9543;9535;8;50;99;-49
93;21;3;Azenha;13637;13637;0;111;111;0
93;21;3;Bela Vista;11627;11608;19;65;99;-34
93;21;3;Belém Novo;10180;9950;230;-102;34;-136
93;21;3;Belém Velho;10900;10695;205;-74;51;-125
93;21;3;Boa Vista;9922;9907;15;27;88;-61
93;21;3;Boa Vista do Sul;2409;2145;264;-2;23;-25
93;21;3;Bom Fim;11461;11451;10;35;74;-39
93;21;3;Bom Jesus;28750;28448;302;163;81;82
93;21;3;Camaquã;17832;17683;149;13;73;-60
93;21;3;Campo Novo;8734;8572;162;-13;57;-70
93;21;3;Cascata;13038;12855;183;-22;72;-94
93;21;3;Cavalhada;29208;29093;115;42;103;-61
93;21;3;Centro;39373;39049;324;177;77;100
93;21;3;Chácara das Pedras;6514;6513;1;4;88;-84
93;21;3;Chapéu do Sol;2909;2727;182;-5;52;-57
93;21;3;Cidade Baixa;15303;15234;69;4;68;-64
93;21;3;Coronel Aparício Borges;19259;19075;184;58;100;-42
93;21;3;Costa e Silva;15711;15642;69;18;110;-92
93;21;3;Cristal;31980;31676;304;-160;152;-312
93;21;3;Cristo Redentor;16341;16303;38;135;102;33
93;21;3;Espírito Santo;5522;5375;147;56;85;-29
93;21;3;Extrema;2131;1866;265;12;17;-5
93;21;3;Farrapos;19113;18883;230;-100;88;-188
93;21;3;Farroupilha;917;852;65;-73;29;-102
93;21;3;Floresta;11488;11460;28;-15;77;-92
93;21;3;Glória;16983;16828;155;89;119;-30
93;21;3;Guarujá;4838;4637;201;23;81;-58
93;21;3;Higienópolis;10632;10592;40;37;104;-67
93;21;3;Hípica;18567;18303;264;-42;124;-166
93;21;3;Humaitá;11573;11407;166;-63;68;-131
93;21;3;Independência;7979;7978;1;5;70;-65
93;21;3;Ipanema;13716;13467;249;39;135;-96
93;21;3;Jardim Botânico;12314;12314;0;65;90;-25
93;21;3;Jardim Carvalho;25451;25155;296;40;170;-130
93;21;3;Jardim do Salso;4340;4240;100;-19;75;-94
93;21;3;Jardim Dona Leopoldina;17834;17746;88;36;134;-98
93;21;3;Jardim Europa;2249;2170;79;38;93;-55
93;21;3;Jardim Floresta;3297;3196;101;29;93;-64
93;21;3;Jardim Isabel;2797;2642;155;10;68;-58
93;21;3;Jardim Itu;17779;17651;128;136;171;-35
93;21;3;Jardim Lindóia;7302;7298;4;15;94;-79
93;21;3;Jardim Sabará;13427;13312;115;99;136;-37
93;21;3;Jardim São Pedro;3931;3833;98;4;94;-90
93;21;3;Lageado;4536;4282;254;8;62;-54
93;21;3;Lami;4364;4108;256;11;32;-21
93;21;3;Lomba do Pinheiro;58725;57922;803;-286;82;-368
93;21;3;Mário Quintana;38290;37809;481;-15;206;-221
93;21;3;Medianeira;11062;10995;67;65;119;-54
93;21;3;Menino Deus;31805;31410;395;231;183;48
93;21;3;Moinhos de Vento;11807;11760;47;57;94;-37
93;21;3;MontSerrat;11079;11041;38;0;133;-133
93;21;3;Morro Santana;19405;19140;265;-26;154;-180
93;21;3;Navegantes;4319;4220;99;-32;63;-95
93;21;3;Nonoai;25105;24840;265;-13;181;-194
93;21;3;Parque Santa Fé;6297;6193;104;63;134;-71
93;21;3;Partenon;48447;47723;724;-63;335;-398
93;21;3;Passo DAreia;21974;21749;225;107;200;-93
93;21;3;Passo das Pedras;15825;15692;133;40;156;-116
93;21;3;Pedra Redonda;346;145;201;-10;22;-32
93;21;3;Petrópolis;37598;37168;430;12;231;-219
93;21;3;Pitinga;4517;4217;300;-13;36;-49
93;21;3;Ponta Grossa;8729;8461;268;-23;103;-126
93;21;3;Praia de Belas;2280;2163;117;-119;30;-149
93;21;3;Restinga;53545;53057;488;-62;188;-250
93;21;3;Rio Branco;17559;17306;253;215;182;33
93;21;3;Rubem Berta;33312;32841;471;-113;204;-317
93;21;3;Santa Cecília;5611;5532;79;-108;110;-218
93;21;3;Santa Maria Goretti;3532;3369;163;-32;105;-137
93;21;3;Santa Rosa de Lima;35561;35075;486;-179;204;-383
93;21;3;Santa Tereza;39758;39083;675;-43;316;-359
93;21;3;Santana;20732;20428;304;197;214;-17
93;21;3;Santo Antônio;13005;12890;115;-15;171;-186
93;21;3;São Caetano;911;614;297;23;21;2
93;21;3;São Geraldo;8670;8525;145;-59;110;-169
93;21;3;São João;12131;12070;61;-36;116;-152
93;21;3;São Sebastião;6920;6883;37;-76;72;-148
93;21;3;Sarandi;59974;59392;582;-280;282;-562
93;21;3;Serraria;6305;5958;347;24;98;-74
93;21;3;Sétimo Céu;1253;1090;163;22;67;-45
93;21;3;Teresópolis;14608;14388;220;-5;190;-195
93;21;3;Três Figueiras;3989;3890;99;-69;106;-175
93;21;3;Tristeza;16646;16329;317;61;207;-146
93;21;3;Vila Assunção;4540;4211;329;-60;62;-122
93;21;3;Vila Conceição;1512;1165;347;24;43;-19
93;21;3;Vila Ipiranga;18622;18377;245;-23;222;-245
93;21;3;Vila Jardim;13170;12942;228;-34;202;-236
93;21;3;Vila João Pessoa;12865;12693;172;-35;152;-187
93;21;3;Vila Nova;32455;31941;514;-59;271;-330
93;21;3;Vila São José;26657;26130;527;-93;218;-311
94;22;3;Aberta dos Morros;7144;6964;180;38;13;25
94;22;3;Agronomia;2548;2258;290;61;12;49
94;22;3;Anchieta;2184;1957;227;39;-26;65
94;22;3;Arquipélago;8428;8254;174;-21;-27;6
94;22;3;Auxiliadora;9617;9469;148;74;-66;140
94;22;3;Azenha;13735;13580;155;98;-57;155
94;22;3;Bela Vista;11713;11551;162;86;-57;143
94;22;3;Belém Novo;10191;9949;242;11;-1;12
94;22;3;Belém Velho;10890;10689;201;-10;-6;-4
94;22;3;Boa Vista;10013;9855;158;91;-52;143
94;22;3;Boa Vista do Sul;2443;2145;298;34;0;34
94;22;3;Bom Fim;11518;11378;140;57;-73;130
94;22;3;Bom Jesus;28621;28442;179;-129;-6;-123
94;22;3;Camaquã;17820;17659;161;-12;-24;12
94;22;3;Campo Novo;8745;8575;170;11;3;8
94;22;3;Cascata;13004;12838;166;-34;-17;-17
94;22;3;Cavalhada;29280;29077;203;72;-16;88
94;22;3;Centro;39304;38995;309;-69;-54;-15
94;22;3;Chácara das Pedras;6625;6473;152;111;-40;151
94;22;3;Chapéu do Sol;2958;2738;220;49;11;38
94;22;3;Cidade Baixa;15370;15197;173;67;-37;104
94;22;3;Coronel Aparício Borges;19259;19076;183;0;1;-1
94;22;3;Costa e Silva;15809;15657;152;98;15;83
94;22;3;Cristal;31926;31702;224;-54;26;-80
94;22;3;Cristo Redentor;16415;16243;172;74;-60;134
94;22;3;Espírito Santo;5546;5386;160;24;11;13
94;22;3;Extrema;2145;1863;282;14;-3;17
94;22;3;Farrapos;19043;18849;194;-70;-34;-36
94;22;3;Farroupilha;935;780;155;18;-72;90
94;22;3;Floresta;11564;11406;158;76;-54;130
94;22;3;Glória;17051;16855;196;68;27;41
94;22;3;Guarujá;4862;4641;221;24;4;20
94;22;3;Higienópolis;10701;10531;170;69;-61;130
94;22;3;Hípica;18575;18356;219;8;53;-45
94;22;3;Humaitá;11563;11382;181;-10;-25;15
94;22;3;Independência;8074;7912;162;95;-66;161
94;22;3;Ipanema;13683;13484;199;-33;17;-50
94;22;3;Jardim Botânico;12459;12295;164;145;-19;164
94;22;3;Jardim Carvalho;25411;25177;234;-40;22;-62
94;22;3;Jardim do Salso;4381;4235;146;41;-5;46
94;22;3;Jardim Dona Leopoldina;17935;17789;146;101;43;58
94;22;3;Jardim Europa;2270;2119;151;21;-51;72
94;22;3;Jardim Floresta;3299;3153;146;2;-43;45
94;22;3;Jardim Isabel;2819;2638;181;22;-4;26
94;22;3;Jardim Itu;17803;17631;172;24;-20;44
94;22;3;Jardim Lindóia;7402;7254;148;100;-44;144
94;22;3;Jardim Sabará;13487;13326;161;60;14;46
94;22;3;Jardim São Pedro;3934;3786;148;3;-47;50
94;22;3;Lageado;4551;4291;260;15;9;6
94;22;3;Lami;4360;4084;276;-4;-24;20
94;22;3;Lomba do Pinheiro;58473;57949;524;-252;27;-279
94;22;3;Mário Quintana;38174;37888;286;-116;79;-195
94;22;3;Medianeira;11167;10997;170;105;2;103
94;22;3;Menino Deus;31630;31372;258;-175;-38;-137
94;22;3;Moinhos de Vento;11889;11702;187;82;-58;140
94;22;3;MontSerrat;11164;11003;161;85;-38;123
94;22;3;Morro Santana;19384;19170;214;-21;30;-51
94;22;3;Navegantes;4335;4188;147;16;-32;48
94;22;3;Nonoai;25078;24860;218;-27;20;-47
94;22;3;Parque Santa Fé;6362;6222;140;65;29;36
94;22;3;Partenon;48162;47728;434;-285;5;-290
94;22;3;Passo DAreia;21891;21696;195;-83;-53;-30
94;22;3;Passo das Pedras;15889;15713;176;64;21;43
94;22;3;Pedra Redonda;402;148;254;56;3;53
94;22;3;Petrópolis;37415;37150;265;-183;-18;-165
94;22;3;Pitinga;4537;4233;304;20;16;4
94;22;3;Ponta Grossa;8776;8494;282;47;33;14
94;22;3;Praia de Belas;2324;2154;170;44;-9;53
94;22;3;Restinga;53291;53094;197;-254;37;-291
94;22;3;Rio Branco;17445;17224;221;-114;-82;-32
94;22;3;Rubem Berta;33194;32889;305;-118;48;-166
94;22;3;Santa Cecília;5659;5497;162;48;-35;83
94;22;3;Santa Maria Goretti;3507;3335;172;-25;-34;9
94;22;3;Santa Rosa de Lima;35412;35091;321;-149;16;-165
94;22;3;Santa Tereza;39591;39125;466;-167;42;-209
94;22;3;Santana;20635;20378;257;-97;-50;-47
94;22;3;Santo Antônio;13088;12900;188;83;10;73
94;22;3;São Caetano;888;582;306;-23;-32;9
94;22;3;São Geraldo;8646;8488;158;-24;-37;13
94;22;3;São João;12205;12027;178;74;-43;117
94;22;3;São Sebastião;6997;6860;137;77;-23;100
94;22;3;Sarandi;59776;59408;368;-198;16;-214
94;22;3;Serraria;6313;5986;327;8;28;-20
94;22;3;Sétimo Céu;1269;1082;187;16;-8;24
94;22;3;Teresópolis;14659;14431;228;51;43;8
94;22;3;Três Figueiras;4027;3874;153;38;-16;54
94;22;3;Tristeza;16621;16324;297;-25;-5;-20
94;22;3;Vila Assunção;4478;4218;260;-62;7;-69
94;22;3;Vila Conceição;1508;1149;359;-4;-16;12
94;22;3;Vila Ipiranga;18577;18371;206;-45;-6;-39
94;22;3;Vila Jardim;13159;12954;205;-11;12;-23
94;22;3;Vila João Pessoa;12929;12750;179;64;57;7
94;22;3;Vila Nova;32362;31985;377;-93;44;-137
94;22;3;Vila São José;26650;26189;461;-7;59;-66
95;23;3;Aberta dos Morros;7146;7146;0;2;182;-180
95;23;3;Agronomia;2331;2331;0;-217;73;-290
95;23;3;Anchieta;2024;2024;0;-160;67;-227
95;23;3;Arquipélago;8330;8330;0;-98;76;-174
95;23;3;Auxiliadora;9683;9683;0;66;214;-148
95;23;3;Azenha;13804;13804;0;69;224;-155
95;23;3;Bela Vista;11787;11787;0;74;236;-162
95;23;3;Belém Novo;10100;10100;0;-91;151;-242
95;23;3;Belém Velho;10835;10835;0;-55;146;-201
95;23;3;Boa Vista;10053;10053;0;40;198;-158
95;23;3;Boa Vista do Sul;2309;2309;0;-134;164;-298
95;23;3;Bom Fim;11593;11593;0;75;215;-140
95;23;3;Bom Jesus;28675;28675;0;54;233;-179
95;23;3;Camaquã;17938;17938;0;118;279;-161
95;23;3;Campo Novo;8766;8766;0;21;191;-170
95;23;3;Cascata;13013;13013;0;9;175;-166
95;23;3;Cavalhada;29299;29299;0;19;222;-203
95;23;3;Centro;39154;39154;0;-150;159;-309
95;23;3;Chácara das Pedras;6668;6668;0;43;195;-152
95;23;3;Chapéu do Sol;2913;2913;0;-45;175;-220
95;23;3;Cidade Baixa;15379;15379;0;9;182;-173
95;23;3;Coronel Aparício Borges;19303;19303;0;44;227;-183
95;23;3;Costa e Silva;15842;15842;0;33;185;-152
95;23;3;Cristal;31946;31946;0;20;244;-224
95;23;3;Cristo Redentor;16455;16455;0;40;212;-172
95;23;3;Espírito Santo;5606;5606;0;60;220;-160
95;23;3;Extrema;1981;1981;0;-164;118;-282
95;23;3;Farrapos;18986;18986;0;-57;137;-194
95;23;3;Farroupilha;961;961;0;26;181;-155
95;23;3;Floresta;11596;11596;0;32;190;-158
95;23;3;Glória;17067;17067;0;16;212;-196
95;23;3;Guarujá;4811;4811;0;-51;170;-221
95;23;3;Higienópolis;10724;10724;0;23;193;-170
95;23;3;Hípica;18645;18645;0;70;289;-219
95;23;3;Humaitá;11502;11502;0;-61;120;-181
95;23;3;Independência;8112;8112;0;38;200;-162
95;23;3;Ipanema;13728;13728;0;45;244;-199
95;23;3;Jardim Botânico;12521;12521;0;62;226;-164
95;23;3;Jardim Carvalho;25386;25386;0;-25;209;-234
95;23;3;Jardim do Salso;4405;4405;0;24;170;-146
95;23;3;Jardim Dona Leopoldina;18016;18016;0;81;227;-146
95;23;3;Jardim Europa;2299;2299;0;29;180;-151
95;23;3;Jardim Floresta;3307;3307;0;8;154;-146
95;23;3;Jardim Isabel;2835;2835;0;16;197;-181
95;23;3;Jardim Itu;17853;17853;0;50;222;-172
95;23;3;Jardim Lindóia;7417;7417;0;15;163;-148
95;23;3;Jardim Sabará;13530;13530;0;43;204;-161
95;23;3;Jardim São Pedro;3967;3967;0;33;181;-148
95;23;3;Lageado;4481;4481;0;-70;190;-260
95;23;3;Lami;4289;4289;0;-71;205;-276
95;23;3;Lomba do Pinheiro;58106;58106;0;-367;157;-524
95;23;3;Mário Quintana;38116;38116;0;-58;228;-286
95;23;3;Medianeira;11223;11223;0;56;226;-170
95;23;3;Menino Deus;31650;31650;0;20;278;-258
95;23;3;Moinhos de Vento;11937;11937;0;48;235;-187
95;23;3;MontSerrat;11236;11236;0;72;233;-161
95;23;3;Morro Santana;19338;19338;0;-46;168;-214
95;23;3;Navegantes;4327;4327;0;-8;139;-147
95;23;3;Nonoai;25160;25160;0;82;300;-218
95;23;3;Parque Santa Fé;6376;6376;0;14;154;-140
95;23;3;Partenon;48160;48160;0;-2;432;-434
95;23;3;Passo DAreia;21968;21968;0;77;272;-195
95;23;3;Passo das Pedras;15902;15902;0;13;189;-176
95;23;3;Pedra Redonda;274;274;0;-128;126;-254
95;23;3;Petrópolis;37496;37496;0;81;346;-265
95;23;3;Pitinga;4352;4352;0;-185;119;-304
95;23;3;Ponta Grossa;8722;8722;0;-54;228;-282
95;23;3;Praia de Belas;2281;2281;0;-43;127;-170
95;23;3;Restinga;53508;53508;0;217;414;-197
95;23;3;Rio Branco;17531;17531;0;86;307;-221
95;23;3;Rubem Berta;33168;33168;0;-26;279;-305
95;23;3;Santa Cecília;5768;5768;0;109;271;-162
95;23;3;Santa Maria Goretti;3509;3509;0;2;174;-172
95;23;3;Santa Rosa de Lima;35333;35333;0;-79;242;-321
95;23;3;Santa Tereza;39577;39577;0;-14;452;-466
95;23;3;Santana;20723;20723;0;88;345;-257
95;23;3;Santo Antônio;13161;13161;0;73;261;-188
95;23;3;São Caetano;757;757;0;-131;175;-306
95;23;3;São Geraldo;8681;8681;0;35;193;-158
95;23;3;São João;12226;12226;0;21;199;-178
95;23;3;São Sebastião;7019;7019;0;22;159;-137
95;23;3;Sarandi;59711;59711;0;-65;303;-368
95;23;3;Serraria;6239;6239;0;-74;253;-327
95;23;3;Sétimo Céu;1329;1329;0;60;247;-187
95;23;3;Teresópolis;14707;14707;0;48;276;-228
95;23;3;Três Figueiras;4070;4070;0;43;196;-153
95;23;3;Tristeza;16692;16692;0;71;368;-297
95;23;3;Vila Assunção;4418;4418;0;-60;200;-260
95;23;3;Vila Conceição;1349;1349;0;-159;200;-359
95;23;3;Vila Ipiranga;18659;18659;0;82;288;-206
95;23;3;Vila Jardim;13189;13189;0;30;235;-205
95;23;3;Vila João Pessoa;13041;13041;0;112;291;-179
95;23;3;Vila Nova;32469;32469;0;107;484;-377
95;23;3;Vila São José;26522;26522;0;-128;333;-461
96;0;4;Aberta dos Morros;7114;7082;32;-32;-64;32
96;0;4;Agronomia;2336;2300;36;5;-31;36
96;0;4;Anchieta;2024;1976;48;0;-48;48
96;0;4;Arquipélago;8333;8290;43;3;-40;43
96;0;4;Auxiliadora;9615;9554;61;-68;-129;61
96;0;4;Azenha;13734;13637;97;-70;-167;97
96;0;4;Bela Vista;11713;11650;63;-74;-137;63
96;0;4;Belém Novo;10085;10070;15;-15;-30;15
96;0;4;Belém Velho;10832;10793;39;-3;-42;39
96;0;4;Boa Vista;9999;9936;63;-54;-117;63
96;0;4;Boa Vista do Sul;2285;2270;15;-24;-39;15
96;0;4;Bom Fim;11471;11429;42;-122;-164;42
96;0;4;Bom Jesus;28644;28586;58;-31;-89;58
96;0;4;Camaquã;17901;17853;48;-37;-85;48
96;0;4;Campo Novo;8751;8709;42;-15;-57;42
96;0;4;Cascata;13004;12955;49;-9;-58;49
96;0;4;Cavalhada;29269;29217;52;-30;-82;52
96;0;4;Centro;39193;39078;115;39;-76;115
96;0;4;Chácara das Pedras;6640;6574;66;-28;-94;66
96;0;4;Chapéu do Sol;2901;2871;30;-12;-42;30
96;0;4;Cidade Baixa;15305;15243;62;-74;-136;62
96;0;4;Coronel Aparício Borges;19270;19211;59;-33;-92;59
96;0;4;Costa e Silva;15836;15781;55;-6;-61;55
96;0;4;Cristal;31929;31879;50;-17;-67;50
96;0;4;Cristo Redentor;16465;16319;146;10;-136;146
96;0;4;Espírito Santo;5582;5536;46;-24;-70;46
96;0;4;Extrema;1977;1968;9;-4;-13;9
96;0;4;Farrapos;19003;18948;55;17;-38;55
96;0;4;Farroupilha;958;810;148;-3;-151;148
96;0;4;Floresta;11544;11480;64;-52;-116;64
96;0;4;Glória;17106;16979;127;39;-88;127
96;0;4;Guarujá;4798;4748;50;-13;-63;50
96;0;4;Higienópolis;10693;10628;65;-31;-96;65
96;0;4;Hípica;18637;18593;44;-8;-52;44
96;0;4;Humaitá;11524;11464;60;22;-38;60
96;0;4;Independência;8139;7980;159;27;-132;159
96;0;4;Ipanema;13712;13662;50;-16;-66;50
96;0;4;Jardim Botânico;12552;12406;146;31;-115;146
96;0;4;Jardim Carvalho;25465;25326;139;79;-60;139
96;0;4;Jardim do Salso;4394;4327;67;-11;-78;67
96;0;4;Jardim Dona Leopoldina;18006;17950;56;-10;-66;56
96;0;4;Jardim Europa;2272;2203;69;-27;-96;69
96;0;4;Jardim Floresta;3294;3225;69;-13;-82;69
96;0;4;Jardim Isabel;2811;2756;55;-24;-79;55
96;0;4;Jardim Itu;17841;17775;66;-12;-78;66
96;0;4;Jardim Lindóia;7400;7331;69;-17;-86;69
96;0;4;Jardim Sabará;13525;13455;70;-5;-75;70
96;0;4;Jardim São Pedro;3948;3879;69;-19;-88;69
96;0;4;Lageado;4484;4451;33;3;-30;33
96;0;4;Lami;4283;4262;21;-6;-27;21
96;0;4;Lomba do Pinheiro;58134;58086;48;28;-20;48
96;0;4;Mário Quintana;38127;38071;56;11;-45;56
96;0;4;Medianeira;11182;11118;64;-41;-105;64
96;0;4;Menino Deus;31705;31545;160;55;-105;160
96;0;4;Moinhos de Vento;11994;11823;171;57;-114;171
96;0;4;MontSerrat;11188;11118;70;-48;-118;70
96;0;4;Morro Santana;19351;19288;63;13;-50;63
96;0;4;Navegantes;4337;4270;67;10;-57;67
96;0;4;Nonoai;25140;25081;59;-20;-79;59
96;0;4;Parque Santa Fé;6373;6312;61;-3;-64;61
96;0;4;Partenon;48146;48078;68;-14;-82;68
96;0;4;Passo DAreia;21946;21872;74;-22;-96;74
96;0;4;Passo das Pedras;15906;15841;65;4;-61;65
96;0;4;Pedra Redonda;253;197;56;-21;-77;56
96;0;4;Petrópolis;37467;37398;69;-29;-98;69
96;0;4;Pitinga;4375;4339;36;23;-13;36
96;0;4;Ponta Grossa;8735;8695;40;13;-27;40
96;0;4;Praia de Belas;2269;2200;69;-12;-81;69
96;0;4;Restinga;53594;53489;105;86;-19;105
96;0;4;Rio Branco;17588;17401;187;57;-130;187
96;0;4;Rubem Berta;33182;33113;69;14;-55;69
96;0;4;Santa Cecília;5837;5651;186;69;-117;186
96;0;4;Santa Maria Goretti;3512;3440;72;3;-69;72
96;0;4;Santa Rosa de Lima;35363;35305;58;30;-28;58
96;0;4;Santa Tereza;39572;39508;64;-5;-69;64
96;0;4;Santana;20803;20609;194;80;-114;194
96;0;4;Santo Antônio;13150;13071;79;-11;-90;79
96;0;4;São Caetano;773;739;34;16;-18;34
96;0;4;São Geraldo;8691;8613;78;10;-68;78
96;0;4;São João;12243;12161;82;17;-65;82
96;0;4;São Sebastião;7027;6954;73;8;-65;73
96;0;4;Sarandi;59733;59663;70;22;-48;70
96;0;4;Serraria;6256;6203;53;17;-36;53
96;0;4;Sétimo Céu;1307;1251;56;-22;-78;56
96;0;4;Teresópolis;14816;14641;175;109;-66;175
96;0;4;Três Figueiras;4070;3990;80;0;-80;80
96;0;4;Tristeza;16671;16614;57;-21;-78;57
96;0;4;Vila Assunção;4531;4381;150;113;-37;150
96;0;4;Vila Conceição;1367;1305;62;18;-44;62
96;0;4;Vila Ipiranga;18663;18584;79;4;-75;79
96;0;4;Vila Jardim;13193;13113;80;4;-76;80
96;0;4;Vila João Pessoa;13054;12978;76;13;-63;76
96;0;4;Vila Nova;32581;32428;153;112;-41;153
96;0;4;Vila São José;26549;26476;73;27;-46;73
97;1;4;Aberta dos Morros;7110;7072;38;-4;-10;6
97;1;4;Agronomia;2324;2286;38;-12;-14;2
97;1;4;Anchieta;2021;1972;49;-3;-4;1
97;1;4;Arquipélago;8339;8284;55;6;-6;12
97;1;4;Auxiliadora;9601;9534;67;-14;-20;6
97;1;4;Azenha;13741;13607;134;7;-30;37
97;1;4;Bela Vista;11705;11631;74;-8;-19;11
97;1;4;Belém Novo;10085;10066;19;0;-4;4
97;1;4;Belém Velho;10828;10778;50;-4;-15;11
97;1;4;Boa Vista;9993;9918;75;-6;-18;12
97;1;4;Boa Vista do Sul;2282;2265;17;-3;-5;2
97;1;4;Bom Fim;11444;11403;41;-27;-26;-1
97;1;4;Bom Jesus;28660;28565;95;16;-21;37
97;1;4;Camaquã;17905;17832;73;4;-21;25
97;1;4;Campo Novo;8745;8696;49;-6;-13;7
97;1;4;Cascata;13002;12934;68;-2;-21;19
97;1;4;Cavalhada;29279;29195;84;10;-22;32
97;1;4;Centro;39286;39073;213;93;-5;98
97;1;4;Chácara das Pedras;6616;6545;71;-24;-29;5
97;1;4;Chapéu do Sol;2891;2858;33;-10;-13;3
97;1;4;Cidade Baixa;15299;15225;74;-6;-18;12
97;1;4;Coronel Aparício Borges;19257;19182;75;-13;-29;16
97;1;4;Costa e Silva;15822;15750;72;-14;-31;17
97;1;4;Cristal;31954;31866;88;25;-13;38
97;1;4;Cristo Redentor;16491;16304;187;26;-15;41
97;1;4;Espírito Santo;5566;5514;52;-16;-22;6
97;1;4;Extrema;1975;1965;10;-2;-3;1
97;1;4;Farrapos;19022;18942;80;19;-6;25
97;1;4;Farroupilha;908;778;130;-50;-32;-18
97;1;4;Floresta;11532;11461;71;-12;-19;7
97;1;4;Glória;17096;16947;149;-10;-32;22
97;1;4;Guarujá;4793;4738;55;-5;-10;5
97;1;4;Higienópolis;10694;10611;83;1;-17;18
97;1;4;Hípica;18635;18576;59;-2;-17;15
97;1;4;Humaitá;11527;11455;72;3;-9;12
97;1;4;Independência;8115;7954;161;-24;-26;2
97;1;4;Ipanema;13714;13649;65;2;-13;15
97;1;4;Jardim Botânico;12541;12376;165;-11;-30;19
97;1;4;Jardim Carvalho;25500;25309;191;35;-17;52
97;1;4;Jardim do Salso;4367;4297;70;-27;-30;3
97;1;4;Jardim Dona Leopoldina;17997;17915;82;-9;-35;26
97;1;4;Jardim Europa;2247;2178;69;-25;-25;0
97;1;4;Jardim Floresta;3280;3208;72;-14;-17;3
97;1;4;Jardim Isabel;2798;2740;58;-13;-16;3
97;1;4;Jardim Itu;17828;17739;89;-13;-36;23
97;1;4;Jardim Lindóia;7389;7311;78;-11;-20;9
97;1;4;Jardim Sabará;13517;13425;92;-8;-30;22
97;1;4;Jardim São Pedro;3930;3855;75;-18;-24;6
97;1;4;Lageado;4479;4444;35;-5;-7;2
97;1;4;Lami;4280;4258;22;-3;-4;1
97;1;4;Lomba do Pinheiro;58180;58081;99;46;-5;51
97;1;4;Mário Quintana;38153;38050;103;26;-21;47
97;1;4;Medianeira;11159;11088;71;-23;-30;7
97;1;4;Menino Deus;31758;31523;235;53;-22;75
97;1;4;Moinhos de Vento;11995;11800;195;1;-23;24
97;1;4;MontSerrat;11176;11093;83;-12;-25;13
97;1;4;Morro Santana;19355;19268;87;4;-20;24
97;1;4;Navegantes;4327;4255;72;-10;-15;5
97;1;4;Nonoai;25142;25057;85;2;-24;26
97;1;4;Parque Santa Fé;6343;6276;67;-30;-36;6
97;1;4;Partenon;48197;48056;141;51;-22;73
97;1;4;Passo DAreia;21966;21856;110;20;-16;36
97;1;4;Passo das Pedras;15901;15815;86;-5;-26;21
97;1;4;Pedra Redonda;238;182;56;-15;-15;0
97;1;4;Petrópolis;37510;37382;128;43;-16;59
97;1;4;Pitinga;4368;4330;38;-7;-9;2
97;1;4;Ponta Grossa;8730;8687;43;-5;-8;3
97;1;4;Praia de Belas;2239;2172;67;-30;-28;-2
97;1;4;Restinga;53673;53484;189;79;-5;84
97;1;4;Rio Branco;17593;17372;221;5;-29;34
97;1;4;Rubem Berta;33196;33084;112;14;-29;43
97;1;4;Santa Cecília;5809;5624;185;-28;-27;-1
97;1;4;Santa Maria Goretti;3498;3422;76;-14;-18;4
97;1;4;Santa Rosa de Lima;35384;35291;93;21;-14;35
97;1;4;Santa Tereza;39601;39490;111;29;-18;47
97;1;4;Santana;20816;20581;235;13;-28;41
97;1;4;Santo Antônio;13126;13032;94;-24;-39;15
97;1;4;São Caetano;767;733;34;-6;-6;0
97;1;4;São Geraldo;8681;8591;90;-10;-22;12
97;1;4;São João;12248;12145;103;5;-16;21
97;1;4;São Sebastião;7013;6929;84;-14;-25;11
97;1;4;Sarandi;59793;59647;146;60;-16;76
97;1;4;Serraria;6248;6190;58;-8;-13;5
97;1;4;Sétimo Céu;1291;1235;56;-16;-16;0
97;1;4;Teresópolis;14808;14615;193;-8;-26;18
97;1;4;Três Figueiras;4057;3972;85;-13;-18;5
97;1;4;Tristeza;16675;16599;76;4;-15;19
97;1;4;Vila Assunção;4519;4369;150;-12;-12;0
97;1;4;Vila Conceição;1361;1299;62;-6;-6;0
97;1;4;Vila Ipiranga;18656;18550;106;-7;-34;27
97;1;4;Vila Jardim;13177;13083;94;-16;-30;14
97;1;4;Vila João Pessoa;13032;12944;88;-22;-34;12
97;1;4;Vila Nova;32627;32415;212;46;-13;59
97;1;4;Vila São José;26555;26451;104;6;-25;31
98;2;4;Aberta dos Morros;7107;7069;38;-3;-3;0
98;2;4;Agronomia;2337;2299;38;13;13;0
98;2;4;Anchieta;2027;1976;51;6;4;2
98;2;4;Arquipélago;8335;8285;50;-4;1;-5
98;2;4;Auxiliadora;9609;9554;55;8;20;-12
98;2;4;Azenha;13781;13647;134;40;40;0
98;2;4;Bela Vista;11699;11644;55;-6;13;-19
98;2;4;Belém Novo;10088;10067;21;3;1;2
98;2;4;Belém Velho;10831;10781;50;3;3;0
98;2;4;Boa Vista;10002;9935;67;9;17;-8
98;2;4;Boa Vista do Sul;2281;2265;16;-1;0;-1
98;2;4;Bom Fim;11448;11425;23;4;22;-18
98;2;4;Bom Jesus;28661;28586;75;1;21;-20
98;2;4;Camaquã;17919;17849;70;14;17;-3
98;2;4;Campo Novo;8749;8697;52;4;1;3
98;2;4;Cascata;12997;12936;61;-5;2;-7
98;2;4;Cavalhada;29279;29203;76;0;8;-8
98;2;4;Centro;39317;39090;227;31;17;14
98;2;4;Chácara das Pedras;6622;6565;57;6;20;-14
98;2;4;Chapéu do Sol;2900;2867;33;9;9;0
98;2;4;Cidade Baixa;15303;15246;57;4;21;-17
98;2;4;Coronel Aparício Borges;19262;19196;66;5;14;-9
98;2;4;Costa e Silva;15843;15772;71;21;22;-1
98;2;4;Cristal;31957;31872;85;3;6;-3
98;2;4;Cristo Redentor;16475;16320;155;-16;16;-32
98;2;4;Espírito Santo;5569;5517;52;3;3;0
98;2;4;Extrema;1974;1963;11;-1;-2;1
98;2;4;Farrapos;19022;18942;80;0;0;0
98;2;4;Farroupilha;924;808;116;16;30;-14
98;2;4;Floresta;11530;11474;56;-2;13;-15
98;2;4;Glória;17108;16947;161;12;0;12
98;2;4;Guarujá;4791;4738;53;-2;0;-2
98;2;4;Higienópolis;10690;10613;77;-4;2;-6
98;2;4;Hípica;18644;18587;57;9;11;-2
98;2;4;Humaitá;11527;11455;72;0;0;0
98;2;4;Independência;8122;7971;151;7;17;-10
98;2;4;Ipanema;13717;13651;66;3;2;1
98;2;4;Jardim Botânico;12555;12404;151;14;28;-14
98;2;4;Jardim Carvalho;25486;25309;177;-14;0;-14
98;2;4;Jardim do Salso;4373;4310;63;6;13;-7
98;2;4;Jardim Dona Leopoldina;18007;17940;67;10;25;-15
98;2;4;Jardim Europa;2253;2189;64;6;11;-5
98;2;4;Jardim Floresta;3290;3218;72;10;10;0
98;2;4;Jardim Isabel;2800;2743;57;2;3;-1
98;2;4;Jardim Itu;17835;17758;77;7;19;-12
98;2;4;Jardim Lindóia;7390;7323;67;1;12;-11
98;2;4;Jardim Sabará;13520;13437;83;3;12;-9
98;2;4;Jardim São Pedro;3937;3869;68;7;14;-7
98;2;4;Lageado;4482;4447;35;3;3;0
98;2;4;Lami;4283;4259;24;3;1;2
98;2;4;Lomba do Pinheiro;58158;58080;78;-22;-1;-21
98;2;4;Mário Quintana;38146;38060;86;-7;10;-17
98;2;4;Medianeira;11156;11102;54;-3;14;-17
98;2;4;Menino Deus;31744;31540;204;-14;17;-31
98;2;4;Moinhos de Vento;11987;11817;170;-8;17;-25
98;2;4;MontSerrat;11180;11108;72;4;15;-11
98;2;4;Morro Santana;19356;19267;89;1;-1;2
98;2;4;Navegantes;4325;4253;72;-2;-2;0
98;2;4;Nonoai;25149;25066;83;7;9;-2
98;2;4;Parque Santa Fé;6348;6291;57;5;15;-10
98;2;4;Partenon;48171;48064;107;-26;8;-34
98;2;4;Passo DAreia;21966;21862;104;0;6;-6
98;2;4;Passo das Pedras;15901;15823;78;0;8;-8
98;2;4;Pedra Redonda;240;187;53;2;5;-3
98;2;4;Petrópolis;37490;37387;103;-20;5;-25
98;2;4;Pitinga;4376;4335;41;8;5;3
98;2;4;Ponta Grossa;8733;8686;47;3;-1;4
98;2;4;Praia de Belas;2244;2187;57;5;15;-10
98;2;4;Restinga;53644;53482;162;-29;-2;-27
98;2;4;Rio Branco;17574;17378;196;-19;6;-25
98;2;4;Rubem Berta;33183;33102;81;-13;18;-31
98;2;4;Santa Cecília;5796;5624;172;-13;0;-13
98;2;4;Santa Maria Goretti;3501;3422;79;3;0;3
98;2;4;Santa Rosa de Lima;35385;35294;91;1;3;-2
98;2;4;Santa Tereza;39582;39487;95;-19;-3;-16
98;2;4;Santana;20803;20582;221;-13;1;-14
98;2;4;Santo Antônio;13113;13045;68;-13;13;-26
98;2;4;São Caetano;764;730;34;-3;-3;0
98;2;4;São Geraldo;8680;8595;85;-1;4;-5
98;2;4;São João;12241;12145;96;-7;0;-7
98;2;4;São Sebastião;7015;6941;74;2;12;-10
98;2;4;Sarandi;59763;59649;114;-30;2;-32
98;2;4;Serraria;6249;6191;58;1;1;0
98;2;4;Sétimo Céu;1299;1243;56;8;8;0
98;2;4;Teresópolis;14800;14613;187;-8;-2;-6
98;2;4;Três Figueiras;4060;3974;86;3;2;1
98;2;4;Tristeza;16676;16604;72;1;5;-4
98;2;4;Vila Assunção;4508;4365;143;-11;-4;-7
98;2;4;Vila Conceição;1362;1299;63;1;0;1
98;2;4;Vila Ipiranga;18653;18558;95;-3;8;-11
98;2;4;Vila Jardim;13176;13088;88;-1;5;-6
98;2;4;Vila João Pessoa;13036;12961;75;4;17;-13
98;2;4;Vila Nova;32603;32415;188;-24;0;-24
98;2;4;Vila São José;26557;26457;100;2;6;-4
99;3;4;Aberta dos Morros;7107;7068;39;0;-1;1
99;3;4;Agronomia;2339;2302;37;2;3;-1
99;3;4;Anchieta;2030;1979;51;3;3;0
99;3;4;Arquipélago;8339;8286;53;4;1;3
99;3;4;Auxiliadora;9615;9574;41;6;20;-14
99;3;4;Azenha;13816;13691;125;35;44;-9
99;3;4;Bela Vista;11700;11666;34;1;22;-21
99;3;4;Belém Novo;10088;10068;20;0;1;-1
99;3;4;Belém Velho;10839;10788;51;8;7;1
99;3;4;Boa Vista;10009;9956;53;7;21;-14
99;3;4;Boa Vista do Sul;2283;2267;16;2;2;0
99;3;4;Bom Fim;11464;11447;17;16;22;-6
99;3;4;Bom Jesus;28670;28604;66;9;18;-9
99;3;4;Camaquã;17923;17870;53;4;21;-17
99;3;4;Campo Novo;8750;8701;49;1;4;-3
99;3;4;Cascata;13001;12950;51;4;14;-10
99;3;4;Cavalhada;29291;29225;66;12;22;-10
99;3;4;Centro;39288;39087;201;-29;-3;-26
99;3;4;Chácara das Pedras;6630;6581;49;8;16;-8
99;3;4;Chapéu do Sol;2902;2869;33;2;2;0
99;3;4;Cidade Baixa;15283;15251;32;-20;5;-25
99;3;4;Coronel Aparício Borges;19256;19222;34;-6;26;-32
99;3;4;Costa e Silva;15841;15794;47;-2;22;-24
99;3;4;Cristal;31941;31883;58;-16;11;-27
99;3;4;Cristo Redentor;16498;16353;145;23;33;-10
99;3;4;Espírito Santo;5574;5525;49;5;8;-3
99;3;4;Extrema;1978;1966;12;4;3;1
99;3;4;Farrapos;19019;18944;75;-3;2;-5
99;3;4;Farroupilha;943;834;109;19;26;-7
99;3;4;Floresta;11536;11493;43;6;19;-13
99;3;4;Glória;17124;16976;148;16;29;-13
99;3;4;Guarujá;4792;4740;52;1;2;-1
99;3;4;Higienópolis;10692;10625;67;2;12;-10
99;3;4;Hípica;18640;18589;51;-4;2;-6
99;3;4;Humaitá;11527;11457;70;0;2;-2
99;3;4;Independência;8134;7992;142;12;21;-9
99;3;4;Ipanema;13722;13658;64;5;7;-2
99;3;4;Jardim Botânico;12554;12422;132;-1;18;-19
99;3;4;Jardim Carvalho;25521;25332;189;35;23;12
99;3;4;Jardim do Salso;4371;4321;50;-2;11;-13
99;3;4;Jardim Dona Leopoldina;18011;17969;42;4;29;-25
99;3;4;Jardim Europa;2260;2208;52;7;19;-12
99;3;4;Jardim Floresta;3299;3235;64;9;17;-8
99;3;4;Jardim Isabel;2803;2748;55;3;5;-2
99;3;4;Jardim Itu;17823;17774;49;-12;16;-28
99;3;4;Jardim Lindóia;7398;7337;61;8;14;-6
99;3;4;Jardim Sabará;13512;13457;55;-8;20;-28
99;3;4;Jardim São Pedro;3945;3883;62;8;14;-6
99;3;4;Lageado;4482;4447;35;0;0;0
99;3;4;Lami;4284;4261;23;1;2;-1
99;3;4;Lomba do Pinheiro;58164;58081;83;6;1;5
99;3;4;Mário Quintana;38143;38078;65;-3;18;-21
99;3;4;Medianeira;11148;11114;34;-8;12;-20
99;3;4;Menino Deus;31756;31555;201;12;15;-3
99;3;4;Moinhos de Vento;11989;11827;162;2;10;-8
99;3;4;MontSerrat;11174;11121;53;-6;13;-19
99;3;4;Morro Santana;19352;19283;69;-4;16;-20
99;3;4;Navegantes;4325;4253;72;0;0;0
99;3;4;Nonoai;25127;25082;45;-22;16;-38
99;3;4;Parque Santa Fé;6371;6323;48;23;32;-9
99;3;4;Partenon;48168;48081;87;-3;17;-20
99;3;4;Passo DAreia;21958;21874;84;-8;12;-20
99;3;4;Passo das Pedras;15896;15841;55;-5;18;-23
99;3;4;Pedra Redonda;239;189;50;-1;2;-3
99;3;4;Petrópolis;37479;37393;86;-11;6;-17
99;3;4;Pitinga;4379;4336;43;3;1;2
99;3;4;Ponta Grossa;8733;8686;47;0;0;0
99;3;4;Praia de Belas;2248;2202;46;4;15;-11
99;3;4;Restinga;53624;53482;142;-20;0;-20
99;3;4;Rio Branco;17579;17396;183;5;18;-13
99;3;4;Rubem Berta;33161;33114;47;-22;12;-34
99;3;4;Santa Cecília;5796;5645;151;0;21;-21
99;3;4;Santa Maria Goretti;3501;3429;72;0;7;-7
99;3;4;Santa Rosa de Lima;35366;35298;68;-19;4;-23
99;3;4;Santa Tereza;39572;39503;69;-10;16;-26
99;3;4;Santana;20795;20596;199;-8;14;-22
99;3;4;Santo Antônio;13100;13060;40;-13;15;-28
99;3;4;São Caetano;767;733;34;3;3;0
99;3;4;São Geraldo;8678;8607;71;-2;12;-14
99;3;4;São João;12241;12154;87;0;9;-9
99;3;4;São Sebastião;7014;6953;61;-1;12;-13
99;3;4;Sarandi;59751;59658;93;-12;9;-21
99;3;4;Serraria;6248;6190;58;-1;-1;0
99;3;4;Sétimo Céu;1306;1252;54;7;9;-2
99;3;4;Teresópolis;14793;14623;170;-7;10;-17
99;3;4;Três Figueiras;4058;3982;76;-2;8;-10
99;3;4;Tristeza;16672;16614;58;-4;10;-14
99;3;4;Vila Assunção;4508;4369;139;0;4;-4
99;3;4;Vila Conceição;1361;1297;64;-1;-2;1
99;3;4;Vila Ipiranga;18636;18573;63;-17;15;-32
99;3;4;Vila Jardim;13172;13103;69;-4;15;-19
99;3;4;Vila João Pessoa;13024;12968;56;-12;7;-19
99;3;4;Vila Nova;32596;32421;175;-7;6;-13
99;3;4;Vila São José;26536;26465;71;-21;8;-29
100;4;4;Aberta dos Morros;6814;6452;362;-293;-616;323
100;4;4;Agronomia;1740;1675;65;-599;-627;28
100;4;4;Anchieta;1394;1359;35;-636;-620;-16
100;4;4;Arquipélago;8164;7676;488;-175;-610;435
100;4;4;Auxiliadora;9173;8644;529;-442;-930;488
100;4;4;Azenha;13462;12672;790;-354;-1019;665
100;4;4;Bela Vista;11310;10622;688;-390;-1044;654
100;4;4;Belém Novo;10043;9566;477;-45;-502;457
100;4;4;Belém Velho;10714;10075;639;-125;-713;588
100;4;4;Boa Vista;9549;8981;568;-460;-975;515
100;4;4;Boa Vista do Sul;1812;1772;40;-471;-495;24
100;4;4;Bom Fim;10991;10365;626;-473;-1082;609
100;4;4;Bom Jesus;29336;27550;1786;666;-1054;1720
100;4;4;Camaquã;18010;16976;1034;87;-894;981
100;4;4;Campo Novo;8422;7978;444;-328;-723;395
100;4;4;Cascata;12862;12127;735;-139;-823;684
100;4;4;Cavalhada;30034;28318;1716;743;-907;1650
100;4;4;Centro;40519;38247;2272;1231;-840;2071
100;4;4;Chácara das Pedras;5845;5536;309;-785;-1045;260
100;4;4;Chapéu do Sol;2332;2272;60;-570;-597;27
100;4;4;Cidade Baixa;15114;14229;885;-169;-1022;853
100;4;4;Coronel Aparício Borges;19315;18192;1123;59;-1030;1089
100;4;4;Costa e Silva;15654;14803;851;-187;-991;804
100;4;4;Cristal;32920;31067;1853;979;-816;1795
100;4;4;Cristo Redentor;16245;15295;950;-253;-1058;805
100;4;4;Espírito Santo;5046;4799;247;-528;-726;198
100;4;4;Extrema;1583;1549;34;-395;-417;22
100;4;4;Farrapos;19322;18266;1056;303;-678;981
100;4;4;Farroupilha;438;438;0;-505;-396;-109
100;4;4;Floresta;11226;10545;681;-310;-948;638
100;4;4;Glória;16962;15954;1008;-162;-1022;860
100;4;4;Guarujá;4271;4069;202;-521;-671;150
100;4;4;Higienópolis;10267;9632;635;-425;-993;568
100;4;4;Hípica;18928;17934;994;288;-655;943
100;4;4;Humaitá;11401;10764;637;-126;-693;567
100;4;4;Independência;7383;6940;443;-751;-1052;301
100;4;4;Ipanema;13688;12935;753;-34;-723;689
100;4;4;Jardim Botânico;12036;11283;753;-518;-1139;621
100;4;4;Jardim Carvalho;25987;24396;1591;466;-936;1402
100;4;4;Jardim do Salso;3473;3290;183;-898;-1031;133
100;4;4;Jardim Dona Leopoldina;17932;16898;1034;-79;-1071;992
100;4;4;Jardim Europa;1310;1288;22;-950;-920;-30
100;4;4;Jardim Floresta;2488;2391;97;-811;-844;33
100;4;4;Jardim Isabel;2064;2028;36;-739;-720;-19
100;4;4;Jardim Itu;17874;16797;1077;51;-977;1028
100;4;4;Jardim Lindóia;6808;6407;401;-590;-930;340
100;4;4;Jardim Sabará;13294;12487;807;-218;-970;752
100;4;4;Jardim São Pedro;3155;2978;177;-790;-905;115
100;4;4;Lageado;4045;3851;194;-437;-596;159
100;4;4;Lami;3992;3785;207;-292;-476;184
100;4;4;Lomba do Pinheiro;60721;57435;3286;2557;-646;3203
100;4;4;Mário Quintana;39425;37268;2157;1282;-810;2092
100;4;4;Medianeira;10754;10111;643;-394;-1003;609
100;4;4;Menino Deus;32652;30629;2023;896;-926;1822
100;4;4;Moinhos de Vento;11569;10824;745;-420;-1003;583
100;4;4;MontSerrat;10775;10104;671;-399;-1017;618
100;4;4;Morro Santana;19624;18475;1149;272;-808;1080
100;4;4;Navegantes;3673;3471;202;-652;-782;130
100;4;4;Nonoai;25645;24174;1471;518;-908;1426
100;4;4;Parque Santa Fé;5680;5366;314;-691;-957;266
100;4;4;Partenon;49922;47085;2837;1754;-996;2750
100;4;4;Passo DAreia;22300;20953;1347;342;-921;1263
100;4;4;Passo das Pedras;15829;14920;909;-67;-921;854
100;4;4;Pedra Redonda;156;129;27;-83;-60;-23
100;4;4;Petrópolis;38778;36405;2373;1299;-988;2287
100;4;4;Pitinga;3961;3749;212;-418;-587;169
100;4;4;Ponta Grossa;8604;8162;442;-129;-524;395
100;4;4;Praia de Belas;1517;1394;123;-731;-808;77
100;4;4;Restinga;55915;52993;2922;2291;-489;2780
100;4;4;Rio Branco;17495;16373;1122;-84;-1023;939
100;4;4;Rubem Berta;34211;32284;1927;1050;-830;1880
100;4;4;Santa Cecília;4886;4576;310;-910;-1069;159
100;4;4;Santa Maria Goretti;2825;2596;229;-676;-833;157
100;4;4;Santa Rosa de Lima;36626;34599;2027;1260;-699;1959
100;4;4;Santa Tereza;41014;38639;2375;1442;-864;2306
100;4;4;Santana;21049;19640;1409;254;-956;1210
100;4;4;Santo Antônio;13007;12120;887;-93;-940;847
100;4;4;São Caetano;605;410;195;-162;-323;161
100;4;4;São Geraldo;8417;7823;594;-261;-784;523
100;4;4;São João;12246;11366;880;5;-788;793
100;4;4;São Sebastião;6500;6073;427;-514;-880;366
100;4;4;Sarandi;62635;58986;3649;2884;-672;3556
100;4;4;Serraria;6096;5713;383;-152;-477;325
100;4;4;Sétimo Céu;759;661;98;-547;-591;44
100;4;4;Teresópolis;14800;13739;1061;7;-884;891
100;4;4;Três Figueiras;3429;3045;384;-629;-937;308
100;4;4;Tristeza;16918;15902;1016;246;-712;958
100;4;4;Vila Assunção;4068;3704;364;-440;-665;225
100;4;4;Vila Conceição;932;759;173;-429;-538;109
100;4;4;Vila Ipiranga;19018;17707;1311;382;-866;1248
100;4;4;Vila Jardim;13215;12226;989;43;-877;920
100;4;4;Vila João Pessoa;12915;12026;889;-109;-942;833
100;4;4;Vila Nova;33907;31865;2042;1311;-556;1867
100;4;4;Vila São José;27531;25776;1755;995;-689;1684
101;5;4;Aberta dos Morros;6809;6443;366;-5;-9;4
101;5;4;Agronomia;1735;1674;61;-5;-1;-4
101;5;4;Anchieta;1383;1354;29;-11;-5;-6
101;5;4;Arquipélago;8175;7674;501;11;-2;13
101;5;4;Auxiliadora;9172;8640;532;-1;-4;3
101;5;4;Azenha;13446;12635;811;-16;-37;21
101;5;4;Bela Vista;11303;10616;687;-7;-6;-1
101;5;4;Belém Novo;10052;9568;484;9;2;7
101;5;4;Belém Velho;10708;10061;647;-6;-14;8
101;5;4;Boa Vista;9551;8975;576;2;-6;8
101;5;4;Boa Vista do Sul;1808;1769;39;-4;-3;-1
101;5;4;Bom Fim;10965;10353;612;-26;-12;-14
101;5;4;Bom Jesus;29367;27525;1842;31;-25;56
101;5;4;Camaquã;18009;16953;1056;-1;-23;22
101;5;4;Campo Novo;8420;7965;455;-2;-13;11
101;5;4;Cascata;12877;12115;762;15;-12;27
101;5;4;Cavalhada;30075;28299;1776;41;-19;60
101;5;4;Centro;40576;38234;2342;57;-13;70
101;5;4;Chácara das Pedras;5827;5527;300;-18;-9;-9
101;5;4;Chapéu do Sol;2317;2267;50;-15;-5;-10
101;5;4;Cidade Baixa;15122;14209;913;8;-20;28
101;5;4;Coronel Aparício Borges;19320;18163;1157;5;-29;34
101;5;4;Costa e Silva;15645;14774;871;-9;-29;20
101;5;4;Cristal;32970;31055;1915;50;-12;62
101;5;4;Cristo Redentor;16242;15273;969;-3;-22;19
101;5;4;Espírito Santo;5039;4794;245;-7;-5;-2
101;5;4;Extrema;1584;1549;35;1;0;1
101;5;4;Farrapos;19344;18260;1084;22;-6;28
101;5;4;Farroupilha;437;437;0;-1;-1;0
101;5;4;Floresta;11221;10528;693;-5;-17;12
101;5;4;Glória;16975;15923;1052;13;-31;44
101;5;4;Guarujá;4270;4067;203;-1;-2;1
101;5;4;Higienópolis;10274;9630;644;7;-2;9
101;5;4;Hípica;18941;17921;1020;13;-13;26
101;5;4;Humaitá;11420;10762;658;19;-2;21
101;5;4;Independência;7375;6936;439;-8;-4;-4
101;5;4;Ipanema;13696;12931;765;8;-4;12
101;5;4;Jardim Botânico;12039;11270;769;3;-13;16
101;5;4;Jardim Carvalho;26015;24376;1639;28;-20;48
101;5;4;Jardim do Salso;3458;3282;176;-15;-8;-7
101;5;4;Jardim Dona Leopoldina;17926;16865;1061;-6;-33;27
101;5;4;Jardim Europa;1285;1279;6;-25;-9;-16
101;5;4;Jardim Floresta;2476;2390;86;-12;-1;-11
101;5;4;Jardim Isabel;2054;2026;28;-10;-2;-8
101;5;4;Jardim Itu;17889;16776;1113;15;-21;36
101;5;4;Jardim Lindóia;6815;6411;404;7;4;3
101;5;4;Jardim Sabará;13300;12472;828;6;-15;21
101;5;4;Jardim São Pedro;3146;2970;176;-9;-8;-1
101;5;4;Lageado;4044;3852;192;-1;1;-2
101;5;4;Lami;3992;3786;206;0;1;-1
101;5;4;Lomba do Pinheiro;60789;57433;3356;68;-2;70
101;5;4;Mário Quintana;39467;37255;2212;42;-13;55
101;5;4;Medianeira;10741;10082;659;-13;-29;16
101;5;4;Menino Deus;32679;30600;2079;27;-29;56
101;5;4;Moinhos de Vento;11542;10797;745;-27;-27;0
101;5;4;MontSerrat;10781;10091;690;6;-13;19
101;5;4;Morro Santana;19646;18460;1186;22;-15;37
101;5;4;Navegantes;3666;3468;198;-7;-3;-4
101;5;4;Nonoai;25671;24158;1513;26;-16;42
101;5;4;Parque Santa Fé;5659;5343;316;-21;-23;2
101;5;4;Partenon;49995;47057;2938;73;-28;101
101;5;4;Passo DAreia;22324;20942;1382;24;-11;35
101;5;4;Passo das Pedras;15835;14900;935;6;-20;26
101;5;4;Pedra Redonda;143;124;19;-13;-5;-8
101;5;4;Petrópolis;38835;36387;2448;57;-18;75
101;5;4;Pitinga;3947;3742;205;-14;-7;-7
101;5;4;Ponta Grossa;8585;8145;440;-19;-17;-2
101;5;4;Praia de Belas;1478;1390;88;-39;-4;-35
101;5;4;Restinga;55951;52984;2967;36;-9;45
101;5;4;Rio Branco;17487;16331;1156;-8;-42;34
101;5;4;Rubem Berta;34221;32267;1954;10;-17;27
101;5;4;Santa Cecília;4871;4570;301;-15;-6;-9
101;5;4;Santa Maria Goretti;2809;2586;223;-16;-10;-6
101;5;4;Santa Rosa de Lima;36633;34583;2050;7;-16;23
101;5;4;Santa Tereza;41029;38623;2406;15;-16;31
101;5;4;Santana;21027;19599;1428;-22;-41;19
101;5;4;Santo Antônio;12974;12088;886;-33;-32;-1
101;5;4;São Caetano;599;407;192;-6;-3;-3
101;5;4;São Geraldo;8403;7803;600;-14;-20;6
101;5;4;São João;12228;11342;886;-18;-24;6
101;5;4;São Sebastião;6484;6062;422;-16;-11;-5
101;5;4;Sarandi;62629;58959;3670;-6;-27;21
101;5;4;Serraria;6094;5706;388;-2;-7;5
101;5;4;Sétimo Céu;748;657;91;-11;-4;-7
101;5;4;Teresópolis;14768;13711;1057;-32;-28;-4
101;5;4;Três Figueiras;3396;3020;376;-33;-25;-8
101;5;4;Tristeza;16923;15894;1029;5;-8;13
101;5;4;Vila Assunção;4039;3696;343;-29;-8;-21
101;5;4;Vila Conceição;921;750;171;-11;-9;-2
101;5;4;Vila Ipiranga;18988;17668;1320;-30;-39;9
101;5;4;Vila Jardim;13170;12169;1001;-45;-57;12
101;5;4;Vila João Pessoa;12884;11987;897;-31;-39;8
101;5;4;Vila Nova;33895;31840;2055;-12;-25;13
101;5;4;Vila São José;27508;25738;1770;-23;-38;15
102;6;4;Aberta dos Morros;6630;5878;752;-179;-565;386
102;6;4;Agronomia;1345;1169;176;-390;-505;115
102;6;4;Anchieta;1123;1005;118;-260;-349;89
102;6;4;Arquipélago;8084;7110;974;-91;-564;473
102;6;4;Auxiliadora;8832;7712;1120;-340;-928;588
102;6;4;Azenha;13224;11592;1632;-222;-1043;821
102;6;4;Bela Vista;10986;9596;1390;-317;-1020;703
102;6;4;Belém Novo;10136;9163;973;84;-405;489
102;6;4;Belém Velho;10616;9403;1213;-92;-658;566
102;6;4;Boa Vista;9181;8021;1160;-370;-954;584
102;6;4;Boa Vista do Sul;1488;1395;93;-320;-374;54
102;6;4;Bom Fim;10603;9326;1277;-362;-1027;665
102;6;4;Bom Jesus;30051;26573;3478;684;-952;1636
102;6;4;Camaquã;18131;16133;1998;122;-820;942
102;6;4;Campo Novo;8196;7311;885;-224;-654;430
102;6;4;Cascata;12815;11355;1460;-62;-760;698
102;6;4;Cavalhada;30743;27433;3310;668;-866;1534
102;6;4;Centro;41736;37404;4332;1160;-830;1990
102;6;4;Chácara das Pedras;5166;4523;643;-661;-1004;343
102;6;4;Chapéu do Sol;1885;1755;130;-432;-512;80
102;6;4;Cidade Baixa;15055;13265;1790;-67;-944;877
102;6;4;Coronel Aparício Borges;19415;17180;2235;95;-983;1078
102;6;4;Costa e Silva;15569;13834;1735;-76;-940;864
102;6;4;Cristal;33861;30261;3600;891;-794;1685
102;6;4;Cristo Redentor;16211;14318;1893;-31;-955;924
102;6;4;Espírito Santo;4662;4166;496;-377;-628;251
102;6;4;Extrema;1225;1173;52;-359;-376;17
102;6;4;Farrapos;19746;17641;2105;402;-619;1021
102;6;4;Farroupilha;442;440;2;5;3;2
102;6;4;Floresta;10947;9650;1297;-274;-878;604
102;6;4;Glória;16955;14975;1980;-20;-948;928
102;6;4;Guarujá;3870;3498;372;-400;-569;169
102;6;4;Higienópolis;9914;8705;1209;-360;-925;565
102;6;4;Hípica;19295;17335;1960;354;-586;940
102;6;4;Humaitá;11339;10109;1230;-81;-653;572
102;6;4;Independência;6784;5952;832;-591;-984;393
102;6;4;Ipanema;13702;12241;1461;6;-690;696
102;6;4;Jardim Botânico;11639;10222;1417;-400;-1048;648
102;6;4;Jardim Carvalho;26465;23445;3020;450;-931;1381
102;6;4;Jardim do Salso;2633;2266;367;-825;-1016;191
102;6;4;Jardim Dona Leopoldina;17865;15829;2036;-61;-1036;975
102;6;4;Jardim Europa;1211;1124;87;-74;-155;81
102;6;4;Jardim Floresta;1875;1664;211;-601;-726;125
102;6;4;Jardim Isabel;1529;1427;102;-525;-599;74
102;6;4;Jardim Itu;17895;15787;2108;6;-989;995
102;6;4;Jardim Lindóia;6302;5541;761;-513;-870;357
102;6;4;Jardim Sabará;13055;11501;1554;-245;-971;726
102;6;4;Jardim São Pedro;2418;2084;334;-728;-886;158
102;6;4;Lageado;3686;3372;314;-358;-480;122
102;6;4;Lami;3690;3390;300;-302;-396;94
102;6;4;Lomba do Pinheiro;62973;56744;6229;2184;-689;2873
102;6;4;Mário Quintana;40723;36418;4305;1256;-837;2093
102;6;4;Medianeira;10369;9110;1259;-372;-972;600
102;6;4;Menino Deus;33452;29628;3824;773;-972;1745
102;6;4;Moinhos de Vento;11245;9865;1380;-297;-932;635
102;6;4;MontSerrat;10385;9090;1295;-396;-1001;605
102;6;4;Morro Santana;19879;17618;2261;233;-842;1075
102;6;4;Navegantes;3089;2717;372;-577;-751;174
102;6;4;Nonoai;26130;23245;2885;459;-913;1372
102;6;4;Parque Santa Fé;4989;4394;595;-670;-949;279
102;6;4;Partenon;51592;46011;5581;1597;-1046;2643
102;6;4;Passo DAreia;22674;19993;2681;350;-949;1299
102;6;4;Passo das Pedras;15737;13918;1819;-98;-982;884
102;6;4;Pedra Redonda;124;124;0;-19;0;-19
102;6;4;Petrópolis;40001;35357;4644;1166;-1030;2196
102;6;4;Pitinga;3548;3207;341;-399;-535;136
102;6;4;Ponta Grossa;8404;7605;799;-181;-540;359
102;6;4;Praia de Belas;1246;1120;126;-232;-270;38
102;6;4;Restinga;57513;52217;5296;1562;-767;2329
102;6;4;Rio Branco;17416;15290;2126;-71;-1041;970
102;6;4;Rubem Berta;35029;31359;3670;808;-908;1716
102;6;4;Santa Cecília;4094;3570;524;-777;-1000;223
102;6;4;Santa Maria Goretti;2090;1801;289;-719;-785;66
102;6;4;Santa Rosa de Lima;37630;33815;3815;997;-768;1765
102;6;4;Santa Tereza;42279;37704;4575;1250;-919;2169
102;6;4;Santana;21085;18537;2548;58;-1062;1120
102;6;4;Santo Antônio;12642;11072;1570;-332;-1016;684
102;6;4;São Caetano;529;374;155;-70;-33;-37
102;6;4;São Geraldo;7998;6989;1009;-405;-814;409
102;6;4;São João;11978;10495;1483;-250;-847;597
102;6;4;São Sebastião;5897;5169;728;-587;-893;306
102;6;4;Sarandi;64723;58106;6617;2094;-853;2947
102;6;4;Serraria;5682;5090;592;-412;-616;204
102;6;4;Sétimo Céu;714;653;61;-34;-4;-30
102;6;4;Teresópolis;14460;12709;1751;-308;-1002;694
102;6;4;Três Figueiras;2554;2108;446;-842;-912;70
102;6;4;Tristeza;16998;15171;1827;75;-723;798
102;6;4;Vila Assunção;3356;2958;398;-683;-738;55
102;6;4;Vila Conceição;832;668;164;-89;-82;-7
102;6;4;Vila Ipiranga;18983;16676;2307;-5;-992;987
102;6;4;Vila Jardim;12814;11177;1637;-356;-992;636
102;6;4;Vila João Pessoa;12522;10957;1565;-362;-1030;668
102;6;4;Vila Nova;34738;31062;3676;843;-778;1621
102;6;4;Vila São José;28009;24850;3159;501;-888;1389
103;7;4;Aberta dos Morros;6268;4856;1412;-362;-1022;660
103;7;4;Agronomia;1264;930;334;-81;-239;158
103;7;4;Anchieta;1033;782;251;-90;-223;133
103;7;4;Arquipélago;7626;5919;1707;-458;-1191;733
103;7;4;Auxiliadora;8234;6161;2073;-598;-1551;953
103;7;4;Azenha;12519;9352;3167;-705;-2240;1535
103;7;4;Bela Vista;10316;7737;2579;-670;-1859;1189
103;7;4;Belém Novo;10063;8415;1648;-73;-748;675
103;7;4;Belém Velho;10060;7900;2160;-556;-1503;947
103;7;4;Boa Vista;8559;6367;2192;-622;-1654;1032
103;7;4;Boa Vista do Sul;1447;1250;197;-41;-145;104
103;7;4;Bom Fim;9874;7428;2446;-729;-1898;1169
103;7;4;Bom Jesus;30681;24170;6511;630;-2403;3033
103;7;4;Camaquã;17964;14208;3756;-167;-1925;1758
103;7;4;Campo Novo;7736;6114;1622;-460;-1197;737
103;7;4;Cascata;12197;9530;2667;-618;-1825;1207
103;7;4;Cavalhada;31726;25521;6205;983;-1912;2895
103;7;4;Centro;43993;35618;8375;2257;-1786;4043
103;7;4;Chácara das Pedras;4823;3558;1265;-343;-965;622
103;7;4;Chapéu do Sol;1793;1480;313;-92;-275;183
103;7;4;Cidade Baixa;14324;11094;3230;-731;-2171;1440
103;7;4;Coronel Aparício Borges;18977;14782;4195;-438;-2398;1960
103;7;4;Costa e Silva;14869;11594;3275;-700;-2240;1540
103;7;4;Cristal;35156;28546;6610;1295;-1715;3010
103;7;4;Cristo Redentor;15739;11995;3744;-472;-2323;1851
103;7;4;Espírito Santo;4418;3469;949;-244;-697;453
103;7;4;Extrema;1209;1049;160;-16;-124;108
103;7;4;Farrapos;20059;16241;3818;313;-1400;1713
103;7;4;Farroupilha;318;223;95;-124;-217;93
103;7;4;Floresta;10283;7908;2375;-664;-1742;1078
103;7;4;Glória;16430;12761;3669;-525;-2214;1689
103;7;4;Guarujá;3669;2927;742;-201;-571;370
103;7;4;Higienópolis;9320;7018;2302;-594;-1687;1093
103;7;4;Hípica;19547;16114;3433;252;-1221;1473
103;7;4;Humaitá;10881;8648;2233;-458;-1461;1003
103;7;4;Independência;6571;4736;1835;-213;-1216;1003
103;7;4;Ipanema;13486;10851;2635;-216;-1390;1174
103;7;4;Jardim Botânico;11052;8233;2819;-587;-1989;1402
103;7;4;Jardim Carvalho;26833;21349;5484;368;-2096;2464
103;7;4;Jardim do Salso;2428;1530;898;-205;-736;531
103;7;4;Jardim Dona Leopoldina;17096;13383;3713;-769;-2446;1677
103;7;4;Jardim Europa;1217;664;553;6;-460;466
103;7;4;Jardim Floresta;1711;1128;583;-164;-536;372
103;7;4;Jardim Isabel;1459;1006;453;-70;-421;351
103;7;4;Jardim Itu;17240;13440;3800;-655;-2347;1692
103;7;4;Jardim Lindóia;6083;4449;1634;-219;-1092;873
103;7;4;Jardim Sabará;12289;9475;2814;-766;-2026;1260
103;7;4;Jardim São Pedro;2224;1428;796;-194;-656;462
103;7;4;Lageado;3471;2903;568;-215;-469;254
103;7;4;Lami;3538;3044;494;-152;-346;194
103;7;4;Lomba do Pinheiro;66406;55461;10945;3433;-1283;4716
103;7;4;Mário Quintana;42494;34569;7925;1771;-1849;3620
103;7;4;Medianeira;9722;7379;2343;-647;-1731;1084
103;7;4;Menino Deus;34356;27464;6892;904;-2164;3068
103;7;4;Moinhos de Vento;10756;7981;2775;-489;-1884;1395
103;7;4;MontSerrat;9782;7398;2384;-603;-1692;1089
103;7;4;Morro Santana;19684;15695;3989;-195;-1923;1728
103;7;4;Navegantes;3134;1995;1139;45;-722;767
103;7;4;Nonoai;26485;21207;5278;355;-2038;2393
103;7;4;Parque Santa Fé;4637;3282;1355;-352;-1112;760
103;7;4;Partenon;54119;43611;10508;2527;-2400;4927
103;7;4;Passo DAreia;22724;17764;4960;50;-2229;2279
103;7;4;Passo das Pedras;14996;11682;3314;-741;-2236;1495
103;7;4;Pedra Redonda;82;54;28;-42;-70;28
103;7;4;Petrópolis;41352;32996;8356;1351;-2361;3712
103;7;4;Pitinga;3348;2600;748;-200;-607;407
103;7;4;Ponta Grossa;8027;6681;1346;-377;-924;547
103;7;4;Praia de Belas;1334;708;626;88;-412;500
103;7;4;Restinga;60039;51117;8922;2526;-1100;3626
103;7;4;Rio Branco;16730;12877;3853;-686;-2413;1727
103;7;4;Rubem Berta;36082;29344;6738;1053;-2015;3068
103;7;4;Santa Cecília;3827;2551;1276;-267;-1019;752
103;7;4;Santa Maria Goretti;1982;1246;736;-108;-555;447
103;7;4;Santa Rosa de Lima;38783;32197;6586;1153;-1618;2771
103;7;4;Santa Tereza;44077;35753;8324;1798;-1951;3749
103;7;4;Santana;20755;16131;4624;-330;-2406;2076
103;7;4;Santo Antônio;11940;9128;2812;-702;-1944;1242
103;7;4;São Caetano;494;252;242;-35;-122;87
103;7;4;São Geraldo;7491;5429;2062;-507;-1560;1053
103;7;4;São João;11489;8808;2681;-489;-1687;1198
103;7;4;São Sebastião;5712;3879;1833;-185;-1290;1105
103;7;4;Sarandi;67586;56272;11314;2863;-1834;4697
103;7;4;Serraria;5392;4189;1203;-290;-901;611
103;7;4;Sétimo Céu;597;404;193;-117;-249;132
103;7;4;Teresópolis;13682;10690;2992;-778;-2019;1241
103;7;4;Três Figueiras;2602;1440;1162;48;-668;716
103;7;4;Tristeza;16658;13638;3020;-340;-1533;1193
103;7;4;Vila Assunção;3209;2238;971;-147;-720;573
103;7;4;Vila Conceição;748;435;313;-84;-233;149
103;7;4;Vila Ipiranga;18253;14359;3894;-730;-2317;1587
103;7;4;Vila Jardim;12099;8995;3104;-715;-2182;1467
103;7;4;Vila João Pessoa;11830;8810;3020;-692;-2147;1455
103;7;4;Vila Nova;35620;29478;6142;882;-1584;2466
103;7;4;Vila São José;28163;22701;5462;154;-2149;2303
104;8;4;Aberta dos Morros;6292;5041;1251;24;185;-161
104;8;4;Agronomia;1314;1119;195;50;189;-139
104;8;4;Anchieta;1081;916;165;48;134;-86
104;8;4;Arquipélago;7755;6124;1631;129;205;-76
104;8;4;Auxiliadora;8216;6387;1829;-18;226;-244
104;8;4;Azenha;12355;9721;2634;-164;369;-533
104;8;4;Bela Vista;10312;8012;2300;-4;275;-279
104;8;4;Belém Novo;10109;8441;1668;46;26;20
104;8;4;Belém Velho;10167;8045;2122;107;145;-38
104;8;4;Boa Vista;8592;6658;1934;33;291;-258
104;8;4;Boa Vista do Sul;1454;1317;137;7;67;-60
104;8;4;Bom Fim;9943;7788;2155;69;360;-291
104;8;4;Bom Jesus;30868;24354;6514;187;184;3
104;8;4;Camaquã;18057;14383;3674;93;175;-82
104;8;4;Campo Novo;7746;6218;1528;10;104;-94
104;8;4;Cascata;12285;9655;2630;88;125;-37
104;8;4;Cavalhada;31640;25645;5995;-86;124;-210
104;8;4;Centro;44178;35865;8313;185;247;-62
104;8;4;Chácara das Pedras;4827;3833;994;4;275;-271
104;8;4;Chapéu do Sol;1785;1577;208;-8;97;-105
104;8;4;Cidade Baixa;14491;11399;3092;167;305;-138
104;8;4;Coronel Aparício Borges;19114;14973;4141;137;191;-54
104;8;4;Costa e Silva;14978;11769;3209;109;175;-66
104;8;4;Cristal;35296;28654;6642;140;108;32
104;8;4;Cristo Redentor;15631;12251;3380;-108;256;-364
104;8;4;Espírito Santo;4295;3583;712;-123;114;-237
104;8;4;Extrema;1330;1165;165;121;116;5
104;8;4;Farrapos;20299;16441;3858;240;200;40
104;8;4;Farroupilha;197;169;28;-121;-54;-67
104;8;4;Floresta;10329;8125;2204;46;217;-171
104;8;4;Glória;16481;12984;3497;51;223;-172
104;8;4;Guarujá;3568;3011;557;-101;84;-185
104;8;4;Higienópolis;9352;7244;2108;32;226;-194
104;8;4;Hípica;19535;16160;3375;-12;46;-58
104;8;4;Humaitá;11025;8822;2203;144;174;-30
104;8;4;Independência;6310;4994;1316;-261;258;-519
104;8;4;Ipanema;13472;10895;2577;-14;44;-58
104;8;4;Jardim Botânico;10789;8425;2364;-263;192;-455
104;8;4;Jardim Carvalho;26959;21540;5419;126;191;-65
104;8;4;Jardim do Salso;2435;1813;622;7;283;-276
104;8;4;Jardim Dona Leopoldina;17107;13534;3573;11;151;-140
104;8;4;Jardim Europa;860;622;238;-357;-42;-315
104;8;4;Jardim Floresta;1710;1282;428;-1;154;-155
104;8;4;Jardim Isabel;1499;1164;335;40;158;-118
104;8;4;Jardim Itu;17316;13628;3688;76;188;-112
104;8;4;Jardim Lindóia;5774;4597;1177;-309;148;-457
104;8;4;Jardim Sabará;12317;9611;2706;28;136;-108
104;8;4;Jardim São Pedro;2265;1692;573;41;264;-223
104;8;4;Lageado;3379;2929;450;-92;26;-118
104;8;4;Lami;3441;3071;370;-97;27;-124
104;8;4;Lomba do Pinheiro;66163;55416;10747;-243;-45;-198
104;8;4;Mário Quintana;42483;34627;7856;-11;58;-69
104;8;4;Medianeira;9698;7577;2121;-24;198;-222
104;8;4;Menino Deus;34471;27662;6809;115;198;-83
104;8;4;Moinhos de Vento;10489;8156;2333;-267;175;-442
104;8;4;MontSerrat;9734;7590;2144;-48;192;-240
104;8;4;Morro Santana;19775;15835;3940;91;140;-49
104;8;4;Navegantes;2891;2189;702;-243;194;-437
104;8;4;Nonoai;26527;21317;5210;42;110;-68
104;8;4;Parque Santa Fé;4555;3502;1053;-82;220;-302
104;8;4;Partenon;54199;43723;10476;80;112;-32
104;8;4;Passo DAreia;22770;17907;4863;46;143;-97
104;8;4;Passo das Pedras;14993;11803;3190;-3;121;-124
104;8;4;Pedra Redonda;51;29;22;-31;-25;-6
104;8;4;Petrópolis;41387;33090;8297;35;94;-59
104;8;4;Pitinga;3294;2694;600;-54;94;-148
104;8;4;Ponta Grossa;7980;6697;1283;-47;16;-63
104;8;4;Praia de Belas;1039;716;323;-295;8;-303
104;8;4;Restinga;60244;51140;9104;205;23;182
104;8;4;Rio Branco;16714;13065;3649;-16;188;-204
104;8;4;Rubem Berta;35997;29401;6596;-85;57;-142
104;8;4;Santa Cecília;3778;2843;935;-49;292;-341
104;8;4;Santa Maria Goretti;2063;1485;578;81;239;-158
104;8;4;Santa Rosa de Lima;38889;32301;6588;106;104;2
104;8;4;Santa Tereza;44059;35858;8201;-18;105;-123
104;8;4;Santana;20717;16310;4407;-38;179;-217
104;8;4;Santo Antônio;11934;9315;2619;-6;187;-193
104;8;4;São Caetano;597;266;331;103;14;89
104;8;4;São Geraldo;7509;5551;1958;18;122;-104
104;8;4;São João;11338;8862;2476;-151;54;-205
104;8;4;São Sebastião;5360;4013;1347;-352;134;-486
104;8;4;Sarandi;67748;56237;11511;162;-35;197
104;8;4;Serraria;5368;4228;1140;-24;39;-63
104;8;4;Sétimo Céu;586;371;215;-11;-33;22
104;8;4;Teresópolis;13695;10790;2905;13;100;-87
104;8;4;Três Figueiras;2522;1737;785;-80;297;-377
104;8;4;Tristeza;16648;13669;2979;-10;31;-41
104;8;4;Vila Assunção;3249;2389;860;40;151;-111
104;8;4;Vila Conceição;881;451;430;133;16;117
104;8;4;Vila Ipiranga;18245;14423;3822;-8;64;-72
104;8;4;Vila Jardim;12232;9141;3091;133;146;-13
104;8;4;Vila João Pessoa;11838;8914;2924;8;104;-96
104;8;4;Vila Nova;35707;29440;6267;87;-38;125
104;8;4;Vila São José;28404;22756;5648;241;55;186
105;9;4;Aberta dos Morros;6264;5024;1240;-28;-17;-11
105;9;4;Agronomia;1280;1102;178;-34;-17;-17
105;9;4;Anchieta;1095;921;174;14;5;9
105;9;4;Arquipélago;7745;6095;1650;-10;-29;19
105;9;4;Auxiliadora;8156;6349;1807;-60;-38;-22
105;9;4;Azenha;12289;9613;2676;-66;-108;42
105;9;4;Bela Vista;10240;7957;2283;-72;-55;-17
105;9;4;Belém Novo;10099;8444;1655;-10;3;-13
105;9;4;Belém Velho;10198;8057;2141;31;12;19
105;9;4;Boa Vista;8564;6632;1932;-28;-26;-2
105;9;4;Boa Vista do Sul;1469;1322;147;15;5;10
105;9;4;Bom Fim;9847;7713;2134;-96;-75;-21
105;9;4;Bom Jesus;30963;24267;6696;95;-87;182
105;9;4;Camaquã;18069;14343;3726;12;-40;52
105;9;4;Campo Novo;7737;6209;1528;-9;-9;0
105;9;4;Cascata;12320;9636;2684;35;-19;54
105;9;4;Cavalhada;31680;25597;6083;40;-48;88
105;9;4;Centro;44422;35824;8598;244;-41;285
105;9;4;Chácara das Pedras;4761;3798;963;-66;-35;-31
105;9;4;Chapéu do Sol;1757;1556;201;-28;-21;-7
105;9;4;Cidade Baixa;14469;11316;3153;-22;-83;61
105;9;4;Coronel Aparício Borges;19185;14902;4283;71;-71;142
105;9;4;Costa e Silva;14977;11697;3280;-1;-72;71
105;9;4;Cristal;35327;28594;6733;31;-60;91
105;9;4;Cristo Redentor;15768;12276;3492;137;25;112
105;9;4;Espírito Santo;4300;3580;720;5;-3;8
105;9;4;Extrema;1347;1178;169;17;13;4
105;9;4;Farrapos;20308;16418;3890;9;-23;32
105;9;4;Farroupilha;190;190;0;-7;21;-28
105;9;4;Floresta;10352;8068;2284;23;-57;80
105;9;4;Glória;16583;12941;3642;102;-43;145
105;9;4;Guarujá;3586;3008;578;18;-3;21
105;9;4;Higienópolis;9354;7209;2145;2;-35;37
105;9;4;Hípica;19571;16131;3440;36;-29;65
105;9;4;Humaitá;11070;8807;2263;45;-15;60
105;9;4;Independência;6244;4905;1339;-66;-89;23
105;9;4;Ipanema;13507;10884;2623;35;-11;46
105;9;4;Jardim Botânico;10790;8362;2428;1;-63;64
105;9;4;Jardim Carvalho;27132;21518;5614;173;-22;195
105;9;4;Jardim do Salso;2327;1801;526;-108;-12;-96
105;9;4;Jardim Dona Leopoldina;17077;13432;3645;-30;-102;72
105;9;4;Jardim Europa;830;645;185;-30;23;-53
105;9;4;Jardim Floresta;1672;1306;366;-38;24;-62
105;9;4;Jardim Isabel;1520;1198;322;21;34;-13
105;9;4;Jardim Itu;17345;13570;3775;29;-58;87
105;9;4;Jardim Lindóia;5793;4591;1202;19;-6;25
105;9;4;Jardim Sabará;12285;9566;2719;-32;-45;13
105;9;4;Jardim São Pedro;2218;1685;533;-47;-7;-40
105;9;4;Lageado;3372;2938;434;-7;9;-16
105;9;4;Lami;3435;3073;362;-6;2;-8
105;9;4;Lomba do Pinheiro;66340;55404;10936;177;-12;189
105;9;4;Mário Quintana;42516;34539;7977;33;-88;121
105;9;4;Medianeira;9700;7532;2168;2;-45;47
105;9;4;Menino Deus;34548;27546;7002;77;-116;193
105;9;4;Moinhos de Vento;10489;8091;2398;0;-65;65
105;9;4;MontSerrat;9709;7511;2198;-25;-79;54
105;9;4;Morro Santana;19768;15747;4021;-7;-88;81
105;9;4;Navegantes;2884;2190;694;-7;1;-8
105;9;4;Nonoai;26583;21239;5344;56;-78;134
105;9;4;Parque Santa Fé;4423;3458;965;-132;-44;-88
105;9;4;Partenon;54443;43638;10805;244;-85;329
105;9;4;Passo DAreia;22813;17866;4947;43;-41;84
105;9;4;Passo das Pedras;15035;11707;3328;42;-96;138
105;9;4;Pedra Redonda;49;41;8;-2;12;-14
105;9;4;Petrópolis;41564;32973;8591;177;-117;294
105;9;4;Pitinga;3301;2697;604;7;3;4
105;9;4;Ponta Grossa;7980;6685;1295;0;-12;12
105;9;4;Praia de Belas;948;693;255;-91;-23;-68
105;9;4;Restinga;60172;51137;9035;-72;-3;-69
105;9;4;Rio Branco;16735;12955;3780;21;-110;131
105;9;4;Rubem Berta;36140;29327;6813;143;-74;217
105;9;4;Santa Cecília;3676;2800;876;-102;-43;-59
105;9;4;Santa Maria Goretti;2009;1460;549;-54;-25;-29
105;9;4;Santa Rosa de Lima;38961;32245;6716;72;-56;128
105;9;4;Santa Tereza;44145;35767;8378;86;-91;177
105;9;4;Santana;20753;16178;4575;36;-132;168
105;9;4;Santo Antônio;11884;9218;2666;-50;-97;47
105;9;4;São Caetano;586;271;315;-11;5;-16
105;9;4;São Geraldo;7449;5523;1926;-60;-28;-32
105;9;4;São João;11354;8850;2504;16;-12;28
105;9;4;São Sebastião;5274;3980;1294;-86;-33;-53
105;9;4;Sarandi;67733;56165;11568;-15;-72;57
105;9;4;Serraria;5359;4203;1156;-9;-25;16
105;9;4;Sétimo Céu;546;385;161;-40;14;-54
105;9;4;Teresópolis;13608;10696;2912;-87;-94;7
105;9;4;Três Figueiras;2426;1663;763;-96;-74;-22
105;9;4;Tristeza;16669;13691;2978;21;22;-1
105;9;4;Vila Assunção;3170;2375;795;-79;-14;-65
105;9;4;Vila Conceição;831;461;370;-50;10;-60
105;9;4;Vila Ipiranga;18138;14321;3817;-107;-102;-5
105;9;4;Vila Jardim;12132;9064;3068;-100;-77;-23
105;9;4;Vila João Pessoa;11802;8863;2939;-36;-51;15
105;9;4;Vila Nova;35592;29389;6203;-115;-51;-64
105;9;4;Vila São José;28225;22641;5584;-179;-115;-64
106;10;4;Aberta dos Morros;6309;5209;1100;45;185;-140
106;10;4;Agronomia;1463;1184;279;183;82;101
106;10;4;Anchieta;1255;1009;246;160;88;72
106;10;4;Arquipélago;7790;6285;1505;45;190;-145
106;10;4;Auxiliadora;8216;6635;1581;60;286;-226
106;10;4;Azenha;12339;9891;2448;50;278;-228
106;10;4;Bela Vista;10290;8257;2033;50;300;-250
106;10;4;Belém Novo;10075;8628;1447;-24;184;-208
106;10;4;Belém Velho;10210;8263;1947;12;206;-194
106;10;4;Boa Vista;8638;6928;1710;74;296;-222
106;10;4;Boa Vista do Sul;1750;1537;213;281;215;66
106;10;4;Bom Fim;9921;8019;1902;74;306;-232
106;10;4;Bom Jesus;30929;24568;6361;-34;301;-335
106;10;4;Camaquã;17990;14561;3429;-79;218;-297
106;10;4;Campo Novo;7812;6487;1325;75;278;-203
106;10;4;Cascata;12269;9887;2382;-51;251;-302
106;10;4;Cavalhada;31735;25743;5992;55;146;-91
106;10;4;Centro;44332;35766;8566;-90;-58;-32
106;10;4;Chácara das Pedras;5184;4196;988;423;398;25
106;10;4;Chapéu do Sol;2078;1776;302;321;220;101
106;10;4;Cidade Baixa;14438;11626;2812;-31;310;-341
106;10;4;Coronel Aparício Borges;19038;15161;3877;-147;259;-406
106;10;4;Costa e Silva;14857;11963;2894;-120;266;-386
106;10;4;Cristal;35100;28701;6399;-227;107;-334
106;10;4;Cristo Redentor;15670;12555;3115;-98;279;-377
106;10;4;Espírito Santo;4553;3820;733;253;240;13
106;10;4;Extrema;1494;1300;194;147;122;25
106;10;4;Farrapos;20233;16538;3695;-75;120;-195
106;10;4;Farroupilha;187;187;0;-3;-3;0
106;10;4;Floresta;10287;8374;1913;-65;306;-371
106;10;4;Glória;16378;13176;3202;-205;235;-440
106;10;4;Guarujá;3868;3254;614;282;246;36
106;10;4;Higienópolis;9353;7537;1816;-1;328;-329
106;10;4;Hípica;19382;16214;3168;-189;83;-272
106;10;4;Humaitá;11012;8979;2033;-58;172;-230
106;10;4;Independência;6657;5227;1430;413;322;91
106;10;4;Ipanema;13409;11080;2329;-98;196;-294
106;10;4;Jardim Botânico;10862;8700;2162;72;338;-266
106;10;4;Jardim Carvalho;26842;21644;5198;-290;126;-416
106;10;4;Jardim do Salso;2750;2184;566;423;383;40
106;10;4;Jardim Dona Leopoldina;16866;13684;3182;-211;252;-463
106;10;4;Jardim Europa;981;657;324;151;12;139
106;10;4;Jardim Floresta;1961;1550;411;289;244;45
106;10;4;Jardim Isabel;1783;1417;366;263;219;44
106;10;4;Jardim Itu;17197;13802;3395;-148;232;-380
106;10;4;Jardim Lindóia;6095;4845;1250;302;254;48
106;10;4;Jardim Sabará;12315;9920;2395;30;354;-324
106;10;4;Jardim São Pedro;2505;1982;523;287;297;-10
106;10;4;Lageado;3580;3135;445;208;197;11
106;10;4;Lami;3654;3252;402;219;179;40
106;10;4;Lomba do Pinheiro;65961;55336;10625;-379;-68;-311
106;10;4;Mário Quintana;42081;34656;7425;-435;117;-552
106;10;4;Medianeira;9668;7866;1802;-32;334;-366
106;10;4;Menino Deus;34184;27628;6556;-364;82;-446
106;10;4;Moinhos de Vento;10470;8342;2128;-19;251;-270
106;10;4;MontSerrat;9706;7859;1847;-3;348;-351
106;10;4;Morro Santana;19586;15868;3718;-182;121;-303
106;10;4;Navegantes;3306;2456;850;422;266;156
106;10;4;Nonoai;26377;21368;5009;-206;129;-335
106;10;4;Parque Santa Fé;4611;3705;906;188;247;-59
106;10;4;Partenon;54155;43745;10410;-288;107;-395
106;10;4;Passo DAreia;22682;18104;4578;-131;238;-369
106;10;4;Passo das Pedras;14890;11922;2968;-145;215;-360
106;10;4;Pedra Redonda;31;29;2;-18;-12;-6
106;10;4;Petrópolis;41324;33143;8181;-240;170;-410
106;10;4;Pitinga;3472;2836;636;171;139;32
106;10;4;Ponta Grossa;7905;6854;1051;-75;169;-244
106;10;4;Praia de Belas;1189;790;399;241;97;144
106;10;4;Restinga;59242;50988;8254;-930;-149;-781
106;10;4;Rio Branco;16602;13260;3342;-133;305;-438
106;10;4;Rubem Berta;35795;29340;6455;-345;13;-358
106;10;4;Santa Cecília;4065;3182;883;389;382;7
106;10;4;Santa Maria Goretti;2269;1755;514;260;295;-35
106;10;4;Santa Rosa de Lima;38675;32226;6449;-286;-19;-267
106;10;4;Santa Tereza;43850;35815;8035;-295;48;-343
106;10;4;Santana;20528;16423;4105;-225;245;-470
106;10;4;Santo Antônio;11859;9520;2339;-25;302;-327
106;10;4;São Caetano;480;276;204;-106;5;-111
106;10;4;São Geraldo;7418;5818;1600;-31;295;-326
106;10;4;São João;11506;9164;2342;152;314;-162
106;10;4;São Sebastião;5566;4260;1306;292;280;12
106;10;4;Sarandi;67643;56221;11422;-90;56;-146
106;10;4;Serraria;5382;4403;979;23;200;-177
106;10;4;Sétimo Céu;510;370;140;-36;-15;-21
106;10;4;Teresópolis;13471;10941;2530;-137;245;-382
106;10;4;Três Figueiras;2826;1988;838;400;325;75
106;10;4;Tristeza;16572;13867;2705;-97;176;-273
106;10;4;Vila Assunção;3409;2632;777;239;257;-18
106;10;4;Vila Conceição;735;490;245;-96;29;-125
106;10;4;Vila Ipiranga;18062;14540;3522;-76;219;-295
106;10;4;Vila Jardim;12177;9471;2706;45;407;-362
106;10;4;Vila João Pessoa;11727;9228;2499;-75;365;-440
106;10;4;Vila Nova;35318;29487;5831;-274;98;-372
106;10;4;Vila São José;28174;22879;5295;-51;238;-289
107;11;4;Aberta dos Morros;6633;6091;542;324;882;-558
107;11;4;Agronomia;1422;1305;117;-41;121;-162
107;11;4;Anchieta;1174;1085;89;-81;76;-157
107;11;4;Arquipélago;8214;7299;915;424;1014;-590
107;11;4;Auxiliadora;8568;7906;662;352;1271;-919
107;11;4;Azenha;12970;11832;1138;631;1941;-1310
107;11;4;Bela Vista;10761;9791;970;471;1534;-1063
107;11;4;Belém Novo;10141;9303;838;66;675;-609
107;11;4;Belém Velho;10721;9578;1143;511;1315;-804
107;11;4;Boa Vista;8963;8248;715;325;1320;-995
107;11;4;Boa Vista do Sul;1737;1630;107;-13;93;-106
107;11;4;Bom Fim;10333;9557;776;412;1538;-1126
107;11;4;Bom Jesus;30498;26548;3950;-431;1980;-2411
107;11;4;Camaquã;18138;16154;1984;148;1593;-1445
107;11;4;Campo Novo;8184;7495;689;372;1008;-636
107;11;4;Cascata;12855;11443;1412;586;1556;-970
107;11;4;Cavalhada;31064;27359;3705;-671;1616;-2287
107;11;4;Centro;42566;37297;5269;-1766;1531;-3297
107;11;4;Chácara das Pedras;5216;4846;370;32;650;-618
107;11;4;Chapéu do Sol;2077;1947;130;-1;171;-172
107;11;4;Cidade Baixa;14943;13410;1533;505;1784;-1279
107;11;4;Coronel Aparício Borges;19360;17098;2262;322;1937;-1615
107;11;4;Costa e Silva;15428;13798;1630;571;1835;-1264
107;11;4;Cristal;34195;30151;4044;-905;1450;-2355
107;11;4;Cristo Redentor;16209;14438;1771;539;1883;-1344
107;11;4;Espírito Santo;4690;4340;350;137;520;-383
107;11;4;Extrema;1488;1396;92;-6;96;-102
107;11;4;Farrapos;20057;17752;2305;-176;1214;-1390
107;11;4;Farroupilha;267;267;0;80;80;0
107;11;4;Floresta;10779;9746;1033;492;1372;-880
107;11;4;Glória;16804;14990;1814;426;1814;-1388
107;11;4;Guarujá;3967;3677;290;99;423;-324
107;11;4;Higienópolis;9737;8858;879;384;1321;-937
107;11;4;Hípica;19280;17244;2036;-102;1030;-1132
107;11;4;Humaitá;11406;10205;1201;394;1226;-832
107;11;4;Independência;6838;6118;720;181;891;-710
107;11;4;Ipanema;13568;12239;1329;159;1159;-1000
107;11;4;Jardim Botânico;11379;10326;1053;517;1626;-1109
107;11;4;Jardim Carvalho;26632;23345;3287;-210;1701;-1911
107;11;4;Jardim do Salso;2774;2573;201;24;389;-365
107;11;4;Jardim Dona Leopoldina;17447;15587;1860;581;1903;-1322
107;11;4;Jardim Europa;1178;860;318;197;203;-6
107;11;4;Jardim Floresta;1960;1862;98;-1;312;-313
107;11;4;Jardim Isabel;1784;1676;108;1;259;-258
107;11;4;Jardim Itu;17737;15686;2051;540;1884;-1344
107;11;4;Jardim Lindóia;6314;5642;672;219;797;-578
107;11;4;Jardim Sabará;12900;11507;1393;585;1587;-1002
107;11;4;Jardim São Pedro;2529;2343;186;24;361;-337
107;11;4;Lageado;3701;3486;215;121;351;-230
107;11;4;Lami;3775;3556;219;121;304;-183
107;11;4;Lomba do Pinheiro;63371;56496;6875;-2590;1160;-3750
107;11;4;Mário Quintana;40820;36183;4637;-1261;1527;-2788
107;11;4;Medianeira;10098;9172;926;430;1306;-876
107;11;4;Menino Deus;33536;29402;4134;-648;1774;-2422
107;11;4;Moinhos de Vento;10981;9853;1128;511;1511;-1000
107;11;4;MontSerrat;10102;9136;966;396;1277;-881
107;11;4;Morro Santana;19838;17447;2391;252;1579;-1327
107;11;4;Navegantes;3424;2920;504;118;464;-346
107;11;4;Nonoai;26090;23025;3065;-287;1657;-1944
107;11;4;Parque Santa Fé;4814;4463;351;203;758;-555
107;11;4;Partenon;52276;45752;6524;-1879;2007;-3886
107;11;4;Passo DAreia;22589;19831;2758;-93;1727;-1820
107;11;4;Passo das Pedras;15493;13723;1770;603;1801;-1198
107;11;4;Pedra Redonda;60;60;0;29;31;-2
107;11;4;Petrópolis;40201;35032;5169;-1123;1889;-3012
107;11;4;Pitinga;3588;3331;257;116;495;-379
107;11;4;Ponta Grossa;8232;7651;581;327;797;-470
107;11;4;Praia de Belas;1338;966;372;149;176;-27
107;11;4;Restinga;57313;51944;5369;-1929;956;-2885
107;11;4;Rio Branco;17071;15134;1937;469;1874;-1405
107;11;4;Rubem Berta;35024;30936;4088;-771;1596;-2367
107;11;4;Santa Cecília;4157;3772;385;92;590;-498
107;11;4;Santa Maria Goretti;2192;1996;196;-77;241;-318
107;11;4;Santa Rosa de Lima;37808;33560;4248;-867;1334;-2201
107;11;4;Santa Tereza;42528;37417;5111;-1322;1602;-2924
107;11;4;Santana;20812;18325;2487;284;1902;-1618
107;11;4;Santo Antônio;12351;11009;1342;492;1489;-997
107;11;4;São Caetano;503;347;156;23;71;-48
107;11;4;São Geraldo;7751;6999;752;333;1181;-848
107;11;4;São João;11988;10421;1567;482;1257;-775
107;11;4;São Sebastião;5868;5203;665;302;943;-641
107;11;4;Sarandi;65353;57574;7779;-2290;1353;-3643
107;11;4;Serraria;5584;5140;444;202;737;-535
107;11;4;Sétimo Céu;550;494;56;40;124;-84
107;11;4;Teresópolis;14130;12568;1562;659;1627;-968
107;11;4;Três Figueiras;2861;2266;595;35;278;-243
107;11;4;Tristeza;16790;15036;1754;218;1169;-951
107;11;4;Vila Assunção;3520;3134;386;111;502;-391
107;11;4;Vila Conceição;760;593;167;25;103;-78
107;11;4;Vila Ipiranga;18601;16310;2291;539;1770;-1231
107;11;4;Vila Jardim;12748;11181;1567;571;1710;-1139
107;11;4;Vila João Pessoa;12307;10930;1377;580;1702;-1122
107;11;4;Vila Nova;34620;30744;3876;-698;1257;-1955
107;11;4;Vila São José;27949;24571;3378;-225;1692;-1917
108;12;4;Aberta dos Morros;6546;5570;976;-87;-521;434
108;12;4;Agronomia;1363;1147;216;-59;-158;99
108;12;4;Anchieta;1110;936;174;-64;-149;85
108;12;4;Arquipélago;8039;6701;1338;-175;-598;423
108;12;4;Auxiliadora;8355;7001;1354;-213;-905;692
108;12;4;Azenha;12874;10875;1999;-96;-957;861
108;12;4;Bela Vista;10443;8759;1684;-318;-1032;714
108;12;4;Belém Novo;10235;8956;1279;94;-347;441
108;12;4;Belém Velho;10604;8919;1685;-117;-659;542
108;12;4;Boa Vista;8730;7361;1369;-233;-887;654
108;12;4;Boa Vista do Sul;1574;1458;116;-163;-172;9
108;12;4;Bom Fim;10201;8613;1588;-132;-944;812
108;12;4;Bom Jesus;31171;25611;5560;673;-937;1610
108;12;4;Camaquã;18302;15484;2818;164;-670;834
108;12;4;Campo Novo;8010;6884;1126;-174;-611;437
108;12;4;Cascata;12678;10678;2000;-177;-765;588
108;12;4;Cavalhada;31814;26773;5041;750;-586;1336
108;12;4;Centro;44108;36656;7452;1542;-641;2183
108;12;4;Chácara das Pedras;5061;4271;790;-155;-575;420
108;12;4;Chapéu do Sol;1924;1775;149;-153;-172;19
108;12;4;Cidade Baixa;14724;12549;2175;-219;-861;642
108;12;4;Coronel Aparício Borges;19354;16170;3184;-6;-928;922
108;12;4;Costa e Silva;15130;12844;2286;-298;-954;656
108;12;4;Cristal;34843;29384;5459;648;-767;1415
108;12;4;Cristo Redentor;15914;13601;2313;-295;-837;542
108;12;4;Espírito Santo;4397;3851;546;-293;-489;196
108;12;4;Extrema;1328;1239;89;-160;-157;-3
108;12;4;Farrapos;20301;17119;3182;244;-633;877
108;12;4;Farroupilha;228;176;52;-39;-91;52
108;12;4;Floresta;10504;8928;1576;-275;-818;543
108;12;4;Glória;16638;14112;2526;-166;-878;712
108;12;4;Guarujá;3720;3243;477;-247;-434;187
108;12;4;Higienópolis;9372;7901;1471;-365;-957;592
108;12;4;Hípica;19422;16698;2724;142;-546;688
108;12;4;Humaitá;11136;9498;1638;-270;-707;437
108;12;4;Independência;6507;5448;1059;-331;-670;339
108;12;4;Ipanema;13458;11595;1863;-110;-644;534
108;12;4;Jardim Botânico;11023;9334;1689;-356;-992;636
108;12;4;Jardim Carvalho;26893;22459;4434;261;-886;1147
108;12;4;Jardim do Salso;2799;2233;566;25;-340;365
108;12;4;Jardim Dona Leopoldina;17155;14589;2566;-292;-998;706
108;12;4;Jardim Europa;947;715;232;-231;-145;-86
108;12;4;Jardim Floresta;1905;1558;347;-55;-304;249
108;12;4;Jardim Isabel;1629;1366;263;-155;-310;155
108;12;4;Jardim Itu;17358;14640;2718;-379;-1046;667
108;12;4;Jardim Lindóia;5960;5034;926;-354;-608;254
108;12;4;Jardim Sabará;12338;10459;1879;-562;-1048;486
108;12;4;Jardim São Pedro;2535;2029;506;6;-314;320
108;12;4;Lageado;3433;3094;339;-268;-392;124
108;12;4;Lami;3527;3208;319;-248;-348;100
108;12;4;Lomba do Pinheiro;65224;55692;9532;1853;-804;2657
108;12;4;Mário Quintana;41835;35255;6580;1015;-928;1943
108;12;4;Medianeira;9762;8263;1499;-336;-909;573
108;12;4;Menino Deus;34126;28589;5537;590;-813;1403
108;12;4;Moinhos de Vento;10620;8960;1660;-361;-893;532
108;12;4;MontSerrat;9762;8225;1537;-340;-911;571
108;12;4;Morro Santana;19792;16618;3174;-46;-829;783
108;12;4;Navegantes;3156;2499;657;-268;-421;153
108;12;4;Nonoai;26386;22163;4223;296;-862;1158
108;12;4;Parque Santa Fé;4637;3878;759;-177;-585;408
108;12;4;Partenon;53688;44674;9014;1412;-1078;2490
108;12;4;Passo DAreia;22531;18852;3679;-58;-979;921
108;12;4;Passo das Pedras;15055;12793;2262;-438;-930;492
108;12;4;Pedra Redonda;54;19;35;-6;-41;35
108;12;4;Petrópolis;40966;33952;7014;765;-1080;1845
108;12;4;Pitinga;3367;2989;378;-221;-342;121
108;12;4;Ponta Grossa;8092;7146;946;-140;-505;365
108;12;4;Praia de Belas;1107;763;344;-231;-203;-28
108;12;4;Restinga;58421;51056;7365;1108;-888;1996
108;12;4;Rio Branco;16665;14118;2547;-406;-1016;610
108;12;4;Rubem Berta;35382;30041;5341;358;-895;1253
108;12;4;Santa Cecília;4040;3217;823;-117;-555;438
108;12;4;Santa Maria Goretti;2146;1632;514;-46;-364;318
108;12;4;Santa Rosa de Lima;38500;32719;5781;692;-841;1533
108;12;4;Santa Tereza;43415;36386;7029;887;-1031;1918
108;12;4;Santana;20357;17246;3111;-455;-1079;624
108;12;4;Santo Antônio;11852;10009;1843;-499;-1000;501
108;12;4;São Caetano;555;243;312;52;-104;156
108;12;4;São Geraldo;7476;6245;1231;-275;-754;479
108;12;4;São João;11374;9610;1764;-614;-811;197
108;12;4;São Sebastião;5580;4509;1071;-288;-694;406
108;12;4;Sarandi;67111;56722;10389;1758;-852;2610
108;12;4;Serraria;5364;4601;763;-220;-539;319
108;12;4;Sétimo Céu;576;375;201;26;-119;145
108;12;4;Teresópolis;13642;11594;2048;-488;-974;486
108;12;4;Três Figueiras;2639;1919;720;-222;-347;125
108;12;4;Tristeza;16531;14244;2287;-259;-792;533
108;12;4;Vila Assunção;3420;2666;754;-100;-468;368
108;12;4;Vila Conceição;830;437;393;70;-156;226
108;12;4;Vila Ipiranga;18271;15364;2907;-330;-946;616
108;12;4;Vila Jardim;12205;10188;2017;-543;-993;450
108;12;4;Vila João Pessoa;11724;9903;1821;-583;-1027;444
108;12;4;Vila Nova;35195;29863;5332;575;-881;1456
108;12;4;Vila São José;28300;23597;4703;351;-974;1325
109;13;4;Aberta dos Morros;6477;5528;949;-69;-42;-27
109;13;4;Agronomia;1306;1131;175;-57;-16;-41
109;13;4;Anchieta;1074;925;149;-36;-11;-25
109;13;4;Arquipélago;8049;6683;1366;10;-18;28
109;13;4;Auxiliadora;8250;6989;1261;-105;-12;-93
109;13;4;Azenha;12696;10809;1887;-178;-66;-112
109;13;4;Bela Vista;10272;8715;1557;-171;-44;-127
109;13;4;Belém Novo;10246;8956;1290;11;0;11
109;13;4;Belém Velho;10585;8864;1721;-19;-55;36
109;13;4;Boa Vista;8570;7314;1256;-160;-47;-113
109;13;4;Boa Vista do Sul;1576;1455;121;2;-3;5
109;13;4;Bom Fim;10004;8549;1455;-197;-64;-133
109;13;4;Bom Jesus;31295;25505;5790;124;-106;230
109;13;4;Camaquã;18295;15404;2891;-7;-80;73
109;13;4;Campo Novo;7959;6829;1130;-51;-55;4
109;13;4;Cascata;12629;10583;2046;-49;-95;46
109;13;4;Cavalhada;32015;26649;5366;201;-124;325
109;13;4;Centro;44468;36614;7854;360;-42;402
109;13;4;Chácara das Pedras;4906;4218;688;-155;-53;-102
109;13;4;Chapéu do Sol;1874;1741;133;-50;-34;-16
109;13;4;Cidade Baixa;14668;12427;2241;-56;-122;66
109;13;4;Coronel Aparício Borges;19281;15999;3282;-73;-171;98
109;13;4;Costa e Silva;15042;12721;2321;-88;-123;35
109;13;4;Cristal;35028;29271;5757;185;-113;298
109;13;4;Cristo Redentor;15945;13618;2327;31;17;14
109;13;4;Espírito Santo;4361;3807;554;-36;-44;8
109;13;4;Extrema;1330;1237;93;2;-2;4
109;13;4;Farrapos;20374;17073;3301;73;-46;119
109;13;4;Farroupilha;153;153;0;-75;-23;-52
109;13;4;Floresta;10435;8844;1591;-69;-84;15
109;13;4;Glória;16624;13970;2654;-14;-142;128
109;13;4;Guarujá;3703;3227;476;-17;-16;-1
109;13;4;Higienópolis;9306;7844;1462;-66;-57;-9
109;13;4;Hípica;19503;16661;2842;81;-37;118
109;13;4;Humaitá;11233;9491;1742;97;-7;104
109;13;4;Independência;6423;5374;1049;-84;-74;-10
109;13;4;Ipanema;13484;11557;1927;26;-38;64
109;13;4;Jardim Botânico;10844;9207;1637;-179;-127;-52
109;13;4;Jardim Carvalho;27061;22344;4717;168;-115;283
109;13;4;Jardim do Salso;2607;2171;436;-192;-62;-130
109;13;4;Jardim Dona Leopoldina;17032;14404;2628;-123;-185;62
109;13;4;Jardim Europa;958;711;247;11;-4;15
109;13;4;Jardim Floresta;1804;1568;236;-101;10;-111
109;13;4;Jardim Isabel;1607;1329;278;-22;-37;15
109;13;4;Jardim Itu;17383;14521;2862;25;-119;144
109;13;4;Jardim Lindóia;5904;5001;903;-56;-33;-23
109;13;4;Jardim Sabará;12329;10354;1975;-9;-105;96
109;13;4;Jardim São Pedro;2371;1991;380;-164;-38;-126
109;13;4;Lageado;3416;3076;340;-17;-18;1
109;13;4;Lami;3516;3212;304;-11;4;-15
109;13;4;Lomba do Pinheiro;65487;55671;9816;263;-21;284
109;13;4;Mário Quintana;41913;35106;6807;78;-149;227
109;13;4;Medianeira;9666;8112;1554;-96;-151;55
109;13;4;Menino Deus;34444;28471;5973;318;-118;436
109;13;4;Moinhos de Vento;10554;8888;1666;-66;-72;6
109;13;4;MontSerrat;9746;8134;1612;-16;-91;75
109;13;4;Morro Santana;19816;16475;3341;24;-143;167
109;13;4;Navegantes;3097;2467;630;-59;-32;-27
109;13;4;Nonoai;26457;21978;4479;71;-185;256
109;13;4;Parque Santa Fé;4467;3741;726;-170;-137;-33
109;13;4;Partenon;54229;44539;9690;541;-135;676
109;13;4;Passo DAreia;22718;18758;3960;187;-94;281
109;13;4;Passo das Pedras;15019;12619;2400;-36;-174;138
109;13;4;Pedra Redonda;25;21;4;-29;2;-31
109;13;4;Petrópolis;41242;33780;7462;276;-172;448
109;13;4;Pitinga;3340;2963;377;-27;-26;-1
109;13;4;Ponta Grossa;8066;7132;934;-26;-14;-12
109;13;4;Praia de Belas;1038;737;301;-69;-26;-43
109;13;4;Restinga;58615;51023;7592;194;-33;227
109;13;4;Rio Branco;16806;14022;2784;141;-96;237
109;13;4;Rubem Berta;35530;29899;5631;148;-142;290
109;13;4;Santa Cecília;3803;3087;716;-237;-130;-107
109;13;4;Santa Maria Goretti;1999;1592;407;-147;-40;-107
109;13;4;Santa Rosa de Lima;38697;32655;6042;197;-64;261
109;13;4;Santa Tereza;43649;36281;7368;234;-105;339
109;13;4;Santana;20474;17089;3385;117;-157;274
109;13;4;Santo Antônio;11811;9833;1978;-41;-176;135
109;13;4;São Caetano;532;243;289;-23;0;-23
109;13;4;São Geraldo;7473;6169;1304;-3;-76;73
109;13;4;São João;11382;9583;1799;8;-27;35
109;13;4;São Sebastião;5520;4494;1026;-60;-15;-45
109;13;4;Sarandi;67483;56666;10817;372;-56;428
109;13;4;Serraria;5369;4584;785;5;-17;22
109;13;4;Sétimo Céu;525;387;138;-51;12;-63
109;13;4;Teresópolis;13646;11435;2211;4;-159;163
109;13;4;Três Figueiras;2388;1836;552;-251;-83;-168
109;13;4;Tristeza;16580;14235;2345;49;-9;58
109;13;4;Vila Assunção;3279;2598;681;-141;-68;-73
109;13;4;Vila Conceição;795;441;354;-35;4;-39
109;13;4;Vila Ipiranga;18268;15221;3047;-3;-143;140
109;13;4;Vila Jardim;12135;10045;2090;-70;-143;73
109;13;4;Vila João Pessoa;11651;9737;1914;-73;-166;93
109;13;4;Vila Nova;35140;29769;5371;-55;-94;39
109;13;4;Vila São José;28206;23410;4796;-94;-187;93
110;14;4;Aberta dos Morros;6610;5601;1009;133;73;60
110;14;4;Agronomia;1474;1230;244;168;99;69
110;14;4;Anchieta;1240;1041;199;166;116;50
110;14;4;Arquipélago;8019;6729;1290;-30;46;-76
110;14;4;Auxiliadora;8443;7093;1350;193;104;89
110;14;4;Azenha;12752;10929;1823;56;120;-64
110;14;4;Bela Vista;10512;8833;1679;240;118;122
110;14;4;Belém Novo;10327;9040;1287;81;84;-3
110;14;4;Belém Velho;10592;8942;1650;7;78;-71
110;14;4;Boa Vista;8826;7443;1383;256;129;127
110;14;4;Boa Vista do Sul;1738;1543;195;162;88;74
110;14;4;Bom Fim;10336;8722;1614;332;173;159
110;14;4;Bom Jesus;30936;25625;5311;-359;120;-479
110;14;4;Camaquã;18190;15530;2660;-105;126;-231
110;14;4;Campo Novo;8132;6917;1215;173;88;85
110;14;4;Cascata;12652;10683;1969;23;100;-77
110;14;4;Cavalhada;31586;26855;4731;-429;206;-635
110;14;4;Centro;43945;36705;7240;-523;91;-614
110;14;4;Chácara das Pedras;5150;4346;804;244;128;116
110;14;4;Chapéu do Sol;2115;1874;241;241;133;108
110;14;4;Cidade Baixa;14811;12553;2258;143;126;17
110;14;4;Coronel Aparício Borges;19144;16165;2979;-137;166;-303
110;14;4;Costa e Silva;15059;12856;2203;17;135;-118
110;14;4;Cristal;34681;29292;5389;-347;21;-368
110;14;4;Cristo Redentor;16309;13826;2483;364;208;156
110;14;4;Espírito Santo;4559;3912;647;198;105;93
110;14;4;Extrema;1509;1385;124;179;148;31
110;14;4;Farrapos;20040;17088;2952;-334;15;-349
110;14;4;Farroupilha;162;162;0;9;9;0
110;14;4;Floresta;10654;9002;1652;219;158;61
110;14;4;Glória;16671;14045;2626;47;75;-28
110;14;4;Guarujá;3906;3346;560;203;119;84
110;14;4;Higienópolis;9554;8009;1545;248;165;83
110;14;4;Hípica;19069;16651;2418;-434;-10;-424
110;14;4;Humaitá;11144;9576;1568;-89;85;-174
110;14;4;Independência;6758;5626;1132;335;252;83
110;14;4;Ipanema;13502;11649;1853;18;92;-74
110;14;4;Jardim Botânico;11135;9447;1688;291;240;51
110;14;4;Jardim Carvalho;26516;22363;4153;-545;19;-564
110;14;4;Jardim do Salso;2837;2357;480;230;186;44
110;14;4;Jardim Dona Leopoldina;17130;14602;2528;98;198;-100
110;14;4;Jardim Europa;971;805;166;13;94;-81
110;14;4;Jardim Floresta;2006;1722;284;202;154;48
110;14;4;Jardim Isabel;1843;1519;324;236;190;46
110;14;4;Jardim Itu;17319;14685;2634;-64;164;-228
110;14;4;Jardim Lindóia;6171;5223;948;267;222;45
110;14;4;Jardim Sabará;12465;10502;1963;136;148;-12
110;14;4;Jardim São Pedro;2562;2156;406;191;165;26
110;14;4;Lageado;3648;3242;406;232;166;66
110;14;4;Lami;3762;3390;372;246;178;68
110;14;4;Lomba do Pinheiro;64866;55626;9240;-621;-45;-576
110;14;4;Mário Quintana;41354;35071;6283;-559;-35;-524
110;14;4;Medianeira;9807;8239;1568;141;127;14
110;14;4;Menino Deus;33844;28404;5440;-600;-67;-533
110;14;4;Moinhos de Vento;10857;9126;1731;303;238;65
110;14;4;MontSerrat;9867;8283;1584;121;149;-28
110;14;4;Morro Santana;19424;16559;2865;-392;84;-476
110;14;4;Navegantes;3339;2658;681;242;191;51
110;14;4;Nonoai;25868;21977;3891;-589;-1;-588
110;14;4;Parque Santa Fé;4683;3908;775;216;167;49
110;14;4;Partenon;53465;44476;8989;-764;-63;-701
110;14;4;Passo DAreia;22398;18919;3479;-320;161;-481
110;14;4;Passo das Pedras;14986;12763;2223;-33;144;-177
110;14;4;Pedra Redonda;22;19;3;-3;-2;-1
110;14;4;Petrópolis;40668;33867;6801;-574;87;-661
110;14;4;Pitinga;3552;3097;455;212;134;78
110;14;4;Ponta Grossa;8253;7279;974;187;147;40
110;14;4;Praia de Belas;1120;925;195;82;188;-106
110;14;4;Restinga;58383;50943;7440;-232;-80;-152
110;14;4;Rio Branco;16868;14170;2698;62;148;-86
110;14;4;Rubem Berta;35133;29874;5259;-397;-25;-372
110;14;4;Santa Cecília;4012;3269;743;209;182;27
110;14;4;Santa Maria Goretti;2191;1782;409;192;190;2
110;14;4;Santa Rosa de Lima;38232;32642;5590;-465;-13;-452
110;14;4;Santa Tereza;43056;36261;6795;-593;-20;-573
110;14;4;Santana;20480;17209;3271;6;120;-114
110;14;4;Santo Antônio;12007;9987;2020;196;154;42
110;14;4;São Caetano;479;296;183;-53;53;-106
110;14;4;São Geraldo;7651;6349;1302;178;180;-2
110;14;4;São João;11679;9816;1863;297;233;64
110;14;4;São Sebastião;5760;4792;968;240;298;-58
110;14;4;Sarandi;67074;56850;10224;-409;184;-593
110;14;4;Serraria;5550;4804;746;181;220;-39
110;14;4;Sétimo Céu;529;425;104;4;38;-34
110;14;4;Teresópolis;13748;11552;2196;102;117;-15
110;14;4;Três Figueiras;2594;2083;511;206;247;-41
110;14;4;Tristeza;16478;14315;2163;-102;80;-182
110;14;4;Vila Assunção;3476;2760;716;197;162;35
110;14;4;Vila Conceição;768;533;235;-27;92;-119
110;14;4;Vila Ipiranga;18262;15393;2869;-6;172;-178
110;14;4;Vila Jardim;12315;10202;2113;180;157;23
110;14;4;Vila João Pessoa;11776;9874;1902;125;137;-12
110;14;4;Vila Nova;34924;29952;4972;-216;183;-399
110;14;4;Vila São José;28081;23538;4543;-125;128;-253
111;15;4;Aberta dos Morros;6560;5577;983;-50;-24;-26
111;15;4;Agronomia;1404;1223;181;-70;-7;-63
111;15;4;Anchieta;1159;1045;114;-81;4;-85
111;15;4;Arquipélago;8099;6746;1353;80;17;63
111;15;4;Auxiliadora;8301;7159;1142;-142;66;-208
111;15;4;Azenha;12299;10934;1365;-453;5;-458
111;15;4;Bela Vista;10366;8893;1473;-146;60;-206
111;15;4;Belém Novo;10321;9023;1298;-6;-17;11
111;15;4;Belém Velho;10621;8940;1681;29;-2;31
111;15;4;Boa Vista;8654;7451;1203;-172;8;-180
111;15;4;Boa Vista do Sul;1722;1539;183;-16;-4;-12
111;15;4;Bom Fim;10193;8788;1405;-143;66;-209
111;15;4;Bom Jesus;31147;25631;5516;211;6;205
111;15;4;Camaquã;18185;15592;2593;-5;62;-67
111;15;4;Campo Novo;8124;6921;1203;-8;4;-12
111;15;4;Cascata;12653;10690;1963;1;7;-6
111;15;4;Cavalhada;31574;26812;4762;-12;-43;31
111;15;4;Centro;44170;36800;7370;225;95;130
111;15;4;Chácara das Pedras;4972;4357;615;-178;11;-189
111;15;4;Chapéu do Sol;2080;1867;213;-35;-7;-28
111;15;4;Cidade Baixa;14867;12596;2271;56;43;13
111;15;4;Coronel Aparício Borges;19149;16144;3005;5;-21;26
111;15;4;Costa e Silva;15044;12860;2184;-15;4;-19
111;15;4;Cristal;34863;29201;5662;182;-91;273
111;15;4;Cristo Redentor;16035;13904;2131;-274;78;-352
111;15;4;Espírito Santo;4543;3897;646;-16;-15;-1
111;15;4;Extrema;1497;1378;119;-12;-7;-5
111;15;4;Farrapos;20238;17093;3145;198;5;193
111;15;4;Farroupilha;180;180;0;18;18;0
111;15;4;Floresta;10716;9077;1639;62;75;-13
111;15;4;Glória;16686;14014;2672;15;-31;46
111;15;4;Guarujá;3876;3326;550;-30;-20;-10
111;15;4;Higienópolis;9562;8069;1493;8;60;-52
111;15;4;Hípica;19137;16619;2518;68;-32;100
111;15;4;Humaitá;11223;9577;1646;79;1;78
111;15;4;Independência;6458;5694;764;-300;68;-368
111;15;4;Ipanema;13513;11595;1918;11;-54;65
111;15;4;Jardim Botânico;10821;9463;1358;-314;16;-330
111;15;4;Jardim Carvalho;26757;22302;4455;241;-61;302
111;15;4;Jardim do Salso;2651;2331;320;-186;-26;-160
111;15;4;Jardim Dona Leopoldina;17075;14586;2489;-55;-16;-39
111;15;4;Jardim Europa;1014;841;173;43;36;7
111;15;4;Jardim Floresta;1903;1781;122;-103;59;-162
111;15;4;Jardim Isabel;1741;1500;241;-102;-19;-83
111;15;4;Jardim Itu;17333;14718;2615;14;33;-19
111;15;4;Jardim Lindóia;5890;5319;571;-281;96;-377
111;15;4;Jardim Sabará;12439;10476;1963;-26;-26;0
111;15;4;Jardim São Pedro;2457;2208;249;-105;52;-157
111;15;4;Lageado;3645;3219;426;-3;-23;20
111;15;4;Lami;3739;3368;371;-23;-22;-1
111;15;4;Lomba do Pinheiro;65264;55615;9649;398;-11;409
111;15;4;Mário Quintana;41596;34999;6597;242;-72;314
111;15;4;Medianeira;9725;8218;1507;-82;-21;-61
111;15;4;Menino Deus;34048;28399;5649;204;-5;209
111;15;4;Moinhos de Vento;10625;9170;1455;-232;44;-276
111;15;4;MontSerrat;9873;8328;1545;6;45;-39
111;15;4;Morro Santana;19523;16476;3047;99;-83;182
111;15;4;Navegantes;3089;2661;428;-250;3;-253
111;15;4;Nonoai;25914;21866;4048;46;-111;157
111;15;4;Parque Santa Fé;4515;3881;634;-168;-27;-141
111;15;4;Partenon;53772;44401;9371;307;-75;382
111;15;4;Passo DAreia;22659;18976;3683;261;57;204
111;15;4;Passo das Pedras;15029;12711;2318;43;-52;95
111;15;4;Pedra Redonda;13;13;0;-9;-6;-3
111;15;4;Petrópolis;41123;33842;7281;455;-25;480
111;15;4;Pitinga;3577;3104;473;25;7;18
111;15;4;Ponta Grossa;8257;7250;1007;4;-29;33
111;15;4;Praia de Belas;1074;904;170;-46;-21;-25
111;15;4;Restinga;58363;50917;7446;-20;-26;6
111;15;4;Rio Branco;17097;14225;2872;229;55;174
111;15;4;Rubem Berta;35363;29831;5532;230;-43;273
111;15;4;Santa Cecília;3802;3244;558;-210;-25;-185
111;15;4;Santa Maria Goretti;2073;1763;310;-118;-19;-99
111;15;4;Santa Rosa de Lima;38359;32618;5741;127;-24;151
111;15;4;Santa Tereza;43306;36118;7188;250;-143;393
111;15;4;Santana;20759;17264;3495;279;55;224
111;15;4;Santo Antônio;12000;9973;2027;-7;-14;7
111;15;4;São Caetano;471;275;196;-8;-21;13
111;15;4;São Geraldo;7732;6399;1333;81;50;31
111;15;4;São João;11664;9839;1825;-15;23;-38
111;15;4;São Sebastião;5516;4830;686;-244;38;-282
111;15;4;Sarandi;67283;56831;10452;209;-19;228
111;15;4;Serraria;5546;4752;794;-4;-52;48
111;15;4;Sétimo Céu;477;402;75;-52;-23;-29
111;15;4;Teresópolis;13837;11481;2356;89;-71;160
111;15;4;Três Figueiras;2206;2023;183;-388;-60;-328
111;15;4;Tristeza;16566;14314;2252;88;-1;89
111;15;4;Vila Assunção;3446;2728;718;-30;-32;2
111;15;4;Vila Conceição;701;467;234;-67;-66;-1
111;15;4;Vila Ipiranga;18388;15400;2988;126;7;119
111;15;4;Vila Jardim;12269;10125;2144;-46;-77;31
111;15;4;Vila João Pessoa;11772;9803;1969;-4;-71;67
111;15;4;Vila Nova;35027;29861;5166;103;-91;194
111;15;4;Vila São José;27996;23404;4592;-85;-134;49
112;16;4;Aberta dos Morros;6522;5682;840;-38;105;-143
112;16;4;Agronomia;1455;1343;112;51;120;-69
112;16;4;Anchieta;1226;1172;54;67;127;-60
112;16;4;Arquipélago;8174;6975;1199;75;229;-154
112;16;4;Auxiliadora;8318;7446;872;17;287;-270
112;16;4;Azenha;12430;11331;1099;131;397;-266
112;16;4;Bela Vista;10407;9234;1173;41;341;-300
112;16;4;Belém Novo;10344;9091;1253;23;68;-45
112;16;4;Belém Velho;10678;9162;1516;57;222;-165
112;16;4;Boa Vista;8774;7772;1002;120;321;-201
112;16;4;Boa Vista do Sul;1705;1579;126;-17;40;-57
112;16;4;Bom Fim;10247;9155;1092;54;367;-313
112;16;4;Bom Jesus;30649;25990;4659;-498;359;-857
112;16;4;Camaquã;18162;15782;2380;-23;190;-213
112;16;4;Campo Novo;8224;7141;1083;100;220;-120
112;16;4;Cascata;12738;10958;1780;85;268;-183
112;16;4;Cavalhada;31194;27064;4130;-380;252;-632
112;16;4;Centro;43735;37092;6643;-435;292;-727
112;16;4;Chácara das Pedras;5117;4663;454;145;306;-161
112;16;4;Chapéu do Sol;2063;1946;117;-17;79;-96
112;16;4;Cidade Baixa;14988;12988;2000;121;392;-271
112;16;4;Coronel Aparício Borges;19290;16562;2728;141;418;-277
112;16;4;Costa e Silva;15223;13236;1987;179;376;-197
112;16;4;Cristal;34448;29366;5082;-415;165;-580
112;16;4;Cristo Redentor;16017;14219;1798;-18;315;-333
112;16;4;Espírito Santo;4534;4016;518;-9;119;-128
112;16;4;Extrema;1491;1385;106;-6;7;-13
112;16;4;Farrapos;20039;17216;2823;-199;123;-322
112;16;4;Farroupilha;153;153;0;-27;-27;0
112;16;4;Floresta;10819;9414;1405;103;337;-234
112;16;4;Glória;16792;14362;2430;106;348;-242
112;16;4;Guarujá;3904;3449;455;28;123;-95
112;16;4;Higienópolis;9650;8416;1234;88;347;-259
112;16;4;Hípica;19173;16725;2448;36;106;-70
112;16;4;Humaitá;11389;9795;1594;166;218;-52
112;16;4;Independência;6517;6074;443;59;380;-321
112;16;4;Ipanema;13570;11685;1885;57;90;-33
112;16;4;Jardim Botânico;10939;9830;1109;118;367;-249
112;16;4;Jardim Carvalho;26443;22535;3908;-314;233;-547
112;16;4;Jardim do Salso;2799;2546;253;148;215;-67
112;16;4;Jardim Dona Leopoldina;17234;14989;2245;159;403;-244
112;16;4;Jardim Europa;1045;928;117;31;87;-56
112;16;4;Jardim Floresta;1977;1940;37;74;159;-85
112;16;4;Jardim Isabel;1780;1619;161;39;119;-80
112;16;4;Jardim Itu;17421;15040;2381;88;322;-234
112;16;4;Jardim Lindóia;5948;5573;375;58;254;-196
112;16;4;Jardim Sabará;12549;10785;1764;110;309;-199
112;16;4;Jardim São Pedro;2607;2432;175;150;224;-74
112;16;4;Lageado;3666;3295;371;21;76;-55
112;16;4;Lami;3676;3355;321;-63;-13;-50
112;16;4;Lomba do Pinheiro;65201;55819;9382;-63;204;-267
112;16;4;Mário Quintana;41373;35266;6107;-223;267;-490
112;16;4;Medianeira;9908;8534;1374;183;316;-133
112;16;4;Menino Deus;33865;28860;5005;-183;461;-644
112;16;4;Moinhos de Vento;10770;9558;1212;145;388;-243
112;16;4;MontSerrat;10062;8704;1358;189;376;-187
112;16;4;Morro Santana;19548;16724;2824;25;248;-223
112;16;4;Navegantes;3125;2818;307;36;157;-121
112;16;4;Nonoai;25845;22222;3623;-69;356;-425
112;16;4;Parque Santa Fé;4766;4230;536;251;349;-98
112;16;4;Partenon;53054;44615;8439;-718;214;-932
112;16;4;Passo DAreia;22622;19331;3291;-37;355;-392
112;16;4;Passo das Pedras;15220;13074;2146;191;363;-172
112;16;4;Pedra Redonda;34;1;33;21;-12;33
112;16;4;Petrópolis;40418;34094;6324;-705;252;-957
112;16;4;Pitinga;3592;3202;390;15;98;-83
112;16;4;Ponta Grossa;8292;7263;1029;35;13;22
112;16;4;Praia de Belas;1094;1033;61;20;129;-109
112;16;4;Restinga;58354;51049;7305;-9;132;-141
112;16;4;Rio Branco;17309;14667;2642;212;442;-230
112;16;4;Rubem Berta;34754;30074;4680;-609;243;-852
112;16;4;Santa Cecília;4011;3580;431;209;336;-127
112;16;4;Santa Maria Goretti;2212;1980;232;139;217;-78
112;16;4;Santa Rosa de Lima;38003;32741;5262;-356;123;-479
112;16;4;Santa Tereza;43000;36248;6752;-306;130;-436
112;16;4;Santana;20884;17655;3229;125;391;-266
112;16;4;Santo Antônio;12229;10297;1932;229;324;-95
112;16;4;São Caetano;558;285;273;87;10;77
112;16;4;São Geraldo;7858;6647;1211;126;248;-122
112;16;4;São João;11604;10091;1513;-60;252;-312
112;16;4;São Sebastião;5526;5068;458;10;238;-228
112;16;4;Sarandi;66945;57088;9857;-338;257;-595
112;16;4;Serraria;5553;4755;798;7;3;4
112;16;4;Sétimo Céu;512;401;111;35;-1;36
112;16;4;Teresópolis;13909;11828;2081;72;347;-275
112;16;4;Três Figueiras;2511;2315;196;305;292;13
112;16;4;Tristeza;16709;14436;2273;143;122;21
112;16;4;Vila Assunção;3609;2927;682;163;199;-36
112;16;4;Vila Conceição;748;474;274;47;7;40
112;16;4;Vila Ipiranga;18599;15719;2880;211;319;-108
112;16;4;Vila Jardim;12520;10434;2086;251;309;-58
112;16;4;Vila João Pessoa;11885;10079;1806;113;276;-163
112;16;4;Vila Nova;34680;29784;4896;-347;-77;-270
112;16;4;Vila São José;27837;23606;4231;-159;202;-361
113;17;4;Aberta dos Morros;6792;6456;336;270;774;-504
113;17;4;Agronomia;1747;1736;11;292;393;-101
113;17;4;Anchieta;1506;1505;1;280;333;-53
113;17;4;Arquipélago;8298;7798;500;124;823;-699
113;17;4;Auxiliadora;8877;8633;244;559;1187;-628
113;17;4;Azenha;13000;12680;320;570;1349;-779
113;17;4;Bela Vista;10971;10588;383;564;1354;-790
113;17;4;Belém Novo;10191;9586;605;-153;495;-648
113;17;4;Belém Velho;10855;10101;754;177;939;-762
113;17;4;Boa Vista;9320;8983;337;546;1211;-665
113;17;4;Boa Vista do Sul;1919;1864;55;214;285;-71
113;17;4;Bom Fim;10869;10485;384;622;1330;-708
113;17;4;Bom Jesus;29820;27376;2444;-829;1386;-2215
113;17;4;Camaquã;18104;16898;1206;-58;1116;-1174
113;17;4;Campo Novo;8528;8002;526;304;861;-557
113;17;4;Cascata;12999;12076;923;261;1118;-857
113;17;4;Cavalhada;30296;28165;2131;-898;1101;-1999
113;17;4;Centro;41705;38178;3527;-2030;1086;-3116
113;17;4;Chácara das Pedras;5672;5606;66;555;943;-388
113;17;4;Chapéu do Sol;2348;2310;38;285;364;-79
113;17;4;Cidade Baixa;15191;14240;951;203;1252;-1049
113;17;4;Coronel Aparício Borges;19338;17967;1371;48;1405;-1357
113;17;4;Costa e Silva;15453;14563;890;230;1327;-1097
113;17;4;Cristal;33559;30518;3041;-889;1152;-2041
113;17;4;Cristo Redentor;16197;15458;739;180;1239;-1059
113;17;4;Espírito Santo;4929;4731;198;395;715;-320
113;17;4;Extrema;1665;1579;86;174;194;-20
113;17;4;Farrapos;19633;18133;1500;-406;917;-1323
113;17;4;Farroupilha;347;347;0;194;194;0
113;17;4;Floresta;11199;10618;581;380;1204;-824
113;17;4;Glória;16973;15692;1281;181;1330;-1149
113;17;4;Guarujá;4229;4054;175;325;605;-280
113;17;4;Higienópolis;10082;9620;462;432;1204;-772
113;17;4;Hípica;18866;17565;1301;-307;840;-1147
113;17;4;Humaitá;11569;10740;829;180;945;-765
113;17;4;Independência;7202;7060;142;685;986;-301
113;17;4;Ipanema;13615;12643;972;45;958;-913
113;17;4;Jardim Botânico;11667;11282;385;728;1452;-724
113;17;4;Jardim Carvalho;26156;23898;2258;-287;1363;-1650
113;17;4;Jardim do Salso;3272;3253;19;473;707;-234
113;17;4;Jardim Dona Leopoldina;17486;16396;1090;252;1407;-1155
113;17;4;Jardim Europa;1372;1319;53;327;391;-64
113;17;4;Jardim Floresta;2460;2456;4;483;516;-33
113;17;4;Jardim Isabel;2151;2104;47;371;485;-114
113;17;4;Jardim Itu;17611;16412;1199;190;1372;-1182
113;17;4;Jardim Lindóia;6638;6510;128;690;937;-247
113;17;4;Jardim Sabará;13062;12163;899;513;1378;-865
113;17;4;Jardim São Pedro;3065;3033;32;458;601;-143
113;17;4;Lageado;3940;3788;152;274;493;-219
113;17;4;Lami;3902;3736;166;226;381;-155
113;17;4;Lomba do Pinheiro;62727;56872;5855;-2474;1053;-3527
113;17;4;Mário Quintana;40060;36461;3599;-1313;1195;-2508
113;17;4;Medianeira;10468;9868;600;560;1334;-774
113;17;4;Menino Deus;33133;30156;2977;-732;1296;-2028
113;17;4;Moinhos de Vento;11313;10828;485;543;1270;-727
113;17;4;MontSerrat;10592;9948;644;530;1244;-714
113;17;4;Morro Santana;19484;17953;1531;-64;1229;-1293
113;17;4;Navegantes;3773;3557;216;648;739;-91
113;17;4;Nonoai;25608;23494;2114;-237;1272;-1509
113;17;4;Parque Santa Fé;5234;5096;138;468;866;-398
113;17;4;Partenon;51332;46062;5270;-1722;1447;-3169
113;17;4;Passo DAreia;22380;20549;1831;-242;1218;-1460
113;17;4;Passo das Pedras;15635;14468;1167;415;1394;-979
113;17;4;Pedra Redonda;58;58;0;24;57;-33
113;17;4;Petrópolis;39088;35536;3552;-1330;1442;-2772
113;17;4;Pitinga;3893;3711;182;301;509;-208
113;17;4;Ponta Grossa;8435;7891;544;143;628;-485
113;17;4;Praia de Belas;1491;1430;61;397;397;0
113;17;4;Restinga;56363;52116;4247;-1991;1067;-3058
113;17;4;Rio Branco;17500;16086;1414;191;1419;-1228
113;17;4;Rubem Berta;34022;31346;2676;-732;1272;-2004
113;17;4;Santa Cecília;4608;4461;147;597;881;-284
113;17;4;Santa Maria Goretti;2623;2581;42;411;601;-190
113;17;4;Santa Rosa de Lima;36991;33837;3154;-1012;1096;-2108
113;17;4;Santa Tereza;41478;37497;3981;-1522;1249;-2771
113;17;4;Santana;20959;19088;1871;75;1433;-1358
113;17;4;Santo Antônio;12710;11680;1030;481;1383;-902
113;17;4;São Caetano;620;403;217;62;118;-56
113;17;4;São Geraldo;8252;7648;604;394;1001;-607
113;17;4;São João;12048;11216;832;444;1125;-681
113;17;4;São Sebastião;6203;6034;169;677;966;-289
113;17;4;Sarandi;64307;58153;6154;-2638;1065;-3703
113;17;4;Serraria;5822;5390;432;269;635;-366
113;17;4;Sétimo Céu;688;653;35;176;252;-76
113;17;4;Teresópolis;14417;13190;1227;508;1362;-854
113;17;4;Três Figueiras;2988;2961;27;477;646;-169
113;17;4;Tristeza;16639;15418;1221;-70;982;-1052
113;17;4;Vila Assunção;3774;3578;196;165;651;-486
113;17;4;Vila Conceição;851;705;146;103;231;-128
113;17;4;Vila Ipiranga;18638;17029;1609;39;1310;-1271
113;17;4;Vila Jardim;12778;11717;1061;258;1283;-1025
113;17;4;Vila João Pessoa;12372;11427;945;487;1348;-861
113;17;4;Vila Nova;33308;30831;2477;-1372;1047;-2419
113;17;4;Vila São José;27042;24782;2260;-795;1176;-1971
114;18;4;Aberta dos Morros;6843;6416;427;51;-40;91
114;18;4;Agronomia;1858;1794;64;111;58;53
114;18;4;Anchieta;1545;1528;17;39;23;16
114;18;4;Arquipélago;8265;7748;517;-33;-50;17
114;18;4;Auxiliadora;9028;8609;419;151;-24;175
114;18;4;Azenha;13234;12576;658;234;-104;338
114;18;4;Bela Vista;11074;10523;551;103;-65;168
114;18;4;Belém Novo;10230;9503;727;39;-83;122
114;18;4;Belém Velho;10772;10033;739;-83;-68;-15
114;18;4;Boa Vista;9393;8939;454;73;-44;117
114;18;4;Boa Vista do Sul;2095;1935;160;176;71;105
114;18;4;Bom Fim;10954;10413;541;85;-72;157
114;18;4;Bom Jesus;29258;27202;2056;-562;-174;-388
114;18;4;Camaquã;17932;16750;1182;-172;-148;-24
114;18;4;Campo Novo;8543;7968;575;15;-34;49
114;18;4;Cascata;12931;12046;885;-68;-30;-38
114;18;4;Cavalhada;30143;28070;2073;-153;-95;-58
114;18;4;Centro;41021;37976;3045;-684;-202;-482
114;18;4;Chácara das Pedras;5852;5592;260;180;-14;194
114;18;4;Chapéu do Sol;2459;2338;121;111;28;83
114;18;4;Cidade Baixa;15127;14144;983;-64;-96;32
114;18;4;Coronel Aparício Borges;19272;17928;1344;-66;-39;-27
114;18;4;Costa e Silva;15387;14483;904;-66;-80;14
114;18;4;Cristal;32798;30272;2526;-761;-246;-515
114;18;4;Cristo Redentor;16319;15441;878;122;-17;139
114;18;4;Espírito Santo;5052;4750;302;123;19;104
114;18;4;Extrema;1790;1682;108;125;103;22
114;18;4;Farrapos;19458;18005;1453;-175;-128;-47
114;18;4;Farroupilha;315;315;0;-32;-32;0
114;18;4;Floresta;11233;10564;669;34;-54;88
114;18;4;Glória;16849;15668;1181;-124;-24;-100
114;18;4;Guarujá;4362;4067;295;133;13;120
114;18;4;Higienópolis;10144;9581;563;62;-39;101
114;18;4;Hípica;18852;17452;1400;-14;-113;99
114;18;4;Humaitá;11501;10673;828;-68;-67;-1
114;18;4;Independência;7441;7063;378;239;3;236
114;18;4;Ipanema;13706;12673;1033;91;30;61
114;18;4;Jardim Botânico;11911;11293;618;244;11;233
114;18;4;Jardim Carvalho;25829;23801;2028;-327;-97;-230
114;18;4;Jardim do Salso;3449;3317;132;177;64;113
114;18;4;Jardim Dona Leopoldina;17431;16359;1072;-55;-37;-18
114;18;4;Jardim Europa;1378;1376;2;6;57;-51
114;18;4;Jardim Floresta;2573;2501;72;113;45;68
114;18;4;Jardim Isabel;2259;2147;112;108;43;65
114;18;4;Jardim Itu;17540;16371;1169;-71;-41;-30
114;18;4;Jardim Lindóia;6880;6543;337;242;33;209
114;18;4;Jardim Sabará;12988;12142;846;-74;-21;-53
114;18;4;Jardim São Pedro;3194;3056;138;129;23;106
114;18;4;Lageado;4173;3866;307;233;78;155
114;18;4;Lami;4114;3851;263;212;115;97
114;18;4;Lomba do Pinheiro;62186;56813;5373;-541;-59;-482
114;18;4;Mário Quintana;39201;36174;3027;-859;-287;-572
114;18;4;Medianeira;10490;9813;677;22;-55;77
114;18;4;Menino Deus;32580;29904;2676;-553;-252;-301
114;18;4;Moinhos de Vento;11456;10813;643;143;-15;158
114;18;4;MontSerrat;10566;9883;683;-26;-65;39
114;18;4;Morro Santana;19491;17990;1501;7;37;-30
114;18;4;Navegantes;3785;3606;179;12;49;-37
114;18;4;Nonoai;25384;23398;1986;-224;-96;-128
114;18;4;Parque Santa Fé;5434;5143;291;200;47;153
114;18;4;Partenon;50134;45627;4507;-1198;-435;-763
114;18;4;Passo DAreia;22259;20446;1813;-121;-103;-18
114;18;4;Passo das Pedras;15597;14441;1156;-38;-27;-11
114;18;4;Pedra Redonda;75;30;45;17;-28;45
114;18;4;Petrópolis;38720;35420;3300;-368;-116;-252
114;18;4;Pitinga;4089;3816;273;196;105;91
114;18;4;Ponta Grossa;8576;7969;607;141;78;63
114;18;4;Praia de Belas;1575;1493;82;84;63;21
114;18;4;Restinga;56253;52127;4126;-110;11;-121
114;18;4;Rio Branco;17393;15960;1433;-107;-126;19
114;18;4;Rubem Berta;34099;31210;2889;77;-136;213
114;18;4;Santa Cecília;4800;4432;368;192;-29;221
114;18;4;Santa Maria Goretti;2863;2620;243;240;39;201
114;18;4;Santa Rosa de Lima;36612;33683;2929;-379;-154;-225
114;18;4;Santa Tereza;40748;37235;3513;-730;-262;-468
114;18;4;Santana;21027;19090;1937;68;2;66
114;18;4;Santo Antônio;12956;11738;1218;246;58;188
114;18;4;São Caetano;558;469;89;-62;66;-128
114;18;4;São Geraldo;8427;7695;732;175;47;128
114;18;4;São João;12278;11296;982;230;80;150
114;18;4;São Sebastião;6501;6094;407;298;60;238
114;18;4;Sarandi;63957;58063;5894;-350;-90;-260
114;18;4;Serraria;6000;5552;448;178;162;16
114;18;4;Sétimo Céu;736;669;67;48;16;32
114;18;4;Teresópolis;14621;13214;1407;204;24;180
114;18;4;Três Figueiras;3367;3066;301;379;105;274
114;18;4;Tristeza;16729;15371;1358;90;-47;137
114;18;4;Vila Assunção;4030;3648;382;256;70;186
114;18;4;Vila Conceição;951;817;134;100;112;-12
114;18;4;Vila Ipiranga;18966;17140;1826;328;111;217
114;18;4;Vila Jardim;13126;11840;1286;348;123;225
114;18;4;Vila João Pessoa;12652;11499;1153;280;72;208
114;18;4;Vila Nova;33875;30890;2985;567;59;508
114;18;4;Vila São José;27473;24980;2493;431;198;233
115;19;4;Aberta dos Morros;6838;6431;407;-5;15;-20
115;19;4;Agronomia;1844;1803;41;-14;9;-23
115;19;4;Anchieta;1545;1545;0;0;17;-17
115;19;4;Arquipélago;8294;7779;515;29;31;-2
115;19;4;Auxiliadora;9010;8661;349;-18;52;-70
115;19;4;Azenha;13095;12629;466;-139;53;-192
115;19;4;Bela Vista;11017;10569;448;-57;46;-103
115;19;4;Belém Novo;10264;9525;739;34;22;12
115;19;4;Belém Velho;10816;10041;775;44;8;36
115;19;4;Boa Vista;9378;8992;386;-15;53;-68
115;19;4;Boa Vista do Sul;2115;1956;159;20;21;-1
115;19;4;Bom Fim;10910;10475;435;-44;62;-106
115;19;4;Bom Jesus;29393;27275;2118;135;73;62
115;19;4;Camaquã;18012;16832;1180;80;82;-2
115;19;4;Campo Novo;8534;7983;551;-9;15;-24
115;19;4;Cascata;12981;12070;911;50;24;26
115;19;4;Cavalhada;30076;28079;1997;-67;9;-76
115;19;4;Centro;41122;38078;3044;101;102;-1
115;19;4;Chácara das Pedras;5788;5620;168;-64;28;-92
115;19;4;Chapéu do Sol;2441;2348;93;-18;10;-28
115;19;4;Cidade Baixa;15131;14187;944;4;43;-39
115;19;4;Coronel Aparício Borges;19270;17992;1278;-2;64;-66
115;19;4;Costa e Silva;15487;14551;936;100;68;32
115;19;4;Cristal;33089;30377;2712;291;105;186
115;19;4;Cristo Redentor;16307;15506;801;-12;65;-77
115;19;4;Espírito Santo;5077;4791;286;25;41;-16
115;19;4;Extrema;1793;1686;107;3;4;-1
115;19;4;Farrapos;19604;18092;1512;146;87;59
115;19;4;Farroupilha;384;384;0;69;69;0
115;19;4;Floresta;11182;10579;603;-51;15;-66
115;19;4;Glória;16924;15715;1209;75;47;28
115;19;4;Guarujá;4385;4105;280;23;38;-15
115;19;4;Higienópolis;10158;9632;526;14;51;-37
115;19;4;Hípica;18948;17479;1469;96;27;69
115;19;4;Humaitá;11517;10718;799;16;45;-29
115;19;4;Independência;7333;7086;247;-108;23;-131
115;19;4;Ipanema;13800;12712;1088;94;39;55
115;19;4;Jardim Botânico;11822;11329;493;-89;36;-125
115;19;4;Jardim Carvalho;26031;23902;2129;202;101;101
115;19;4;Jardim do Salso;3382;3347;35;-67;30;-97
115;19;4;Jardim Dona Leopoldina;17506;16420;1086;75;61;14
115;19;4;Jardim Europa;1451;1451;0;73;75;-2
115;19;4;Jardim Floresta;2540;2538;2;-33;37;-70
115;19;4;Jardim Isabel;2206;2154;52;-53;7;-60
115;19;4;Jardim Itu;17669;16460;1209;129;89;40
115;19;4;Jardim Lindóia;6842;6597;245;-38;54;-92
115;19;4;Jardim Sabará;13095;12199;896;107;57;50
115;19;4;Jardim São Pedro;3163;3096;67;-31;40;-71
115;19;4;Lageado;4186;3889;297;13;23;-10
115;19;4;Lami;4120;3858;262;6;7;-1
115;19;4;Lomba do Pinheiro;62064;56827;5237;-122;14;-136
115;19;4;Mário Quintana;39462;36306;3156;261;132;129
115;19;4;Medianeira;10543;9892;651;53;79;-26
115;19;4;Menino Deus;32738;30012;2726;158;108;50
115;19;4;Moinhos de Vento;11474;10872;602;18;59;-41
115;19;4;MontSerrat;10563;9939;624;-3;56;-59
115;19;4;Morro Santana;19623;18019;1604;132;29;103
115;19;4;Navegantes;3733;3635;98;-52;29;-81
115;19;4;Nonoai;25447;23417;2030;63;19;44
115;19;4;Parque Santa Fé;5413;5202;211;-21;59;-80
115;19;4;Partenon;50409;45747;4662;275;120;155
115;19;4;Passo DAreia;22355;20511;1844;96;65;31
115;19;4;Passo das Pedras;15597;14509;1088;0;68;-68
115;19;4;Pedra Redonda;59;52;7;-16;22;-38
115;19;4;Petrópolis;38855;35491;3364;135;71;64
115;19;4;Pitinga;4107;3818;289;18;2;16
115;19;4;Ponta Grossa;8593;7958;635;17;-11;28
115;19;4;Praia de Belas;1524;1524;0;-51;31;-82
115;19;4;Restinga;55914;52115;3799;-339;-12;-327
115;19;4;Rio Branco;17490;16064;1426;97;104;-7
115;19;4;Rubem Berta;33974;31235;2739;-125;25;-150
115;19;4;Santa Cecília;4748;4496;252;-52;64;-116
115;19;4;Santa Maria Goretti;2786;2652;134;-77;32;-109
115;19;4;Santa Rosa de Lima;36579;33754;2825;-33;71;-104
115;19;4;Santa Tereza;40790;37311;3479;42;76;-34
115;19;4;Santana;21053;19133;1920;26;43;-17
115;19;4;Santo Antônio;12876;11744;1132;-80;6;-86
115;19;4;São Caetano;561;471;90;3;2;1
115;19;4;São Geraldo;8406;7721;685;-21;26;-47
115;19;4;São João;12248;11327;921;-30;31;-61
115;19;4;São Sebastião;6438;6115;323;-63;21;-84
115;19;4;Sarandi;63520;58041;5479;-437;-22;-415
115;19;4;Serraria;6008;5530;478;8;-22;30
115;19;4;Sétimo Céu;739;683;56;3;14;-11
115;19;4;Teresópolis;14531;13218;1313;-90;4;-94
115;19;4;Três Figueiras;3237;3082;155;-130;16;-146
115;19;4;Tristeza;16737;15363;1374;8;-8;16
115;19;4;Vila Assunção;4038;3658;380;8;10;-2
115;19;4;Vila Conceição;943;805;138;-8;-12;4
115;19;4;Vila Ipiranga;18815;17095;1720;-151;-45;-106
115;19;4;Vila Jardim;12951;11766;1185;-175;-74;-101
115;19;4;Vila João Pessoa;12664;11506;1158;12;7;5
115;19;4;Vila Nova;33570;30837;2733;-305;-53;-252
115;19;4;Vila São José;27301;24888;2413;-172;-92;-80
116;20;4;Aberta dos Morros;7112;6890;222;274;459;-185
116;20;4;Agronomia;2538;2224;314;694;421;273
116;20;4;Anchieta;2153;1938;215;608;393;215
116;20;4;Arquipélago;8500;8253;247;206;474;-268
116;20;4;Auxiliadora;9508;9458;50;498;797;-299
116;20;4;Azenha;13536;13536;0;441;907;-466
116;20;4;Bela Vista;11554;11514;40;537;945;-408
116;20;4;Belém Novo;10273;9913;360;9;388;-379
116;20;4;Belém Velho;10960;10641;319;144;600;-456
116;20;4;Boa Vista;9900;9830;70;522;838;-316
116;20;4;Boa Vista do Sul;2438;2122;316;323;166;157
116;20;4;Bom Fim;11408;11361;47;498;886;-388
116;20;4;Bom Jesus;28552;28337;215;-841;1062;-1903
116;20;4;Camaquã;17816;17603;213;-196;771;-967
116;20;4;Campo Novo;8754;8519;235;220;536;-316
116;20;4;Cascata;13075;12788;287;94;718;-624
116;20;4;Cavalhada;29133;28964;169;-943;885;-1828
116;20;4;Centro;39180;38952;228;-1942;874;-2816
116;20;4;Chácara das Pedras;6505;6421;84;717;801;-84
116;20;4;Chapéu do Sol;2929;2688;241;488;340;148
116;20;4;Cidade Baixa;15310;15176;134;179;989;-810
116;20;4;Coronel Aparício Borges;19207;18981;226;-63;989;-1052
116;20;4;Costa e Silva;15683;15526;157;196;975;-779
116;20;4;Cristal;32140;31511;629;-949;1134;-2083
116;20;4;Cristo Redentor;16198;16190;8;-109;684;-793
116;20;4;Espírito Santo;5443;5261;182;366;470;-104
116;20;4;Extrema;2093;1848;245;300;162;138
116;20;4;Farrapos;19220;18796;424;-384;704;-1088
116;20;4;Farroupilha;988;815;173;604;431;173
116;20;4;Floresta;11510;11391;119;328;812;-484
116;20;4;Glória;16930;16740;190;6;1025;-1019
116;20;4;Guarujá;4794;4531;263;409;426;-17
116;20;4;Higienópolis;10554;10456;98;396;824;-428
116;20;4;Hípica;18604;18185;419;-344;706;-1050
116;20;4;Humaitá;11613;11319;294;96;601;-505
116;20;4;Independência;7946;7878;68;613;792;-179
116;20;4;Ipanema;13692;13343;349;-108;631;-739
116;20;4;Jardim Botânico;12262;12234;28;440;905;-465
116;20;4;Jardim Carvalho;25424;24999;425;-607;1097;-1704
116;20;4;Jardim do Salso;4371;4174;197;989;827;162
116;20;4;Jardim Dona Leopoldina;17809;17620;189;303;1200;-897
116;20;4;Jardim Europa;2204;2069;135;753;618;135
116;20;4;Jardim Floresta;3268;3101;167;728;563;165
116;20;4;Jardim Isabel;2799;2586;213;593;432;161
116;20;4;Jardim Itu;17627;17466;161;-42;1006;-1048
116;20;4;Jardim Lindóia;7254;7174;80;412;577;-165
116;20;4;Jardim Sabará;13347;13193;154;252;994;-742
116;20;4;Jardim São Pedro;3935;3749;186;772;653;119
116;20;4;Lageado;4553;4241;312;367;352;15
116;20;4;Lami;4364;4087;277;244;229;15
116;20;4;Lomba do Pinheiro;59009;57848;1161;-3055;1021;-4076
116;20;4;Mário Quintana;38314;37617;697;-1148;1311;-2459
116;20;4;Medianeira;10989;10868;121;446;976;-530
116;20;4;Menino Deus;31587;31240;347;-1151;1228;-2379
116;20;4;Moinhos de Vento;11775;11680;95;301;808;-507
116;20;4;MontSerrat;11082;10908;174;519;969;-450
116;20;4;Morro Santana;19431;18988;443;-192;969;-1161
116;20;4;Navegantes;4349;4158;191;616;523;93
116;20;4;Nonoai;25146;24675;471;-301;1258;-1559
116;20;4;Parque Santa Fé;6254;6075;179;841;873;-32
116;20;4;Partenon;48521;47401;1120;-1888;1654;-3542
116;20;4;Passo DAreia;21894;21571;323;-461;1060;-1521
116;20;4;Passo das Pedras;15778;15535;243;181;1026;-845
116;20;4;Pedra Redonda;341;110;231;282;58;224
116;20;4;Petrópolis;37516;36853;663;-1339;1362;-2701
116;20;4;Pitinga;4531;4186;345;424;368;56
116;20;4;Ponta Grossa;8770;8356;414;177;398;-221
116;20;4;Praia de Belas;2395;2127;268;871;603;268
116;20;4;Restinga;53583;52841;742;-2331;726;-3057
116;20;4;Rio Branco;17312;17093;219;-178;1029;-1207
116;20;4;Rubem Berta;33416;32640;776;-558;1405;-1963
116;20;4;Santa Cecília;5729;5433;296;981;937;44
116;20;4;Santa Maria Goretti;3573;3271;302;787;619;168
116;20;4;Santa Rosa de Lima;35732;34860;872;-847;1106;-1953
116;20;4;Santa Tereza;39783;38768;1015;-1007;1457;-2464
116;20;4;Santana;20561;20236;325;-492;1103;-1595
116;20;4;Santo Antônio;13030;12725;305;154;981;-827
116;20;4;São Caetano;880;582;298;319;111;208
116;20;4;São Geraldo;8747;8429;318;341;708;-367
116;20;4;São João;12173;11960;213;-75;633;-708
116;20;4;São Sebastião;6989;6808;181;551;693;-142
116;20;4;Sarandi;60286;59140;1146;-3234;1099;-4333
116;20;4;Serraria;6280;5860;420;272;330;-58
116;20;4;Sétimo Céu;1225;1018;207;486;335;151
116;20;4;Teresópolis;14608;14203;405;77;985;-908
116;20;4;Três Figueiras;4038;3770;268;801;688;113
116;20;4;Tristeza;16584;16114;470;-153;751;-904
116;20;4;Vila Assunção;4617;4163;454;579;505;74
116;20;4;Vila Conceição;1499;1134;365;556;329;227
116;20;4;Vila Ipiranga;18624;18136;488;-191;1041;-1232
116;20;4;Vila Jardim;13225;12768;457;274;1002;-728
116;20;4;Vila João Pessoa;12913;12559;354;249;1053;-804
116;20;4;Vila Nova;32521;31671;850;-1049;834;-1883
116;20;4;Vila São José;26775;25932;843;-526;1044;-1570
117;21;4;Aberta dos Morros;7108;6946;162;-4;56;-60
117;21;4;Agronomia;2498;2254;244;-40;30;-70
117;21;4;Anchieta;2140;1982;158;-13;44;-57
117;21;4;Arquipélago;8439;8281;158;-61;28;-89
117;21;4;Auxiliadora;9551;9543;8;43;85;-42
117;21;4;Azenha;13639;13639;0;103;103;0
117;21;4;Bela Vista;11629;11609;20;75;95;-20
117;21;4;Belém Novo;10186;9955;231;-87;42;-129
117;21;4;Belém Velho;10882;10685;197;-78;44;-122
117;21;4;Boa Vista;9918;9909;9;18;79;-61
117;21;4;Boa Vista do Sul;2434;2145;289;-4;23;-27
117;21;4;Bom Fim;11455;11442;13;47;81;-34
117;21;4;Bom Jesus;28734;28439;295;182;102;80
117;21;4;Camaquã;17835;17687;148;19;84;-65
117;21;4;Campo Novo;8727;8562;165;-27;43;-70
117;21;4;Cascata;13039;12852;187;-36;64;-100
117;21;4;Cavalhada;29198;29076;122;65;112;-47
117;21;4;Centro;39343;39022;321;163;70;93
117;21;4;Chácara das Pedras;6514;6512;2;9;91;-82
117;21;4;Chapéu do Sol;2925;2742;183;-4;54;-58
117;21;4;Cidade Baixa;15298;15236;62;-12;60;-72
117;21;4;Coronel Aparício Borges;19254;19078;176;47;97;-50
117;21;4;Costa e Silva;15704;15640;64;21;114;-93
117;21;4;Cristal;31995;31686;309;-145;175;-320
117;21;4;Cristo Redentor;16342;16306;36;144;116;28
117;21;4;Espírito Santo;5494;5352;142;51;91;-40
117;21;4;Extrema;2111;1869;242;18;21;-3
117;21;4;Farrapos;19129;18896;233;-91;100;-191
117;21;4;Farroupilha;925;859;66;-63;44;-107
117;21;4;Floresta;11493;11463;30;-17;72;-89
117;21;4;Glória;17001;16844;157;71;104;-33
117;21;4;Guarujá;4826;4616;210;32;85;-53
117;21;4;Higienópolis;10597;10555;42;43;99;-56
117;21;4;Hípica;18575;18316;259;-29;131;-160
117;21;4;Humaitá;11573;11402;171;-40;83;-123
117;21;4;Independência;7966;7960;6;20;82;-62
117;21;4;Ipanema;13720;13465;255;28;122;-94
117;21;4;Jardim Botânico;12331;12331;0;69;97;-28
117;21;4;Jardim Carvalho;25439;25151;288;15;152;-137
117;21;4;Jardim do Salso;4346;4249;97;-25;75;-100
117;21;4;Jardim Dona Leopoldina;17840;17748;92;31;128;-97
117;21;4;Jardim Europa;2257;2179;78;53;110;-57
117;21;4;Jardim Floresta;3299;3196;103;31;95;-64
117;21;4;Jardim Isabel;2792;2635;157;-7;49;-56
117;21;4;Jardim Itu;17763;17628;135;136;162;-26
117;21;4;Jardim Lindóia;7287;7284;3;33;110;-77
117;21;4;Jardim Sabará;13452;13336;116;105;143;-38
117;21;4;Jardim São Pedro;3927;3827;100;-8;78;-86
117;21;4;Lageado;4544;4288;256;-9;47;-56
117;21;4;Lami;4374;4118;256;10;31;-21
117;21;4;Lomba do Pinheiro;58741;57939;802;-268;91;-359
117;21;4;Mário Quintana;38302;37821;481;-12;204;-216
117;21;4;Medianeira;11059;10992;67;70;124;-54
117;21;4;Menino Deus;31805;31414;391;218;174;44
117;21;4;Moinhos de Vento;11810;11772;38;35;92;-57
117;21;4;MontSerrat;11095;11053;42;13;145;-132
117;21;4;Morro Santana;19401;19138;263;-30;150;-180
117;21;4;Navegantes;4317;4220;97;-32;62;-94
117;21;4;Nonoai;25101;24836;265;-45;161;-206
117;21;4;Parque Santa Fé;6295;6194;101;41;119;-78
117;21;4;Partenon;48436;47724;712;-85;323;-408
117;21;4;Passo DAreia;21994;21764;230;100;193;-93
117;21;4;Passo das Pedras;15830;15696;134;52;161;-109
117;21;4;Pedra Redonda;337;133;204;-4;23;-27
117;21;4;Petrópolis;37558;37121;437;42;268;-226
117;21;4;Pitinga;4520;4221;299;-11;35;-46
117;21;4;Ponta Grossa;8745;8463;282;-25;107;-132
117;21;4;Praia de Belas;2287;2171;116;-108;44;-152
117;21;4;Restinga;53516;53034;482;-67;193;-260
117;21;4;Rio Branco;17516;17264;252;204;171;33
117;21;4;Rubem Berta;33292;32827;465;-124;187;-311
117;21;4;Santa Cecília;5626;5544;82;-103;111;-214
117;21;4;Santa Maria Goretti;3530;3360;170;-43;89;-132
117;21;4;Santa Rosa de Lima;35571;35076;495;-161;216;-377
117;21;4;Santa Tereza;39741;39073;668;-42;305;-347
117;21;4;Santana;20746;20442;304;185;206;-21
117;21;4;Santo Antônio;13001;12889;112;-29;164;-193
117;21;4;São Caetano;909;610;299;29;28;1
117;21;4;São Geraldo;8670;8523;147;-77;94;-171
117;21;4;São João;12143;12068;75;-30;108;-138
117;21;4;São Sebastião;6929;6896;33;-60;88;-148
117;21;4;Sarandi;59999;59431;568;-287;291;-578
117;21;4;Serraria;6319;5973;346;39;113;-74
117;21;4;Sétimo Céu;1232;1065;167;7;47;-40
117;21;4;Teresópolis;14607;14394;213;-1;191;-192
117;21;4;Três Figueiras;3989;3889;100;-49;119;-168
117;21;4;Tristeza;16648;16321;327;64;207;-143
117;21;4;Vila Assunção;4562;4232;330;-55;69;-124
117;21;4;Vila Conceição;1514;1171;343;15;37;-22
117;21;4;Vila Ipiranga;18621;18372;249;-3;236;-239
117;21;4;Vila Jardim;13180;12953;227;-45;185;-230
117;21;4;Vila João Pessoa;12875;12706;169;-38;147;-185
117;21;4;Vila Nova;32445;31941;504;-76;270;-346
117;21;4;Vila São José;26689;26155;534;-86;223;-309
118;22;4;Aberta dos Morros;7151;6957;194;43;11;32
118;22;4;Agronomia;2566;2266;300;68;12;56
118;22;4;Anchieta;2184;1958;226;44;-24;68
118;22;4;Arquipélago;8417;8254;163;-22;-27;5
118;22;4;Auxiliadora;9615;9470;145;64;-73;137
118;22;4;Azenha;13746;13583;163;107;-56;163
118;22;4;Bela Vista;11712;11551;161;83;-58;141
118;22;4;Belém Novo;10202;9955;247;16;0;16
118;22;4;Belém Velho;10883;10683;200;1;-2;3
118;22;4;Boa Vista;10013;9850;163;95;-59;154
118;22;4;Boa Vista do Sul;2478;2156;322;44;11;33
118;22;4;Bom Fim;11512;11362;150;57;-80;137
118;22;4;Bom Jesus;28609;28436;173;-125;-3;-122
118;22;4;Camaquã;17828;17666;162;-7;-21;14
118;22;4;Campo Novo;8749;8577;172;22;15;7
118;22;4;Cascata;12997;12833;164;-42;-19;-23
118;22;4;Cavalhada;29259;29054;205;61;-22;83
118;22;4;Centro;39279;38973;306;-64;-49;-15
118;22;4;Chácara das Pedras;6627;6474;153;113;-38;151
118;22;4;Chapéu do Sol;2970;2748;222;45;6;39
118;22;4;Cidade Baixa;15371;15185;186;73;-51;124
118;22;4;Coronel Aparício Borges;19269;19088;181;15;10;5
118;22;4;Costa e Silva;15814;15651;163;110;11;99
118;22;4;Cristal;31935;31705;230;-60;19;-79
118;22;4;Cristo Redentor;16411;16246;165;69;-60;129
118;22;4;Espírito Santo;5516;5356;160;22;4;18
118;22;4;Extrema;2124;1862;262;13;-7;20
118;22;4;Farrapos;19060;18860;200;-69;-36;-33
118;22;4;Farroupilha;939;787;152;14;-72;86
118;22;4;Floresta;11562;11398;164;69;-65;134
118;22;4;Glória;17048;16850;198;47;6;41
118;22;4;Guarujá;4845;4624;221;19;8;11
118;22;4;Higienópolis;10682;10513;169;85;-42;127
118;22;4;Hípica;18592;18360;232;17;44;-27
118;22;4;Humaitá;11561;11380;181;-12;-22;10
118;22;4;Independência;8078;7909;169;112;-51;163
118;22;4;Ipanema;13679;13480;199;-41;15;-56
118;22;4;Jardim Botânico;12482;12311;171;151;-20;171
118;22;4;Jardim Carvalho;25414;25179;235;-25;28;-53
118;22;4;Jardim do Salso;4392;4240;152;46;-9;55
118;22;4;Jardim Dona Leopoldina;17931;17785;146;91;37;54
118;22;4;Jardim Europa;2280;2129;151;23;-50;73
118;22;4;Jardim Floresta;3298;3152;146;-1;-44;43
118;22;4;Jardim Isabel;2809;2631;178;17;-4;21
118;22;4;Jardim Itu;17787;17622;165;24;-6;30
118;22;4;Jardim Lindóia;7403;7246;157;116;-38;154
118;22;4;Jardim Sabará;13488;13322;166;36;-14;50
118;22;4;Jardim São Pedro;3933;3789;144;6;-38;44
118;22;4;Lageado;4552;4295;257;8;7;1
118;22;4;Lami;4373;4099;274;-1;-19;18
118;22;4;Lomba do Pinheiro;58479;57964;515;-262;25;-287
118;22;4;Mário Quintana;38160;37875;285;-142;54;-196
118;22;4;Medianeira;11157;10993;164;98;1;97
118;22;4;Menino Deus;31638;31375;263;-167;-39;-128
118;22;4;Moinhos de Vento;11867;11686;181;57;-86;143
118;22;4;MontSerrat;11164;11002;162;69;-51;120
118;22;4;Morro Santana;19386;19172;214;-15;34;-49
118;22;4;Navegantes;4338;4189;149;21;-31;52
118;22;4;Nonoai;25096;24878;218;-5;42;-47
118;22;4;Parque Santa Fé;6359;6222;137;64;28;36
118;22;4;Partenon;48164;47729;435;-272;5;-277
118;22;4;Passo DAreia;21911;21716;195;-83;-48;-35
118;22;4;Passo das Pedras;15887;15710;177;57;14;43
118;22;4;Pedra Redonda;406;139;267;69;6;63
118;22;4;Petrópolis;37391;37119;272;-167;-2;-165
118;22;4;Pitinga;4537;4231;306;17;10;7
118;22;4;Ponta Grossa;8768;8490;278;23;27;-4
118;22;4;Praia de Belas;2324;2158;166;37;-13;50
118;22;4;Restinga;53277;53084;193;-239;50;-289
118;22;4;Rio Branco;17397;17180;217;-119;-84;-35
118;22;4;Rubem Berta;33170;32866;304;-122;39;-161
118;22;4;Santa Cecília;5655;5497;158;29;-47;76
118;22;4;Santa Maria Goretti;3499;3330;169;-31;-30;-1
118;22;4;Santa Rosa de Lima;35412;35093;319;-159;17;-176
118;22;4;Santa Tereza;39585;39116;469;-156;43;-199
118;22;4;Santana;20661;20403;258;-85;-39;-46
118;22;4;Santo Antônio;13091;12904;187;90;15;75
118;22;4;São Caetano;884;574;310;-25;-36;11
118;22;4;São Geraldo;8651;8494;157;-19;-29;10
118;22;4;São João;12213;12034;179;70;-34;104
118;22;4;São Sebastião;7006;6869;137;77;-27;104
118;22;4;Sarandi;59803;59446;357;-196;15;-211
118;22;4;Serraria;6323;5995;328;4;22;-18
118;22;4;Sétimo Céu;1260;1071;189;28;6;22
118;22;4;Teresópolis;14656;14428;228;49;34;15
118;22;4;Três Figueiras;4026;3873;153;37;-16;53
118;22;4;Tristeza;16613;16310;303;-35;-11;-24
118;22;4;Vila Assunção;4494;4230;264;-68;-2;-66
118;22;4;Vila Conceição;1513;1153;360;-1;-18;17
118;22;4;Vila Ipiranga;18585;18369;216;-36;-3;-33
118;22;4;Vila Jardim;13154;12953;201;-26;0;-26
118;22;4;Vila João Pessoa;12933;12752;181;58;46;12
118;22;4;Vila Nova;32349;31980;369;-96;39;-135
118;22;4;Vila São José;26684;26222;462;-5;67;-72
119;23;4;Aberta dos Morros;7146;7146;0;-5;189;-194
119;23;4;Agronomia;2331;2331;0;-235;65;-300
119;23;4;Anchieta;2024;2024;0;-160;66;-226
119;23;4;Arquipélago;8330;8330;0;-87;76;-163
119;23;4;Auxiliadora;9683;9683;0;68;213;-145
119;23;4;Azenha;13804;13804;0;58;221;-163
119;23;4;Bela Vista;11787;11787;0;75;236;-161
119;23;4;Belém Novo;10100;10100;0;-102;145;-247
119;23;4;Belém Velho;10835;10835;0;-48;152;-200
119;23;4;Boa Vista;10053;10053;0;40;203;-163
119;23;4;Boa Vista do Sul;2309;2309;0;-169;153;-322
119;23;4;Bom Fim;11593;11593;0;81;231;-150
119;23;4;Bom Jesus;28675;28675;0;66;239;-173
119;23;4;Camaquã;17938;17938;0;110;272;-162
119;23;4;Campo Novo;8766;8766;0;17;189;-172
119;23;4;Cascata;13013;13013;0;16;180;-164
119;23;4;Cavalhada;29299;29299;0;40;245;-205
119;23;4;Centro;39154;39154;0;-125;181;-306
119;23;4;Chácara das Pedras;6668;6668;0;41;194;-153
119;23;4;Chapéu do Sol;2913;2913;0;-57;165;-222
119;23;4;Cidade Baixa;15379;15379;0;8;194;-186
119;23;4;Coronel Aparício Borges;19303;19303;0;34;215;-181
119;23;4;Costa e Silva;15842;15842;0;28;191;-163
119;23;4;Cristal;31946;31946;0;11;241;-230
119;23;4;Cristo Redentor;16455;16455;0;44;209;-165
119;23;4;Espírito Santo;5606;5606;0;90;250;-160
119;23;4;Extrema;1981;1981;0;-143;119;-262
119;23;4;Farrapos;18986;18986;0;-74;126;-200
119;23;4;Farroupilha;961;961;0;22;174;-152
119;23;4;Floresta;11596;11596;0;34;198;-164
119;23;4;Glória;17067;17067;0;19;217;-198
119;23;4;Guarujá;4811;4811;0;-34;187;-221
119;23;4;Higienópolis;10724;10724;0;42;211;-169
119;23;4;Hípica;18645;18645;0;53;285;-232
119;23;4;Humaitá;11502;11502;0;-59;122;-181
119;23;4;Independência;8112;8112;0;34;203;-169
119;23;4;Ipanema;13728;13728;0;49;248;-199
119;23;4;Jardim Botânico;12521;12521;0;39;210;-171
119;23;4;Jardim Carvalho;25386;25386;0;-28;207;-235
119;23;4;Jardim do Salso;4405;4405;0;13;165;-152
119;23;4;Jardim Dona Leopoldina;18016;18016;0;85;231;-146
119;23;4;Jardim Europa;2299;2299;0;19;170;-151
119;23;4;Jardim Floresta;3307;3307;0;9;155;-146
119;23;4;Jardim Isabel;2835;2835;0;26;204;-178
119;23;4;Jardim Itu;17853;17853;0;66;231;-165
119;23;4;Jardim Lindóia;7417;7417;0;14;171;-157
119;23;4;Jardim Sabará;13530;13530;0;42;208;-166
119;23;4;Jardim São Pedro;3967;3967;0;34;178;-144
119;23;4;Lageado;4481;4481;0;-71;186;-257
119;23;4;Lami;4289;4289;0;-84;190;-274
119;23;4;Lomba do Pinheiro;58106;58106;0;-373;142;-515
119;23;4;Mário Quintana;38116;38116;0;-44;241;-285
119;23;4;Medianeira;11223;11223;0;66;230;-164
119;23;4;Menino Deus;31650;31650;0;12;275;-263
119;23;4;Moinhos de Vento;11937;11937;0;70;251;-181
119;23;4;MontSerrat;11236;11236;0;72;234;-162
119;23;4;Morro Santana;19338;19338;0;-48;166;-214
119;23;4;Navegantes;4327;4327;0;-11;138;-149
119;23;4;Nonoai;25160;25160;0;64;282;-218
119;23;4;Parque Santa Fé;6376;6376;0;17;154;-137
119;23;4;Partenon;48160;48160;0;-4;431;-435
119;23;4;Passo DAreia;21968;21968;0;57;252;-195
119;23;4;Passo das Pedras;15902;15902;0;15;192;-177
119;23;4;Pedra Redonda;274;274;0;-132;135;-267
119;23;4;Petrópolis;37496;37496;0;105;377;-272
119;23;4;Pitinga;4352;4352;0;-185;121;-306
119;23;4;Ponta Grossa;8722;8722;0;-46;232;-278
119;23;4;Praia de Belas;2281;2281;0;-43;123;-166
119;23;4;Restinga;53508;53508;0;231;424;-193
119;23;4;Rio Branco;17531;17531;0;134;351;-217
119;23;4;Rubem Berta;33168;33168;0;-2;302;-304
119;23;4;Santa Cecília;5768;5768;0;113;271;-158
119;23;4;Santa Maria Goretti;3509;3509;0;10;179;-169
119;23;4;Santa Rosa de Lima;35333;35333;0;-79;240;-319
119;23;4;Santa Tereza;39577;39577;0;-8;461;-469
119;23;4;Santana;20723;20723;0;62;320;-258
119;23;4;Santo Antônio;13161;13161;0;70;257;-187
119;23;4;São Caetano;757;757;0;-127;183;-310
119;23;4;São Geraldo;8681;8681;0;30;187;-157
119;23;4;São João;12226;12226;0;13;192;-179
119;23;4;São Sebastião;7019;7019;0;13;150;-137
119;23;4;Sarandi;59711;59711;0;-92;265;-357
119;23;4;Serraria;6239;6239;0;-84;244;-328
119;23;4;Sétimo Céu;1329;1329;0;69;258;-189
119;23;4;Teresópolis;14707;14707;0;51;279;-228
119;23;4;Três Figueiras;4070;4070;0;44;197;-153
119;23;4;Tristeza;16692;16692;0;79;382;-303
119;23;4;Vila Assunção;4418;4418;0;-76;188;-264
119;23;4;Vila Conceição;1349;1349;0;-164;196;-360
119;23;4;Vila Ipiranga;18659;18659;0;74;290;-216
119;23;4;Vila Jardim;13189;13189;0;35;236;-201
119;23;4;Vila João Pessoa;13041;13041;0;108;289;-181
119;23;4;Vila Nova;32469;32469;0;120;489;-369
119;23;4;Vila São José;26522;26522;0;-162;300;-462
