;Cycle;Origin;Destination;Total;age: [children];age: [adults];age: [elders];occupation: [student];occupation: [worker]
0;0;Aberta dos Morros;Aberta dos Morros;2794;0;1666;468;100;2694
1;0;Aberta dos Morros;Agronomia;50;50;0;0;50;0
2;0;Aberta dos Morros;Anchieta;52;0;35;5;0;52
3;0;Aberta dos Morros;Arquipélago;0;0;0;0;0;0
4;0;Aberta dos Morros;Auxiliadora;3;0;2;1;0;3
5;0;Aberta dos Morros;Azenha;0;0;0;0;0;0
6;0;Aberta dos Morros;Bela Vista;4;0;1;3;0;4
7;0;Aberta dos Morros;Belém Novo;175;100;17;4;150;25
8;0;Aberta dos Morros;Belém Velho;276;150;17;5;250;26
9;0;Aberta dos Morros;Boa Vista;50;0;0;0;50;0
10;0;Aberta dos Morros;Boa Vista do Sul;75;0;17;5;50;25
11;0;Aberta dos Morros;Bom Fim;0;0;0;0;0;0
12;0;Aberta dos Morros;Bom Jesus;3;0;1;1;0;3
13;0;Aberta dos Morros;Camaquã;97;0;75;11;50;47
14;0;Aberta dos Morros;Campo Novo;1299;200;554;169;350;949
15;0;Aberta dos Morros;Cascata;50;0;0;0;50;0
16;0;Aberta dos Morros;Cavalhada;325;0;133;52;100;225
17;0;Aberta dos Morros;Cel. Aparício Borges;153;0;113;17;50;103
18;0;Aberta dos Morros;Centro Histórico;41;0;23;9;0;41
19;0;Aberta dos Morros;Chapéu do Sol;50;0;28;11;0;50
20;0;Aberta dos Morros;Chácara das Pedras;100;50;0;0;100;0
21;0;Aberta dos Morros;Cidade Baixa;54;0;32;8;0;54
22;0;Aberta dos Morros;Costa e Silva;105;0;34;5;50;55
23;0;Aberta dos Morros;Cristal;129;50;34;22;50;79
24;0;Aberta dos Morros;Cristo Redentor;5;0;3;1;0;5
25;0;Aberta dos Morros;Espírito Santo;1892;750;250;47;1642;250
26;0;Aberta dos Morros;Extrema;100;0;0;0;100;0
27;0;Aberta dos Morros;Farrapos;5345;0;3236;992;0;5345
28;0;Aberta dos Morros;Farroupilha;69;0;40;19;0;69
29;0;Aberta dos Morros;Floresta;52;0;1;0;50;2
30;0;Aberta dos Morros;Glória;50;50;0;0;50;0
31;0;Aberta dos Morros;Guarujá;214;50;91;29;76;138
32;0;Aberta dos Morros;Higienópolis;0;0;0;0;0;0
33;0;Aberta dos Morros;Humaitá;100;0;66;20;0;100
34;0;Aberta dos Morros;Hípica;1101;300;201;49;800;301
35;0;Aberta dos Morros;Independência;0;0;0;0;0;0
36;0;Aberta dos Morros;Ipanema;287;0;139;50;50;237
37;0;Aberta dos Morros;Jardim Botânico;6;0;1;3;0;6
38;0;Aberta dos Morros;Jardim Carvalho;0;0;0;0;0;0
39;0;Aberta dos Morros;Jardim Europa;0;0;0;0;0;0
40;0;Aberta dos Morros;Jardim Floresta;50;0;0;0;50;0
41;0;Aberta dos Morros;Jardim Isabel;100;50;24;10;50;50
42;0;Aberta dos Morros;Jardim Itú;0;0;0;0;0;0
43;0;Aberta dos Morros;Jardim Leopoldina;54;0;31;7;0;54
44;0;Aberta dos Morros;Jardim Lindóia;50;0;32;9;0;50
45;0;Aberta dos Morros;Jardim Sabará;19;0;9;7;0;19
46;0;Aberta dos Morros;Jardim São Pedro;0;0;0;0;0;0
47;0;Aberta dos Morros;Jardim do Salso;0;0;0;0;0;0
48;0;Aberta dos Morros;Lageado;162;0;82;9;50;112
49;0;Aberta dos Morros;Lami;0;0;0;0;0;0
50;0;Aberta dos Morros;Lomba do Pinheiro;29;0;12;1;0;29
51;0;Aberta dos Morros;Medianeira;119;100;10;6;100;19
52;0;Aberta dos Morros;Menino Deus;104;0;32;7;50;54
53;0;Aberta dos Morros;Moinhos de Vento;19;0;13;5;0;19
54;0;Aberta dos Morros;Mont'Serrat;13;0;11;1;0;13
55;0;Aberta dos Morros;Morro Santana;6;0;2;2;0;6
56;0;Aberta dos Morros;Mário Quintana;4;0;2;0;0;4
57;0;Aberta dos Morros;Navegantes;50;0;0;0;50;0
58;0;Aberta dos Morros;Nonoai;104;0;60;16;0;104
59;0;Aberta dos Morros;Parque Santa Fé;0;0;0;0;0;0
60;0;Aberta dos Morros;Partenon;32;0;20;5;0;32
61;0;Aberta dos Morros;Passo D'Areia;53;50;2;0;50;3
62;0;Aberta dos Morros;Passo das Pedras;4;0;1;2;0;4
63;0;Aberta dos Morros;Pedra Redonda;0;0;0;0;0;0
64;0;Aberta dos Morros;Petrópolis;305;50;107;29;200;105
65;0;Aberta dos Morros;Pitinga;0;0;0;0;0;0
66;0;Aberta dos Morros;Ponta Grossa;319;50;167;42;50;269
67;0;Aberta dos Morros;Praia de Belas;0;0;0;0;0;0
68;0;Aberta dos Morros;Restinga;1615;450;363;99;950;665
69;0;Aberta dos Morros;Rio Branco;30;0;15;10;0;30
70;0;Aberta dos Morros;Rubem Berta;3;0;2;1;0;3
71;0;Aberta dos Morros;Santa Cecília;12;0;8;3;0;12
72;0;Aberta dos Morros;Santa Maria Goretti;25;0;17;0;0;25
73;0;Aberta dos Morros;Santa Rosa de Lima;0;0;0;0;0;0
74;0;Aberta dos Morros;Santa Tereza;55;0;25;12;0;55
75;0;Aberta dos Morros;Santana;123;100;13;6;100;23
76;0;Aberta dos Morros;Santo Antônio;101;0;67;17;0;101
77;0;Aberta dos Morros;Sarandi;180;0;48;15;100;80
78;0;Aberta dos Morros;Serraria;450;150;92;29;300;150
79;0;Aberta dos Morros;São Caetano;0;0;0;0;0;0
80;0;Aberta dos Morros;São Geraldo;50;50;0;0;50;0
81;0;Aberta dos Morros;São José;29;0;19;3;0;29
82;0;Aberta dos Morros;São João;0;0;0;0;0;0
83;0;Aberta dos Morros;São Sebastião;50;0;37;8;0;50
84;0;Aberta dos Morros;Sétimo Céu;0;0;0;0;0;0
85;0;Aberta dos Morros;Teresópolis;102;0;34;11;50;52
86;0;Aberta dos Morros;Tristeza;117;50;11;1;100;17
87;0;Aberta dos Morros;Três Figueiras;100;50;25;10;50;50
88;0;Aberta dos Morros;Vila Assunção;0;0;0;0;0;0
89;0;Aberta dos Morros;Vila Conceição;50;0;25;8;0;50
90;0;Aberta dos Morros;Vila Ipiranga;100;0;32;7;50;50
91;0;Aberta dos Morros;Vila Jardim;30;0;19;7;0;30
92;0;Aberta dos Morros;Vila João Pessoa;50;0;0;0;50;0
93;0;Aberta dos Morros;Vila Nova;587;50;198;69;250;337
94;0;Agronomia;Aberta dos Morros;50;50;0;0;50;0
95;0;Agronomia;Agronomia;340;0;140;8;240;100
96;0;Agronomia;Anchieta;50;0;29;6;0;50
97;0;Agronomia;Arquipélago;0;0;0;0;0;0
98;0;Agronomia;Auxiliadora;100;0;51;21;0;100
99;0;Agronomia;Azenha;100;0;52;19;0;100
100;0;Agronomia;Bela Vista;100;0;59;26;0;100
101;0;Agronomia;Belém Novo;50;0;25;16;0;50
102;0;Agronomia;Belém Velho;151;48;57;15;48;103
103;0;Agronomia;Boa Vista;0;0;0;0;0;0
104;0;Agronomia;Boa Vista do Sul;0;0;0;0;0;0
105;0;Agronomia;Bom Fim;50;50;0;0;50;0
106;0;Agronomia;Bom Jesus;819;294;201;64;464;355
107;0;Agronomia;Camaquã;50;0;29;13;0;50
108;0;Agronomia;Campo Novo;148;48;65;18;48;100
109;0;Agronomia;Cascata;343;193;106;16;193;150
110;0;Agronomia;Cavalhada;15;0;12;2;0;15
111;0;Agronomia;Cel. Aparício Borges;108;0;32;9;50;58
112;0;Agronomia;Centro Histórico;3;0;2;1;0;3
113;0;Agronomia;Chapéu do Sol;48;0;0;0;48;0
114;0;Agronomia;Chácara das Pedras;0;0;0;0;0;0
115;0;Agronomia;Cidade Baixa;0;0;0;0;0;0
116;0;Agronomia;Costa e Silva;55;0;40;7;0;55
117;0;Agronomia;Cristal;50;0;7;1;35;15
118;0;Agronomia;Cristo Redentor;55;0;52;3;50;5
119;0;Agronomia;Espírito Santo;100;0;48;24;0;100
120;0;Agronomia;Extrema;0;0;0;0;0;0
121;0;Agronomia;Farrapos;553;90;83;8;503;50
122;0;Agronomia;Farroupilha;0;0;0;0;0;0
123;0;Agronomia;Floresta;100;0;52;18;0;100
124;0;Agronomia;Glória;100;0;58;16;0;100
125;0;Agronomia;Guarujá;0;0;0;0;0;0
126;0;Agronomia;Higienópolis;0;0;0;0;0;0
127;0;Agronomia;Humaitá;0;0;0;0;0;0
128;0;Agronomia;Hípica;100;0;72;15;0;100
129;0;Agronomia;Independência;0;0;0;0;0;0
130;0;Agronomia;Ipanema;54;0;31;17;0;54
131;0;Agronomia;Jardim Botânico;103;0;42;3;48;55
132;0;Agronomia;Jardim Carvalho;3172;1268;304;45;2872;300
133;0;Agronomia;Jardim Europa;0;0;0;0;0;0
134;0;Agronomia;Jardim Floresta;0;0;0;0;0;0
135;0;Agronomia;Jardim Isabel;0;0;0;0;0;0
136;0;Agronomia;Jardim Itú;150;0;88;26;0;150
137;0;Agronomia;Jardim Leopoldina;153;0;68;18;50;103
138;0;Agronomia;Jardim Lindóia;0;0;0;0;0;0
139;0;Agronomia;Jardim Sabará;248;48;129;40;48;200
140;0;Agronomia;Jardim São Pedro;0;0;0;0;0;0
141;0;Agronomia;Jardim do Salso;0;0;0;0;0;0
142;0;Agronomia;Lageado;50;0;27;9;0;50
143;0;Agronomia;Lami;0;0;0;0;0;0
144;0;Agronomia;Lomba do Pinheiro;5909;634;2882;613;1155;4754
145;0;Agronomia;Medianeira;0;0;0;0;0;0
146;0;Agronomia;Menino Deus;109;0;59;28;0;109
147;0;Agronomia;Moinhos de Vento;0;0;0;0;0;0
148;0;Agronomia;Mont'Serrat;0;0;0;0;0;0
149;0;Agronomia;Morro Santana;653;48;315;103;48;605
150;0;Agronomia;Mário Quintana;113;0;71;13;0;113
151;0;Agronomia;Navegantes;0;0;0;0;0;0
152;0;Agronomia;Nonoai;0;0;0;0;0;0
153;0;Agronomia;Parque Santa Fé;0;0;0;0;0;0
154;0;Agronomia;Partenon;204;50;83;13;148;56
155;0;Agronomia;Passo D'Areia;158;50;41;38;50;108
156;0;Agronomia;Passo das Pedras;206;0;114;37;0;206
157;0;Agronomia;Pedra Redonda;0;0;0;0;0;0
158;0;Agronomia;Petrópolis;109;0;65;29;0;109
159;0;Agronomia;Pitinga;0;0;0;0;0;0
160;0;Agronomia;Ponta Grossa;0;0;0;0;0;0
161;0;Agronomia;Praia de Belas;0;0;0;0;0;0
162;0;Agronomia;Restinga;398;50;190;44;85;313
163;0;Agronomia;Rio Branco;4;0;2;2;0;4
164;0;Agronomia;Rubem Berta;50;0;0;0;50;0
165;0;Agronomia;Santa Cecília;0;0;0;0;0;0
166;0;Agronomia;Santa Maria Goretti;0;0;0;0;0;0
167;0;Agronomia;Santa Rosa de Lima;147;50;50;0;147;0
168;0;Agronomia;Santa Tereza;192;0;103;28;35;157
169;0;Agronomia;Santana;4;0;1;1;0;4
170;0;Agronomia;Santo Antônio;185;0;95;28;35;150
171;0;Agronomia;Sarandi;114;0;45;16;50;64
172;0;Agronomia;Serraria;50;0;34;12;0;50
173;0;Agronomia;São Caetano;50;0;33;9;0;50
174;0;Agronomia;São Geraldo;98;48;28;14;48;50
175;0;Agronomia;São José;2916;733;1000;279;1212;1704
176;0;Agronomia;São João;0;0;0;0;0;0
177;0;Agronomia;São Sebastião;0;0;0;0;0;0
178;0;Agronomia;Sétimo Céu;50;0;26;7;0;50
179;0;Agronomia;Teresópolis;50;50;0;0;50;0
180;0;Agronomia;Tristeza;6;0;6;0;0;6
181;0;Agronomia;Três Figueiras;0;0;0;0;0;0
182;0;Agronomia;Vila Assunção;0;0;0;0;0;0
183;0;Agronomia;Vila Conceição;0;0;0;0;0;0
184;0;Agronomia;Vila Ipiranga;0;0;0;0;0;0
185;0;Agronomia;Vila Jardim;153;50;25;19;100;53
186;0;Agronomia;Vila João Pessoa;445;98;114;52;245;200
187;0;Agronomia;Vila Nova;214;0;114;42;0;214
188;0;Anchieta;Aberta dos Morros;68;0;36;8;0;68
189;0;Anchieta;Agronomia;0;0;0;0;0;0
190;0;Anchieta;Anchieta;0;0;0;0;0;0
191;0;Anchieta;Arquipélago;0;0;0;0;0;0
192;0;Anchieta;Auxiliadora;8;0;6;2;0;8
193;0;Anchieta;Azenha;24;0;13;4;0;24
194;0;Anchieta;Bela Vista;88;0;56;18;0;88
195;0;Anchieta;Belém Novo;0;0;0;0;0;0
196;0;Anchieta;Belém Velho;106;50;35;6;50;56
197;0;Anchieta;Boa Vista;100;0;24;11;50;50
198;0;Anchieta;Boa Vista do Sul;50;50;0;0;50;0
199;0;Anchieta;Bom Fim;0;0;0;0;0;0
200;0;Anchieta;Bom Jesus;76;50;13;2;50;26
201;0;Anchieta;Camaquã;10;0;6;3;0;10
202;0;Anchieta;Campo Novo;50;0;0;0;50;0
203;0;Anchieta;Cascata;74;0;37;7;0;74
204;0;Anchieta;Cavalhada;186;50;47;16;100;86
205;0;Anchieta;Cel. Aparício Borges;132;0;44;14;50;82
206;0;Anchieta;Centro Histórico;44;0;21;8;0;44
207;0;Anchieta;Chapéu do Sol;0;0;0;0;0;0
208;0;Anchieta;Chácara das Pedras;0;0;0;0;0;0
209;0;Anchieta;Cidade Baixa;75;0;39;16;0;75
210;0;Anchieta;Costa e Silva;24;0;12;6;0;24
211;0;Anchieta;Cristal;102;50;29;9;50;52
212;0;Anchieta;Cristo Redentor;206;50;34;13;150;56
213;0;Anchieta;Espírito Santo;0;0;0;0;0;0
214;0;Anchieta;Extrema;0;0;0;0;0;0
215;0;Anchieta;Farrapos;4134;650;1678;746;1050;3084
216;0;Anchieta;Farroupilha;0;0;0;0;0;0
217;0;Anchieta;Floresta;50;0;0;0;50;0
218;0;Anchieta;Glória;24;0;17;3;0;24
219;0;Anchieta;Guarujá;24;0;11;6;0;24
220;0;Anchieta;Higienópolis;55;0;40;6;0;55
221;0;Anchieta;Humaitá;497;200;39;12;431;66
222;0;Anchieta;Hípica;0;0;0;0;0;0
223;0;Anchieta;Independência;0;0;0;0;0;0
224;0;Anchieta;Ipanema;40;0;26;8;0;40
225;0;Anchieta;Jardim Botânico;25;0;14;4;0;25
226;0;Anchieta;Jardim Carvalho;74;0;15;3;50;24
227;0;Anchieta;Jardim Europa;0;0;0;0;0;0
228;0;Anchieta;Jardim Floresta;0;0;0;0;0;0
229;0;Anchieta;Jardim Isabel;0;0;0;0;0;0
230;0;Anchieta;Jardim Itú;168;100;9;4;150;18
231;0;Anchieta;Jardim Leopoldina;171;50;52;10;100;71
232;0;Anchieta;Jardim Lindóia;74;50;14;7;50;24
233;0;Anchieta;Jardim Sabará;10;0;2;6;0;10
234;0;Anchieta;Jardim São Pedro;400;50;170;36;100;300
235;0;Anchieta;Jardim do Salso;0;0;0;0;0;0
236;0;Anchieta;Lageado;0;0;0;0;0;0
237;0;Anchieta;Lami;0;0;0;0;0;0
238;0;Anchieta;Lomba do Pinheiro;122;0;68;20;0;122
239;0;Anchieta;Medianeira;0;0;0;0;0;0
240;0;Anchieta;Menino Deus;85;0;20;11;50;35
241;0;Anchieta;Moinhos de Vento;18;0;7;8;0;18
242;0;Anchieta;Mont'Serrat;52;0;35;15;0;52
243;0;Anchieta;Morro Santana;51;0;37;9;0;51
244;0;Anchieta;Mário Quintana;117;50;44;6;50;67
245;0;Anchieta;Navegantes;100;50;0;0;100;0
246;0;Anchieta;Nonoai;110;100;4;3;100;10
247;0;Anchieta;Parque Santa Fé;0;0;0;0;0;0
248;0;Anchieta;Partenon;119;0;67;23;0;119
249;0;Anchieta;Passo D'Areia;265;50;51;68;100;165
250;0;Anchieta;Passo das Pedras;111;50;33;13;50;61
251;0;Anchieta;Pedra Redonda;0;0;0;0;0;0
252;0;Anchieta;Petrópolis;106;0;70;20;0;106
253;0;Anchieta;Pitinga;0;0;0;0;0;0
254;0;Anchieta;Ponta Grossa;24;0;14;4;0;24
255;0;Anchieta;Praia de Belas;0;0;0;0;0;0
256;0;Anchieta;Restinga;161;50;40;8;100;61
257;0;Anchieta;Rio Branco;30;0;17;11;0;30
258;0;Anchieta;Rubem Berta;27;0;11;12;0;27
259;0;Anchieta;Santa Cecília;0;0;0;0;0;0
260;0;Anchieta;Santa Maria Goretti;806;300;160;30;532;274
261;0;Anchieta;Santa Rosa de Lima;153;50;29;9;100;53
262;0;Anchieta;Santa Tereza;85;50;21;5;50;35
263;0;Anchieta;Santana;24;0;12;8;0;24
264;0;Anchieta;Santo Antônio;5;0;2;1;0;5
265;0;Anchieta;Sarandi;729;0;412;180;50;679
266;0;Anchieta;Serraria;0;0;0;0;0;0
267;0;Anchieta;São Caetano;50;0;0;0;50;0
268;0;Anchieta;São Geraldo;60;0;8;1;50;10
269;0;Anchieta;São José;22;0;15;5;0;22
270;0;Anchieta;São João;92;0;46;15;0;92
271;0;Anchieta;São Sebastião;50;50;0;0;50;0
272;0;Anchieta;Sétimo Céu;0;0;0;0;0;0
273;0;Anchieta;Teresópolis;10;0;5;2;0;10
274;0;Anchieta;Tristeza;26;0;15;6;0;26
275;0;Anchieta;Três Figueiras;0;0;0;0;0;0
276;0;Anchieta;Vila Assunção;0;0;0;0;0;0
277;0;Anchieta;Vila Conceição;0;0;0;0;0;0
278;0;Anchieta;Vila Ipiranga;29;0;16;7;0;29
279;0;Anchieta;Vila Jardim;36;0;19;11;0;36
280;0;Anchieta;Vila João Pessoa;34;0;21;6;0;34
281;0;Anchieta;Vila Nova;276;0;133;44;50;226
282;0;Arquipélago;Aberta dos Morros;0;0;0;0;0;0
283;0;Arquipélago;Agronomia;0;0;0;0;0;0
284;0;Arquipélago;Anchieta;0;0;0;0;0;0
285;0;Arquipélago;Arquipélago;76;0;51;9;0;76
286;0;Arquipélago;Auxiliadora;206;100;59;17;100;106
287;0;Arquipélago;Azenha;339;100;99;35;150;189
288;0;Arquipélago;Bela Vista;161;50;44;9;100;61
289;0;Arquipélago;Belém Novo;100;0;51;28;0;100
290;0;Arquipélago;Belém Velho;102;50;37;9;50;52
291;0;Arquipélago;Boa Vista;7;0;6;1;0;7
292;0;Arquipélago;Boa Vista do Sul;50;0;0;0;50;0
293;0;Arquipélago;Bom Fim;350;100;111;19;150;200
294;0;Arquipélago;Bom Jesus;30;0;21;3;0;30
295;0;Arquipélago;Camaquã;55;0;4;0;50;5
296;0;Arquipélago;Campo Novo;0;0;0;0;0;0
297;0;Arquipélago;Cascata;76;0;17;4;50;26
298;0;Arquipélago;Cavalhada;122;50;16;5;100;22
299;0;Arquipélago;Cel. Aparício Borges;73;0;17;1;50;23
300;0;Arquipélago;Centro Histórico;1162;100;620;164;100;1062
301;0;Arquipélago;Chapéu do Sol;0;0;0;0;0;0
302;0;Arquipélago;Chácara das Pedras;0;0;0;0;0;0
303;0;Arquipélago;Cidade Baixa;257;100;60;24;150;107
304;0;Arquipélago;Costa e Silva;42;0;23;8;0;42
305;0;Arquipélago;Cristal;71;50;11;5;50;21
306;0;Arquipélago;Cristo Redentor;119;50;33;28;50;69
307;0;Arquipélago;Espírito Santo;50;0;29;9;0;50
308;0;Arquipélago;Extrema;100;0;49;25;0;100
309;0;Arquipélago;Farrapos;2124;0;1172;427;50;2074
310;0;Arquipélago;Farroupilha;550;200;183;52;250;300
311;0;Arquipélago;Floresta;26;0;13;5;0;26
312;0;Arquipélago;Glória;66;0;11;0;50;16
313;0;Arquipélago;Guarujá;0;0;0;0;0;0
314;0;Arquipélago;Higienópolis;57;50;4;3;50;7
315;0;Arquipélago;Humaitá;26;0;14;4;0;26
316;0;Arquipélago;Hípica;76;0;39;11;0;76
317;0;Arquipélago;Independência;100;0;54;15;0;100
318;0;Arquipélago;Ipanema;40;0;20;8;0;40
319;0;Arquipélago;Jardim Botânico;79;0;42;13;0;79
320;0;Arquipélago;Jardim Carvalho;106;0;5;0;100;6
321;0;Arquipélago;Jardim Europa;0;0;0;0;0;0
322;0;Arquipélago;Jardim Floresta;100;50;22;14;50;50
323;0;Arquipélago;Jardim Isabel;0;0;0;0;0;0
324;0;Arquipélago;Jardim Itú;23;0;16;3;0;23
325;0;Arquipélago;Jardim Leopoldina;115;100;10;4;100;15
326;0;Arquipélago;Jardim Lindóia;100;50;0;0;100;0
327;0;Arquipélago;Jardim Sabará;154;100;3;0;150;4
328;0;Arquipélago;Jardim São Pedro;13;0;7;6;0;13
329;0;Arquipélago;Jardim do Salso;0;0;0;0;0;0
330;0;Arquipélago;Lageado;50;50;0;0;50;0
331;0;Arquipélago;Lami;0;0;0;0;0;0
332;0;Arquipélago;Lomba do Pinheiro;341;0;177;33;50;291
333;0;Arquipélago;Medianeira;0;0;0;0;0;0
334;0;Arquipélago;Menino Deus;352;50;141;63;100;252
335;0;Arquipélago;Moinhos de Vento;176;0;95;33;0;176
336;0;Arquipélago;Mont'Serrat;3;0;2;1;0;3
337;0;Arquipélago;Morro Santana;67;0;14;2;50;17
338;0;Arquipélago;Mário Quintana;165;0;59;15;50;115
339;0;Arquipélago;Navegantes;26;0;8;10;0;26
340;0;Arquipélago;Nonoai;190;0;111;41;0;190
341;0;Arquipélago;Parque Santa Fé;100;0;55;16;0;100
342;0;Arquipélago;Partenon;264;50;65;24;150;114
343;0;Arquipélago;Passo D'Areia;98;0;19;14;50;48
344;0;Arquipélago;Passo das Pedras;16;0;9;4;0;16
345;0;Arquipélago;Pedra Redonda;50;0;0;0;50;0
346;0;Arquipélago;Petrópolis;393;50;143;42;150;243
347;0;Arquipélago;Pitinga;0;0;0;0;0;0
348;0;Arquipélago;Ponta Grossa;50;0;34;11;0;50
349;0;Arquipélago;Praia de Belas;1150;300;314;61;650;500
350;0;Arquipélago;Restinga;200;50;60;12;100;100
351;0;Arquipélago;Rio Branco;66;0;31;13;0;66
352;0;Arquipélago;Rubem Berta;5;0;2;2;0;5
353;0;Arquipélago;Santa Cecília;54;50;2;1;50;4
354;0;Arquipélago;Santa Maria Goretti;0;0;0;0;0;0
355;0;Arquipélago;Santa Rosa de Lima;55;0;5;0;50;5
356;0;Arquipélago;Santa Tereza;312;0;130;28;100;212
357;0;Arquipélago;Santana;17;0;7;5;0;17
358;0;Arquipélago;Santo Antônio;105;0;28;11;50;55
359;0;Arquipélago;Sarandi;183;0;71;33;50;133
360;0;Arquipélago;Serraria;100;50;23;8;50;50
361;0;Arquipélago;São Caetano;0;0;0;0;0;0
362;0;Arquipélago;São Geraldo;0;0;0;0;0;0
363;0;Arquipélago;São José;140;0;61;10;50;90
364;0;Arquipélago;São João;150;100;28;9;100;50
365;0;Arquipélago;São Sebastião;126;50;45;13;50;76
366;0;Arquipélago;Sétimo Céu;100;0;57;12;0;100
367;0;Arquipélago;Teresópolis;0;0;0;0;0;0
368;0;Arquipélago;Tristeza;17;0;11;5;0;17
369;0;Arquipélago;Três Figueiras;50;50;0;0;50;0
370;0;Arquipélago;Vila Assunção;50;0;0;0;50;0
371;0;Arquipélago;Vila Conceição;0;0;0;0;0;0
372;0;Arquipélago;Vila Ipiranga;31;0;22;5;0;31
373;0;Arquipélago;Vila Jardim;112;50;6;4;100;12
374;0;Arquipélago;Vila João Pessoa;150;0;39;10;100;50
375;0;Arquipélago;Vila Nova;133;100;12;9;100;33
376;0;Auxiliadora;Aberta dos Morros;0;0;0;0;0;0
377;0;Auxiliadora;Agronomia;100;0;51;21;0;100
378;0;Auxiliadora;Anchieta;0;0;0;0;0;0
379;0;Auxiliadora;Arquipélago;200;100;58;12;100;100
380;0;Auxiliadora;Auxiliadora;6410;800;1629;727;4000;2410
381;0;Auxiliadora;Azenha;151;0;61;25;50;101
382;0;Auxiliadora;Bela Vista;910;300;298;142;400;510
383;0;Auxiliadora;Belém Novo;50;0;26;9;0;50
384;0;Auxiliadora;Belém Velho;14;0;7;3;0;14
385;0;Auxiliadora;Boa Vista;557;100;271;106;100;457
386;0;Auxiliadora;Boa Vista do Sul;100;50;0;0;100;0
387;0;Auxiliadora;Bom Fim;450;50;174;68;250;200
388;0;Auxiliadora;Bom Jesus;119;0;77;27;0;119
389;0;Auxiliadora;Camaquã;10;0;6;1;0;10
390;0;Auxiliadora;Campo Novo;0;0;0;0;0;0
391;0;Auxiliadora;Cascata;100;50;27;7;50;50
392;0;Auxiliadora;Cavalhada;190;50;87;40;50;140
393;0;Auxiliadora;Cel. Aparício Borges;135;0;93;21;50;85
394;0;Auxiliadora;Centro Histórico;563;50;86;31;400;163
395;0;Auxiliadora;Chapéu do Sol;50;50;0;0;50;0
396;0;Auxiliadora;Chácara das Pedras;200;0;105;68;0;200
397;0;Auxiliadora;Cidade Baixa;160;0;68;26;50;110
398;0;Auxiliadora;Costa e Silva;119;50;40;18;50;69
399;0;Auxiliadora;Cristal;88;0;47;20;0;88
400;0;Auxiliadora;Cristo Redentor;322;0;161;56;50;272
401;0;Auxiliadora;Espírito Santo;100;50;0;0;100;0
402;0;Auxiliadora;Extrema;0;0;0;0;0;0
403;0;Auxiliadora;Farrapos;4717;1294;2043;1060;1197;1224
404;0;Auxiliadora;Farroupilha;50;0;33;11;0;50
405;0;Auxiliadora;Floresta;600;100;218;103;200;400
406;0;Auxiliadora;Glória;106;0;66;27;0;106
407;0;Auxiliadora;Guarujá;0;0;0;0;0;0
408;0;Auxiliadora;Higienópolis;1059;150;441;195;300;759
409;0;Auxiliadora;Humaitá;100;50;27;5;50;50
410;0;Auxiliadora;Hípica;0;0;0;0;0;0
411;0;Auxiliadora;Independência;0;0;0;0;0;0
412;0;Auxiliadora;Ipanema;12;0;8;3;0;12
413;0;Auxiliadora;Jardim Botânico;113;50;33;12;50;63
414;0;Auxiliadora;Jardim Carvalho;161;0;7;1;150;11
415;0;Auxiliadora;Jardim Europa;50;0;23;12;0;50
416;0;Auxiliadora;Jardim Floresta;100;0;58;28;0;100
417;0;Auxiliadora;Jardim Isabel;50;0;29;9;0;50
418;0;Auxiliadora;Jardim Itú;154;0;59;25;50;104
419;0;Auxiliadora;Jardim Leopoldina;62;50;10;2;50;12
420;0;Auxiliadora;Jardim Lindóia;100;0;58;24;0;100
421;0;Auxiliadora;Jardim Sabará;50;0;28;10;0;50
422;0;Auxiliadora;Jardim São Pedro;100;0;51;27;0;100
423;0;Auxiliadora;Jardim do Salso;100;50;25;17;50;50
424;0;Auxiliadora;Lageado;0;0;0;0;0;0
425;0;Auxiliadora;Lami;0;0;0;0;0;0
426;0;Auxiliadora;Lomba do Pinheiro;10;0;3;4;0;10
427;0;Auxiliadora;Medianeira;150;0;23;12;100;50
428;0;Auxiliadora;Menino Deus;687;100;191;94;400;287
429;0;Auxiliadora;Moinhos de Vento;950;350;202;89;650;300
430;0;Auxiliadora;Mont'Serrat;3007;150;1572;754;300;2707
431;0;Auxiliadora;Morro Santana;122;0;15;4;100;22
432;0;Auxiliadora;Mário Quintana;263;50;95;14;100;163
433;0;Auxiliadora;Navegantes;100;0;26;16;50;50
434;0;Auxiliadora;Nonoai;210;0;96;28;50;160
435;0;Auxiliadora;Parque Santa Fé;0;0;0;0;0;0
436;0;Auxiliadora;Partenon;268;50;97;51;100;168
437;0;Auxiliadora;Passo D'Areia;574;50;164;133;200;374
438;0;Auxiliadora;Passo das Pedras;117;0;68;24;0;117
439;0;Auxiliadora;Pedra Redonda;50;0;21;17;0;50
440;0;Auxiliadora;Petrópolis;784;150;349;143;150;634
441;0;Auxiliadora;Pitinga;0;0;0;0;0;0
442;0;Auxiliadora;Ponta Grossa;0;0;0;0;0;0
443;0;Auxiliadora;Praia de Belas;0;0;0;0;0;0
444;0;Auxiliadora;Restinga;138;50;53;8;50;88
445;0;Auxiliadora;Rio Branco;562;50;169;85;250;312
446;0;Auxiliadora;Rubem Berta;159;0;68;71;0;159
447;0;Auxiliadora;Santa Cecília;150;0;49;30;50;100
448;0;Auxiliadora;Santa Maria Goretti;50;0;34;4;0;50
449;0;Auxiliadora;Santa Rosa de Lima;207;0;88;26;50;157
450;0;Auxiliadora;Santa Tereza;231;0;137;33;0;231
451;0;Auxiliadora;Santana;465;50;146;80;200;265
452;0;Auxiliadora;Santo Antônio;159;0;64;33;50;109
453;0;Auxiliadora;Sarandi;167;50;33;19;100;67
454;0;Auxiliadora;Serraria;0;0;0;0;0;0
455;0;Auxiliadora;São Caetano;0;0;0;0;0;0
456;0;Auxiliadora;São Geraldo;450;50;162;63;250;200
457;0;Auxiliadora;São José;11;0;7;2;0;11
458;0;Auxiliadora;São João;700;100;336;173;100;600
459;0;Auxiliadora;São Sebastião;50;0;0;0;50;0
460;0;Auxiliadora;Sétimo Céu;50;0;26;9;0;50
461;0;Auxiliadora;Teresópolis;0;0;0;0;0;0
462;0;Auxiliadora;Tristeza;69;0;35;18;0;69
463;0;Auxiliadora;Três Figueiras;350;50;156;81;50;300
464;0;Auxiliadora;Vila Assunção;0;0;0;0;0;0
465;0;Auxiliadora;Vila Conceição;0;0;0;0;0;0
466;0;Auxiliadora;Vila Ipiranga;109;50;5;1;100;9
467;0;Auxiliadora;Vila Jardim;260;0;127;54;50;210
468;0;Auxiliadora;Vila João Pessoa;152;50;53;20;50;102
469;0;Auxiliadora;Vila Nova;152;0;81;41;0;152
470;0;Azenha;Aberta dos Morros;0;0;0;0;0;0
471;0;Azenha;Agronomia;100;0;52;19;0;100
472;0;Azenha;Anchieta;50;0;26;10;0;50
473;0;Azenha;Arquipélago;319;100;82;44;150;169
474;0;Azenha;Auxiliadora;154;0;63;25;50;104
475;0;Azenha;Azenha;853;200;377;140;200;653
476;0;Azenha;Bela Vista;637;150;195;85;300;337
477;0;Azenha;Belém Novo;25;0;14;7;0;25
478;0;Azenha;Belém Velho;56;50;5;1;50;6
479;0;Azenha;Boa Vista;1;0;1;0;0;1
480;0;Azenha;Boa Vista do Sul;50;0;0;0;50;0
481;0;Azenha;Bom Fim;477;50;163;67;150;327
482;0;Azenha;Bom Jesus;57;0;4;1;50;7
483;0;Azenha;Camaquã;79;0;38;16;0;79
484;0;Azenha;Campo Novo;81;0;70;7;50;31
485;0;Azenha;Cascata;127;0;12;3;100;27
486;0;Azenha;Cavalhada;160;0;57;28;50;110
487;0;Azenha;Cel. Aparício Borges;209;0;87;46;50;159
488;0;Azenha;Centro Histórico;380;150;74;32;250;130
489;0;Azenha;Chapéu do Sol;200;50;26;12;150;50
490;0;Azenha;Chácara das Pedras;50;0;30;10;0;50
491;0;Azenha;Cidade Baixa;1001;150;385;182;250;751
492;0;Azenha;Costa e Silva;106;0;46;41;0;106
493;0;Azenha;Cristal;186;50;75;29;50;136
494;0;Azenha;Cristo Redentor;57;0;31;21;0;57
495;0;Azenha;Espírito Santo;50;0;0;0;50;0
496;0;Azenha;Extrema;0;0;0;0;0;0
497;0;Azenha;Farrapos;4857;0;2727;1143;0;4857
498;0;Azenha;Farroupilha;450;50;193;110;50;400
499;0;Azenha;Floresta;175;0;36;23;100;75
500;0;Azenha;Glória;220;50;56;29;100;120
501;0;Azenha;Guarujá;0;0;0;0;0;0
502;0;Azenha;Higienópolis;148;50;27;9;100;48
503;0;Azenha;Humaitá;50;0;25;15;0;50
504;0;Azenha;Hípica;62;50;8;1;50;12
505;0;Azenha;Independência;250;100;62;23;150;100
506;0;Azenha;Ipanema;256;100;64;28;150;106
507;0;Azenha;Jardim Botânico;257;100;100;30;150;107
508;0;Azenha;Jardim Carvalho;204;100;69;23;100;104
509;0;Azenha;Jardim Europa;100;0;29;10;50;50
510;0;Azenha;Jardim Floresta;0;0;0;0;0;0
511;0;Azenha;Jardim Isabel;0;0;0;0;0;0
512;0;Azenha;Jardim Itú;69;0;54;7;0;69
513;0;Azenha;Jardim Leopoldina;6;0;4;2;0;6
514;0;Azenha;Jardim Lindóia;2;0;1;1;0;2
515;0;Azenha;Jardim Sabará;162;0;37;12;100;62
516;0;Azenha;Jardim São Pedro;100;0;30;10;50;50
517;0;Azenha;Jardim do Salso;0;0;0;0;0;0
518;0;Azenha;Lageado;200;100;48;21;100;100
519;0;Azenha;Lami;0;0;0;0;0;0
520;0;Azenha;Lomba do Pinheiro;6;0;3;1;0;6
521;0;Azenha;Medianeira;1073;100;418;180;400;673
522;0;Azenha;Menino Deus;1140;50;544;232;200;940
523;0;Azenha;Moinhos de Vento;219;0;93;39;50;169
524;0;Azenha;Mont'Serrat;178;0;67;38;50;128
525;0;Azenha;Morro Santana;6;0;2;0;0;6
526;0;Azenha;Mário Quintana;85;0;48;11;0;85
527;0;Azenha;Navegantes;275;0;81;54;100;175
528;0;Azenha;Nonoai;223;0;38;17;150;73
529;0;Azenha;Parque Santa Fé;0;0;0;0;0;0
530;0;Azenha;Partenon;1271;300;280;126;750;521
531;0;Azenha;Passo D'Areia;222;100;38;19;150;72
532;0;Azenha;Passo das Pedras;308;50;66;16;200;108
533;0;Azenha;Pedra Redonda;100;0;52;18;0;100
534;0;Azenha;Petrópolis;614;100;210;113;200;414
535;0;Azenha;Pitinga;50;0;25;12;0;50
536;0;Azenha;Ponta Grossa;50;0;20;13;0;50
537;0;Azenha;Praia de Belas;412;150;114;53;200;212
538;0;Azenha;Restinga;292;50;80;27;150;142
539;0;Azenha;Rio Branco;376;100;103;33;250;126
540;0;Azenha;Rubem Berta;166;0;70;33;50;116
541;0;Azenha;Santa Cecília;468;200;97;42;300;168
542;0;Azenha;Santa Maria Goretti;100;0;42;24;0;100
543;0;Azenha;Santa Rosa de Lima;51;0;26;10;0;51
544;0;Azenha;Santa Tereza;1480;300;483;162;700;780
545;0;Azenha;Santana;807;50;363;161;200;607
546;0;Azenha;Santo Antônio;1542;400;489;164;850;692
547;0;Azenha;Sarandi;317;50;128;55;100;217
548;0;Azenha;Serraria;0;0;0;0;0;0
549;0;Azenha;São Caetano;100;0;55;17;0;100
550;0;Azenha;São Geraldo;0;0;0;0;0;0
551;0;Azenha;São José;68;0;33;16;0;68
552;0;Azenha;São João;325;150;70;34;200;125
553;0;Azenha;São Sebastião;0;0;0;0;0;0
554;0;Azenha;Sétimo Céu;0;0;0;0;0;0
555;0;Azenha;Teresópolis;50;0;22;14;0;50
556;0;Azenha;Tristeza;210;0;85;42;50;160
557;0;Azenha;Três Figueiras;100;0;25;14;50;50
558;0;Azenha;Vila Assunção;50;0;24;10;0;50
559;0;Azenha;Vila Conceição;100;0;25;14;50;50
560;0;Azenha;Vila Ipiranga;252;50;74;14;200;52
561;0;Azenha;Vila Jardim;74;0;39;17;0;74
562;0;Azenha;Vila João Pessoa;202;100;58;23;100;102
563;0;Azenha;Vila Nova;155;0;34;10;100;55
564;0;Bela Vista;Aberta dos Morros;0;0;0;0;0;0
565;0;Bela Vista;Agronomia;100;0;59;26;0;100
566;0;Bela Vista;Anchieta;70;0;47;13;0;70
567;0;Bela Vista;Arquipélago;157;48;38;12;95;62
568;0;Bela Vista;Auxiliadora;624;297;139;54;397;227
569;0;Bela Vista;Azenha;531;144;150;60;276;255
570;0;Bela Vista;Bela Vista;4368;1576;882;324;3084;1284
571;0;Bela Vista;Belém Novo;100;0;0;0;100;0
572;0;Bela Vista;Belém Velho;100;47;37;9;47;53
573;0;Bela Vista;Boa Vista;182;50;81;32;50;132
574;0;Bela Vista;Boa Vista do Sul;50;50;0;0;50;0
575;0;Bela Vista;Bom Fim;493;50;206;53;244;249
576;0;Bela Vista;Bom Jesus;104;95;5;2;95;9
577;0;Bela Vista;Camaquã;51;0;26;13;0;51
578;0;Bela Vista;Campo Novo;50;0;34;11;0;50
579;0;Bela Vista;Cascata;47;47;0;0;47;0
580;0;Bela Vista;Cavalhada;22;0;13;6;0;22
581;0;Bela Vista;Cel. Aparício Borges;133;47;21;8;97;36
582;0;Bela Vista;Centro Histórico;414;0;99;40;229;185
583;0;Bela Vista;Chapéu do Sol;50;50;0;0;50;0
584;0;Bela Vista;Chácara das Pedras;50;0;24;14;0;50
585;0;Bela Vista;Cidade Baixa;417;46;154;36;238;179
586;0;Bela Vista;Costa e Silva;17;0;13;1;0;17
587;0;Bela Vista;Cristal;159;50;47;13;82;77
588;0;Bela Vista;Cristo Redentor;248;0;59;33;132;116
589;0;Bela Vista;Espírito Santo;50;0;27;15;0;50
590;0;Bela Vista;Extrema;50;0;35;13;0;50
591;0;Bela Vista;Farrapos;10669;1872;4924;2192;2154;5720
592;0;Bela Vista;Farroupilha;150;100;0;0;150;0
593;0;Bela Vista;Floresta;537;198;93;37;386;151
594;0;Bela Vista;Glória;127;50;47;23;50;77
595;0;Bela Vista;Guarujá;100;0;18;15;50;50
596;0;Bela Vista;Higienópolis;14;0;8;5;0;14
597;0;Bela Vista;Humaitá;95;50;27;10;50;45
598;0;Bela Vista;Hípica;147;97;29;11;97;50
599;0;Bela Vista;Independência;365;150;85;41;200;165
600;0;Bela Vista;Ipanema;100;47;32;13;47;53
601;0;Bela Vista;Jardim Botânico;301;145;34;12;244;57
602;0;Bela Vista;Jardim Carvalho;127;0;48;13;50;77
603;0;Bela Vista;Jardim Europa;50;0;30;11;0;50
604;0;Bela Vista;Jardim Floresta;100;0;59;20;0;100
605;0;Bela Vista;Jardim Isabel;50;0;30;10;0;50
606;0;Bela Vista;Jardim Itú;103;0;65;24;0;103
607;0;Bela Vista;Jardim Leopoldina;6;0;6;0;0;6
608;0;Bela Vista;Jardim Lindóia;55;0;4;1;50;5
609;0;Bela Vista;Jardim Sabará;120;0;74;30;0;120
610;0;Bela Vista;Jardim São Pedro;147;50;0;0;147;0
611;0;Bela Vista;Jardim do Salso;3;0;2;1;0;3
612;0;Bela Vista;Lageado;0;0;0;0;0;0
613;0;Bela Vista;Lami;0;0;0;0;0;0
614;0;Bela Vista;Lomba do Pinheiro;128;50;48;9;50;78
615;0;Bela Vista;Medianeira;76;0;47;20;0;76
616;0;Bela Vista;Menino Deus;258;145;41;19;191;67
617;0;Bela Vista;Moinhos de Vento;245;100;6;6;231;14
618;0;Bela Vista;Mont'Serrat;1292;97;685;292;147;1145
619;0;Bela Vista;Morro Santana;135;97;23;9;97;38
620;0;Bela Vista;Mário Quintana;231;0;107;31;50;181
621;0;Bela Vista;Navegantes;100;0;60;27;0;100
622;0;Bela Vista;Nonoai;55;0;40;10;0;55
623;0;Bela Vista;Parque Santa Fé;26;0;13;8;0;26
624;0;Bela Vista;Partenon;223;50;77;23;99;124
625;0;Bela Vista;Passo D'Areia;588;189;157;94;336;252
626;0;Bela Vista;Passo das Pedras;54;0;32;9;0;54
627;0;Bela Vista;Pedra Redonda;50;50;0;0;50;0
628;0;Bela Vista;Petrópolis;1704;146;886;332;443;1261
629;0;Bela Vista;Pitinga;0;0;0;0;0;0
630;0;Bela Vista;Ponta Grossa;100;0;0;0;100;0
631;0;Bela Vista;Praia de Belas;150;0;101;30;0;150
632;0;Bela Vista;Restinga;177;50;41;22;100;77
633;0;Bela Vista;Rio Branco;3316;1097;565;244;2367;949
634;0;Bela Vista;Rubem Berta;77;0;44;21;0;77
635;0;Bela Vista;Santa Cecília;1004;50;505;188;199;805
636;0;Bela Vista;Santa Maria Goretti;0;0;0;0;0;0
637;0;Bela Vista;Santa Rosa de Lima;152;0;101;23;0;152
638;0;Bela Vista;Santa Tereza;203;0;125;49;0;203
639;0;Bela Vista;Santana;473;150;102;40;299;174
640;0;Bela Vista;Santo Antônio;260;0;103;40;97;163
641;0;Bela Vista;Sarandi;100;0;51;27;0;100
642;0;Bela Vista;Serraria;0;0;0;0;0;0
643;0;Bela Vista;São Caetano;50;50;0;0;50;0
644;0;Bela Vista;São Geraldo;300;0;142;63;50;250
645;0;Bela Vista;São José;152;50;1;1;150;2
646;0;Bela Vista;São João;199;99;32;13;149;50
647;0;Bela Vista;São Sebastião;50;0;0;0;50;0
648;0;Bela Vista;Sétimo Céu;0;0;0;0;0;0
649;0;Bela Vista;Teresópolis;127;0;0;0;127;0
650;0;Bela Vista;Tristeza;132;47;19;10;97;35
651;0;Bela Vista;Três Figueiras;78;50;13;8;50;28
652;0;Bela Vista;Vila Assunção;0;0;0;0;0;0
653;0;Bela Vista;Vila Conceição;50;0;32;13;0;50
654;0;Bela Vista;Vila Ipiranga;249;100;1;1;247;2
655;0;Bela Vista;Vila Jardim;4;0;2;1;0;4
656;0;Bela Vista;Vila João Pessoa;50;50;0;0;50;0
657;0;Bela Vista;Vila Nova;227;97;71;27;97;130
658;0;Belém Novo;Aberta dos Morros;200;100;29;11;150;50
659;0;Belém Novo;Agronomia;50;0;25;16;0;50
660;0;Belém Novo;Anchieta;0;0;0;0;0;0
661;0;Belém Novo;Arquipélago;52;0;25;16;0;52
662;0;Belém Novo;Auxiliadora;34;0;16;9;0;34
663;0;Belém Novo;Azenha;50;0;24;15;0;50
664;0;Belém Novo;Bela Vista;110;0;5;4;100;10
665;0;Belém Novo;Belém Novo;4633;900;2000;730;1300;3333
666;0;Belém Novo;Belém Velho;109;0;33;15;50;59
667;0;Belém Novo;Boa Vista;8;0;5;3;0;8
668;0;Belém Novo;Boa Vista do Sul;137;0;53;19;50;87
669;0;Belém Novo;Bom Fim;0;0;0;0;0;0
670;0;Belém Novo;Bom Jesus;109;50;32;10;50;59
671;0;Belém Novo;Camaquã;120;0;38;20;50;70
672;0;Belém Novo;Campo Novo;200;50;93;26;50;150
673;0;Belém Novo;Cascata;112;100;8;1;100;12
674;0;Belém Novo;Cavalhada;9;0;4;2;0;9
675;0;Belém Novo;Cel. Aparício Borges;131;0;40;21;50;81
676;0;Belém Novo;Centro Histórico;61;0;5;3;50;11
677;0;Belém Novo;Chapéu do Sol;250;0;166;36;50;200
678;0;Belém Novo;Chácara das Pedras;0;0;0;0;0;0
679;0;Belém Novo;Cidade Baixa;88;0;16;10;50;38
680;0;Belém Novo;Costa e Silva;9;0;8;1;0;9
681;0;Belém Novo;Cristal;35;0;22;7;0;35
682;0;Belém Novo;Cristo Redentor;12;0;7;4;0;12
683;0;Belém Novo;Espírito Santo;120;50;47;12;50;70
684;0;Belém Novo;Extrema;50;50;0;0;50;0
685;0;Belém Novo;Farrapos;3838;0;2241;752;0;3838
686;0;Belém Novo;Farroupilha;50;0;0;0;50;0
687;0;Belém Novo;Floresta;50;50;0;0;50;0
688;0;Belém Novo;Glória;173;0;94;40;0;173
689;0;Belém Novo;Guarujá;150;0;94;33;0;150
690;0;Belém Novo;Higienópolis;59;0;56;2;50;9
691;0;Belém Novo;Humaitá;175;0;40;18;100;75
692;0;Belém Novo;Hípica;1548;450;530;178;650;898
693;0;Belém Novo;Independência;2;0;2;0;0;2
694;0;Belém Novo;Ipanema;120;0;44;11;50;70
695;0;Belém Novo;Jardim Botânico;62;0;5;2;50;12
696;0;Belém Novo;Jardim Carvalho;136;50;52;22;50;86
697;0;Belém Novo;Jardim Europa;0;0;0;0;0;0
698;0;Belém Novo;Jardim Floresta;0;0;0;0;0;0
699;0;Belém Novo;Jardim Isabel;0;0;0;0;0;0
700;0;Belém Novo;Jardim Itú;9;0;5;3;0;9
701;0;Belém Novo;Jardim Leopoldina;109;50;4;3;100;9
702;0;Belém Novo;Jardim Lindóia;50;50;0;0;50;0
703;0;Belém Novo;Jardim Sabará;50;0;0;0;50;0
704;0;Belém Novo;Jardim São Pedro;0;0;0;0;0;0
705;0;Belém Novo;Jardim do Salso;50;0;35;9;0;50
706;0;Belém Novo;Lageado;375;50;187;69;50;325
707;0;Belém Novo;Lami;0;0;0;0;0;0
708;0;Belém Novo;Lomba do Pinheiro;110;50;37;10;50;60
709;0;Belém Novo;Medianeira;50;0;30;7;0;50
710;0;Belém Novo;Menino Deus;106;0;33;18;50;56
711;0;Belém Novo;Moinhos de Vento;0;0;0;0;0;0
712;0;Belém Novo;Mont'Serrat;70;0;60;6;50;20
713;0;Belém Novo;Morro Santana;111;50;7;2;100;11
714;0;Belém Novo;Mário Quintana;25;0;13;2;0;25
715;0;Belém Novo;Navegantes;0;0;0;0;0;0
716;0;Belém Novo;Nonoai;111;50;42;12;50;61
717;0;Belém Novo;Parque Santa Fé;100;0;49;32;0;100
718;0;Belém Novo;Partenon;186;0;87;29;50;136
719;0;Belém Novo;Passo D'Areia;138;100;12;11;100;38
720;0;Belém Novo;Passo das Pedras;136;0;48;20;50;86
721;0;Belém Novo;Pedra Redonda;150;0;57;20;50;100
722;0;Belém Novo;Petrópolis;156;0;91;42;0;156
723;0;Belém Novo;Pitinga;52;0;37;4;0;52
724;0;Belém Novo;Ponta Grossa;474;50;264;67;50;424
725;0;Belém Novo;Praia de Belas;0;0;0;0;0;0
726;0;Belém Novo;Restinga;247;100;47;19;150;97
727;0;Belém Novo;Rio Branco;8;0;5;2;0;8
728;0;Belém Novo;Rubem Berta;78;0;44;20;0;78
729;0;Belém Novo;Santa Cecília;50;0;0;0;50;0
730;0;Belém Novo;Santa Maria Goretti;100;50;33;8;50;50
731;0;Belém Novo;Santa Rosa de Lima;82;0;15;4;50;32
732;0;Belém Novo;Santa Tereza;118;0;36;14;50;68
733;0;Belém Novo;Santana;8;0;6;0;0;8
734;0;Belém Novo;Santo Antônio;7;0;2;4;0;7
735;0;Belém Novo;Sarandi;91;50;25;5;50;41
736;0;Belém Novo;Serraria;202;50;63;17;100;102
737;0;Belém Novo;São Caetano;200;50;26;13;150;50
738;0;Belém Novo;São Geraldo;75;0;31;22;0;75
739;0;Belém Novo;São José;59;50;4;1;50;9
740;0;Belém Novo;São João;0;0;0;0;0;0
741;0;Belém Novo;São Sebastião;50;0;35;7;0;50
742;0;Belém Novo;Sétimo Céu;100;0;24;10;50;50
743;0;Belém Novo;Teresópolis;0;0;0;0;0;0
744;0;Belém Novo;Tristeza;108;50;5;3;100;8
745;0;Belém Novo;Três Figueiras;12;0;5;3;0;12
746;0;Belém Novo;Vila Assunção;50;0;0;0;50;0
747;0;Belém Novo;Vila Conceição;100;0;51;24;0;100
748;0;Belém Novo;Vila Ipiranga;34;0;23;7;0;34
749;0;Belém Novo;Vila Jardim;12;0;7;4;0;12
750;0;Belém Novo;Vila João Pessoa;127;0;51;10;50;77
751;0;Belém Novo;Vila Nova;110;50;8;2;100;10
752;0;Belém Velho;Aberta dos Morros;400;150;87;23;250;150
753;0;Belém Velho;Agronomia;125;50;39;12;50;75
754;0;Belém Velho;Anchieta;150;50;61;14;50;100
755;0;Belém Velho;Arquipélago;200;50;92;27;50;150
756;0;Belém Velho;Auxiliadora;2;0;2;0;0;2
757;0;Belém Velho;Azenha;50;50;0;0;50;0
758;0;Belém Velho;Bela Vista;80;50;23;4;50;30
759;0;Belém Velho;Belém Novo;62;0;7;3;50;12
760;0;Belém Velho;Belém Velho;5009;1800;853;215;3800;1209
761;0;Belém Velho;Boa Vista;52;0;0;0;50;2
762;0;Belém Velho;Boa Vista do Sul;50;0;0;0;50;0
763;0;Belém Velho;Bom Fim;0;0;0;0;0;0
764;0;Belém Velho;Bom Jesus;189;50;89;18;50;139
765;0;Belém Velho;Camaquã;128;0;47;10;50;78
766;0;Belém Velho;Campo Novo;1562;700;315;91;1037;525
767;0;Belém Velho;Cascata;894;150;455;111;200;694
768;0;Belém Velho;Cavalhada;136;50;21;12;100;36
769;0;Belém Velho;Cel. Aparício Borges;272;50;114;15;100;172
770;0;Belém Velho;Centro Histórico;56;0;2;2;50;6
771;0;Belém Velho;Chapéu do Sol;75;0;16;3;50;25
772;0;Belém Velho;Chácara das Pedras;0;0;0;0;0;0
773;0;Belém Velho;Cidade Baixa;53;0;41;8;0;53
774;0;Belém Velho;Costa e Silva;93;50;31;4;50;43
775;0;Belém Velho;Cristal;127;0;82;28;0;127
776;0;Belém Velho;Cristo Redentor;33;0;22;11;0;33
777;0;Belém Velho;Espírito Santo;150;0;0;0;150;0
778;0;Belém Velho;Extrema;100;50;26;10;50;50
779;0;Belém Velho;Farrapos;12550;3301;5710;1746;1023;8958
780;0;Belém Velho;Farroupilha;0;0;0;0;0;0
781;0;Belém Velho;Floresta;0;0;0;0;0;0
782;0;Belém Velho;Glória;103;0;56;22;0;103
783;0;Belém Velho;Guarujá;100;50;31;7;50;50
784;0;Belém Velho;Higienópolis;48;0;30;10;0;48
785;0;Belém Velho;Humaitá;44;0;32;5;0;44
786;0;Belém Velho;Hípica;277;0;42;19;200;77
787;0;Belém Velho;Independência;25;0;10;7;0;25
788;0;Belém Velho;Ipanema;229;50;82;26;100;129
789;0;Belém Velho;Jardim Botânico;84;0;22;7;50;34
790;0;Belém Velho;Jardim Carvalho;2;0;0;1;0;2
791;0;Belém Velho;Jardim Europa;0;0;0;0;0;0
792;0;Belém Velho;Jardim Floresta;75;50;15;2;50;25
793;0;Belém Velho;Jardim Isabel;150;50;0;0;150;0
794;0;Belém Velho;Jardim Itú;0;0;0;0;0;0
795;0;Belém Velho;Jardim Leopoldina;83;50;19;7;50;33
796;0;Belém Velho;Jardim Lindóia;19;0;10;6;0;19
797;0;Belém Velho;Jardim Sabará;100;0;50;0;100;0
798;0;Belém Velho;Jardim São Pedro;100;50;0;0;100;0
799;0;Belém Velho;Jardim do Salso;0;0;0;0;0;0
800;0;Belém Velho;Lageado;50;0;37;10;0;50
801;0;Belém Velho;Lami;50;0;33;10;0;50
802;0;Belém Velho;Lomba do Pinheiro;835;300;289;53;450;385
803;0;Belém Velho;Medianeira;50;0;33;6;0;50
804;0;Belém Velho;Menino Deus;95;0;54;27;0;95
805;0;Belém Velho;Moinhos de Vento;13;0;5;7;0;13
806;0;Belém Velho;Mont'Serrat;2;0;1;0;0;2
807;0;Belém Velho;Morro Santana;119;0;46;14;50;69
808;0;Belém Velho;Mário Quintana;145;0;87;22;0;145
809;0;Belém Velho;Navegantes;0;0;0;0;0;0
810;0;Belém Velho;Nonoai;87;0;55;11;0;87
811;0;Belém Velho;Parque Santa Fé;50;0;29;13;0;50
812;0;Belém Velho;Partenon;127;0;43;18;50;77
813;0;Belém Velho;Passo D'Areia;92;0;46;24;0;92
814;0;Belém Velho;Passo das Pedras;64;50;9;3;50;14
815;0;Belém Velho;Pedra Redonda;50;0;24;9;0;50
816;0;Belém Velho;Petrópolis;323;100;120;22;200;123
817;0;Belém Velho;Pitinga;119;0;47;4;50;69
818;0;Belém Velho;Ponta Grossa;50;0;33;10;0;50
819;0;Belém Velho;Praia de Belas;0;0;0;0;0;0
820;0;Belém Velho;Restinga;726;250;192;54;400;326
821;0;Belém Velho;Rio Branco;8;0;6;1;0;8
822;0;Belém Velho;Rubem Berta;152;0;87;27;0;152
823;0;Belém Velho;Santa Cecília;50;0;22;10;0;50
824;0;Belém Velho;Santa Maria Goretti;19;0;17;0;0;19
825;0;Belém Velho;Santa Rosa de Lima;100;50;31;4;50;50
826;0;Belém Velho;Santa Tereza;147;0;91;30;0;147
827;0;Belém Velho;Santana;59;0;29;12;0;59
828;0;Belém Velho;Santo Antônio;71;0;11;7;50;21
829;0;Belém Velho;Sarandi;86;0;49;12;0;86
830;0;Belém Velho;Serraria;21;0;16;4;0;21
831;0;Belém Velho;São Caetano;0;0;0;0;0;0
832;0;Belém Velho;São Geraldo;50;0;30;7;0;50
833;0;Belém Velho;São José;528;200;75;28;400;128
834;0;Belém Velho;São João;50;0;0;0;50;0
835;0;Belém Velho;São Sebastião;19;0;8;5;0;19
836;0;Belém Velho;Sétimo Céu;100;0;35;8;50;50
837;0;Belém Velho;Teresópolis;600;150;148;25;450;150
838;0;Belém Velho;Tristeza;114;100;7;7;100;14
839;0;Belém Velho;Três Figueiras;50;0;30;6;0;50
840;0;Belém Velho;Vila Assunção;50;0;0;0;50;0
841;0;Belém Velho;Vila Conceição;0;0;0;0;0;0
842;0;Belém Velho;Vila Ipiranga;189;100;18;13;150;39
843;0;Belém Velho;Vila Jardim;56;0;4;2;50;6
844;0;Belém Velho;Vila João Pessoa;203;0;135;42;0;203
845;0;Belém Velho;Vila Nova;2823;700;791;310;1332;1491
846;0;Boa Vista;Aberta dos Morros;50;0;0;0;50;0
847;0;Boa Vista;Agronomia;0;0;0;0;0;0
848;0;Boa Vista;Anchieta;75;0;13;6;50;25
849;0;Boa Vista;Arquipélago;50;0;31;9;0;50
850;0;Boa Vista;Auxiliadora;471;100;220;81;100;371
851;0;Boa Vista;Azenha;0;0;0;0;0;0
852;0;Boa Vista;Bela Vista;231;50;113;43;50;181
853;0;Boa Vista;Belém Novo;0;0;0;0;0;0
854;0;Boa Vista;Belém Velho;58;0;7;1;50;8
855;0;Boa Vista;Boa Vista;1455;200;708;268;200;1255
856;0;Boa Vista;Boa Vista do Sul;150;50;29;9;100;50
857;0;Boa Vista;Bom Fim;151;0;68;15;50;101
858;0;Boa Vista;Bom Jesus;166;50;49;9;100;66
859;0;Boa Vista;Camaquã;17;0;12;3;0;17
860;0;Boa Vista;Campo Novo;0;0;0;0;0;0
861;0;Boa Vista;Cascata;50;0;30;11;0;50
862;0;Boa Vista;Cavalhada;64;0;32;15;0;64
863;0;Boa Vista;Cel. Aparício Borges;23;0;14;2;0;23
864;0;Boa Vista;Centro Histórico;183;0;67;29;50;133
865;0;Boa Vista;Chapéu do Sol;0;0;0;0;0;0
866;0;Boa Vista;Chácara das Pedras;175;50;46;16;100;75
867;0;Boa Vista;Cidade Baixa;79;0;43;18;0;79
868;0;Boa Vista;Costa e Silva;133;50;48;13;50;83
869;0;Boa Vista;Cristal;82;0;16;6;50;32
870;0;Boa Vista;Cristo Redentor;317;100;34;15;250;67
871;0;Boa Vista;Espírito Santo;150;0;108;24;50;100
872;0;Boa Vista;Extrema;50;0;0;0;50;0
873;0;Boa Vista;Farrapos;4694;0;2550;1206;0;4694
874;0;Boa Vista;Farroupilha;101;0;35;12;50;51
875;0;Boa Vista;Floresta;50;0;25;16;0;50
876;0;Boa Vista;Glória;205;50;94;30;50;155
877;0;Boa Vista;Guarujá;0;0;0;0;0;0
878;0;Boa Vista;Higienópolis;1729;150;895;356;250;1479
879;0;Boa Vista;Humaitá;100;0;23;14;50;50
880;0;Boa Vista;Hípica;0;0;0;0;0;0
881;0;Boa Vista;Independência;51;0;26;9;0;51
882;0;Boa Vista;Ipanema;8;0;7;1;0;8
883;0;Boa Vista;Jardim Botânico;113;0;63;30;0;113
884;0;Boa Vista;Jardim Carvalho;158;100;35;10;100;58
885;0;Boa Vista;Jardim Europa;244;0;125;30;119;125
886;0;Boa Vista;Jardim Floresta;175;50;70;31;50;125
887;0;Boa Vista;Jardim Isabel;50;0;30;10;0;50
888;0;Boa Vista;Jardim Itú;120;0;39;15;50;70
889;0;Boa Vista;Jardim Leopoldina;60;0;8;0;50;10
890;0;Boa Vista;Jardim Lindóia;119;50;11;6;100;19
891;0;Boa Vista;Jardim Sabará;100;50;34;7;50;50
892;0;Boa Vista;Jardim São Pedro;351;0;115;42;150;201
893;0;Boa Vista;Jardim do Salso;0;0;0;0;0;0
894;0;Boa Vista;Lageado;150;150;0;0;150;0
895;0;Boa Vista;Lami;100;0;31;9;50;50
896;0;Boa Vista;Lomba do Pinheiro;223;100;64;3;200;23
897;0;Boa Vista;Medianeira;50;50;0;0;50;0
898;0;Boa Vista;Menino Deus;300;50;145;61;50;250
899;0;Boa Vista;Moinhos de Vento;285;100;75;33;150;135
900;0;Boa Vista;Mont'Serrat;415;0;243;99;0;415
901;0;Boa Vista;Morro Santana;29;0;15;6;0;29
902;0;Boa Vista;Mário Quintana;161;0;76;7;50;111
903;0;Boa Vista;Navegantes;50;0;30;11;0;50
904;0;Boa Vista;Nonoai;54;50;3;0;50;4
905;0;Boa Vista;Parque Santa Fé;150;100;0;0;150;0
906;0;Boa Vista;Partenon;66;50;11;2;50;16
907;0;Boa Vista;Passo D'Areia;2066;250;889;433;400;1666
908;0;Boa Vista;Passo das Pedras;84;50;21;5;50;34
909;0;Boa Vista;Pedra Redonda;50;0;30;12;0;50
910;0;Boa Vista;Petrópolis;427;50;165;45;250;177
911;0;Boa Vista;Pitinga;51;0;40;6;0;51
912;0;Boa Vista;Ponta Grossa;50;0;25;19;0;50
913;0;Boa Vista;Praia de Belas;0;0;0;0;0;0
914;0;Boa Vista;Restinga;27;0;15;8;0;27
915;0;Boa Vista;Rio Branco;195;50;28;9;150;45
916;0;Boa Vista;Rubem Berta;23;0;9;7;0;23
917;0;Boa Vista;Santa Cecília;50;0;35;5;0;50
918;0;Boa Vista;Santa Maria Goretti;543;100;183;66;250;293
919;0;Boa Vista;Santa Rosa de Lima;273;150;81;12;150;123
920;0;Boa Vista;Santa Tereza;116;0;72;19;0;116
921;0;Boa Vista;Santana;95;0;23;16;50;45
922;0;Boa Vista;Santo Antônio;5;0;2;2;0;5
923;0;Boa Vista;Sarandi;179;50;73;44;50;129
924;0;Boa Vista;Serraria;50;50;0;0;50;0
925;0;Boa Vista;São Caetano;0;0;0;0;0;0
926;0;Boa Vista;São Geraldo;50;0;28;12;0;50
927;0;Boa Vista;São José;162;0;94;44;0;162
928;0;Boa Vista;São João;347;0;162;79;50;297
929;0;Boa Vista;São Sebastião;225;100;38;21;150;75
930;0;Boa Vista;Sétimo Céu;0;0;0;0;0;0
931;0;Boa Vista;Teresópolis;50;0;0;0;50;0
932;0;Boa Vista;Tristeza;62;0;29;21;0;62
933;0;Boa Vista;Três Figueiras;819;250;262;75;450;369
934;0;Boa Vista;Vila Assunção;0;0;0;0;0;0
935;0;Boa Vista;Vila Conceição;0;0;0;0;0;0
936;0;Boa Vista;Vila Ipiranga;491;150;100;30;342;149
937;0;Boa Vista;Vila Jardim;228;150;47;18;150;78
938;0;Boa Vista;Vila João Pessoa;105;0;37;11;50;55
939;0;Boa Vista;Vila Nova;40;0;20;10;0;40
940;0;Boa Vista do Sul;Aberta dos Morros;100;0;35;8;50;50
941;0;Boa Vista do Sul;Agronomia;0;0;0;0;0;0
942;0;Boa Vista do Sul;Anchieta;50;50;0;0;50;0
943;0;Boa Vista do Sul;Arquipélago;50;0;0;0;50;0
944;0;Boa Vista do Sul;Auxiliadora;99;50;1;0;97;2
945;0;Boa Vista do Sul;Azenha;23;0;0;0;23;0
946;0;Boa Vista do Sul;Bela Vista;53;50;3;0;50;3
947;0;Boa Vista do Sul;Belém Novo;200;0;93;30;50;150
948;0;Boa Vista do Sul;Belém Velho;57;0;3;1;50;7
949;0;Boa Vista do Sul;Boa Vista;145;49;30;9;94;51
950;0;Boa Vista do Sul;Boa Vista do Sul;497;97;228;64;97;400
951;0;Boa Vista do Sul;Bom Fim;50;0;24;16;0;50
952;0;Boa Vista do Sul;Bom Jesus;160;50;58;13;50;110
953;0;Boa Vista do Sul;Camaquã;3;0;1;1;0;3
954;0;Boa Vista do Sul;Campo Novo;50;0;25;9;0;50
955;0;Boa Vista do Sul;Cascata;47;0;0;0;47;0
956;0;Boa Vista do Sul;Cavalhada;22;0;16;3;0;22
957;0;Boa Vista do Sul;Cel. Aparício Borges;63;0;31;7;0;63
958;0;Boa Vista do Sul;Centro Histórico;106;0;77;10;50;56
959;0;Boa Vista do Sul;Chapéu do Sol;50;0;25;11;0;50
960;0;Boa Vista do Sul;Chácara das Pedras;0;0;0;0;0;0
961;0;Boa Vista do Sul;Cidade Baixa;152;50;48;13;50;102
962;0;Boa Vista do Sul;Costa e Silva;8;0;5;0;0;8
963;0;Boa Vista do Sul;Cristal;212;98;10;1;193;19
964;0;Boa Vista do Sul;Cristo Redentor;9;0;7;2;0;9
965;0;Boa Vista do Sul;Espírito Santo;47;47;0;0;47;0
966;0;Boa Vista do Sul;Extrema;50;0;26;9;0;50
967;0;Boa Vista do Sul;Farrapos;249;24;34;7;199;50
968;0;Boa Vista do Sul;Farroupilha;0;0;0;0;0;0
969;0;Boa Vista do Sul;Floresta;100;0;26;16;50;50
970;0;Boa Vista do Sul;Glória;101;0;58;15;0;101
971;0;Boa Vista do Sul;Guarujá;50;50;0;0;50;0
972;0;Boa Vista do Sul;Higienópolis;50;0;0;0;50;0
973;0;Boa Vista do Sul;Humaitá;50;0;32;10;0;50
974;0;Boa Vista do Sul;Hípica;101;0;65;9;0;101
975;0;Boa Vista do Sul;Independência;0;0;0;0;0;0
976;0;Boa Vista do Sul;Ipanema;7;0;5;2;0;7
977;0;Boa Vista do Sul;Jardim Botânico;8;0;7;1;0;8
978;0;Boa Vista do Sul;Jardim Carvalho;51;0;36;5;0;51
979;0;Boa Vista do Sul;Jardim Europa;0;0;0;0;0;0
980;0;Boa Vista do Sul;Jardim Floresta;0;0;0;0;0;0
981;0;Boa Vista do Sul;Jardim Isabel;0;0;0;0;0;0
982;0;Boa Vista do Sul;Jardim Itú;97;97;0;0;97;0
983;0;Boa Vista do Sul;Jardim Leopoldina;78;50;5;0;73;5
984;0;Boa Vista do Sul;Jardim Lindóia;0;0;0;0;0;0
985;0;Boa Vista do Sul;Jardim Sabará;50;0;0;0;50;0
986;0;Boa Vista do Sul;Jardim São Pedro;0;0;0;0;0;0
987;0;Boa Vista do Sul;Jardim do Salso;0;0;0;0;0;0
988;0;Boa Vista do Sul;Lageado;100;0;53;17;0;100
989;0;Boa Vista do Sul;Lami;100;50;32;6;50;50
990;0;Boa Vista do Sul;Lomba do Pinheiro;355;0;216;44;0;355
991;0;Boa Vista do Sul;Medianeira;50;0;27;12;0;50
992;0;Boa Vista do Sul;Menino Deus;65;50;6;6;50;15
993;0;Boa Vista do Sul;Moinhos de Vento;0;0;0;0;0;0
994;0;Boa Vista do Sul;Mont'Serrat;0;0;0;0;0;0
995;0;Boa Vista do Sul;Morro Santana;110;0;60;20;0;110
996;0;Boa Vista do Sul;Mário Quintana;120;0;64;14;0;120
997;0;Boa Vista do Sul;Navegantes;0;0;0;0;0;0
998;0;Boa Vista do Sul;Nonoai;52;0;29;5;0;52
999;0;Boa Vista do Sul;Parque Santa Fé;0;0;0;0;0;0
1000;0;Boa Vista do Sul;Partenon;58;0;37;13;0;58
1001;0;Boa Vista do Sul;Passo D'Areia;163;0;56;63;0;163
1002;0;Boa Vista do Sul;Passo das Pedras;9;0;8;0;0;9
1003;0;Boa Vista do Sul;Pedra Redonda;0;0;0;0;0;0
1004;0;Boa Vista do Sul;Petrópolis;67;0;8;6;50;17
1005;0;Boa Vista do Sul;Pitinga;50;0;29;13;0;50
1006;0;Boa Vista do Sul;Ponta Grossa;50;0;31;7;0;50
1007;0;Boa Vista do Sul;Praia de Belas;0;0;0;0;0;0
1008;0;Boa Vista do Sul;Restinga;122;0;64;23;0;122
1009;0;Boa Vista do Sul;Rio Branco;150;94;34;15;94;56
1010;0;Boa Vista do Sul;Rubem Berta;3;0;2;1;0;3
1011;0;Boa Vista do Sul;Santa Cecília;47;47;0;0;47;0
1012;0;Boa Vista do Sul;Santa Maria Goretti;50;0;32;4;0;50
1013;0;Boa Vista do Sul;Santa Rosa de Lima;50;50;0;0;50;0
1014;0;Boa Vista do Sul;Santa Tereza;308;97;86;39;147;161
1015;0;Boa Vista do Sul;Santana;155;50;30;12;97;58
1016;0;Boa Vista do Sul;Santo Antônio;0;0;0;0;0;0
1017;0;Boa Vista do Sul;Sarandi;419;0;178;78;98;321
1018;0;Boa Vista do Sul;Serraria;50;50;0;0;50;0
1019;0;Boa Vista do Sul;São Caetano;150;0;90;26;0;150
1020;0;Boa Vista do Sul;São Geraldo;50;0;27;13;0;50
1021;0;Boa Vista do Sul;São José;55;0;26;7;0;55
1022;0;Boa Vista do Sul;São João;50;0;31;13;0;50
1023;0;Boa Vista do Sul;São Sebastião;0;0;0;0;0;0
1024;0;Boa Vista do Sul;Sétimo Céu;0;0;0;0;0;0
1025;0;Boa Vista do Sul;Teresópolis;100;0;51;28;0;100
1026;0;Boa Vista do Sul;Tristeza;10;0;4;3;0;10
1027;0;Boa Vista do Sul;Três Figueiras;50;0;21;13;0;50
1028;0;Boa Vista do Sul;Vila Assunção;50;0;31;7;0;50
1029;0;Boa Vista do Sul;Vila Conceição;50;0;28;9;0;50
1030;0;Boa Vista do Sul;Vila Ipiranga;151;0;81;40;0;151
1031;0;Boa Vista do Sul;Vila Jardim;6;0;1;5;0;6
1032;0;Boa Vista do Sul;Vila João Pessoa;50;0;27;10;0;50
1033;0;Boa Vista do Sul;Vila Nova;23;0;15;4;0;23
1034;0;Bom Fim;Aberta dos Morros;0;0;0;0;0;0
1035;0;Bom Fim;Agronomia;50;50;0;0;50;0
1036;0;Bom Fim;Anchieta;0;0;0;0;0;0
1037;0;Bom Fim;Arquipélago;350;100;111;19;150;200
1038;0;Bom Fim;Auxiliadora;452;50;175;69;250;202
1039;0;Bom Fim;Azenha;550;50;203;90;150;400
1040;0;Bom Fim;Bela Vista;602;50;266;70;250;352
1041;0;Bom Fim;Belém Novo;0;0;0;0;0;0
1042;0;Bom Fim;Belém Velho;4;0;4;0;0;4
1043;0;Bom Fim;Boa Vista;203;0;95;31;50;153
1044;0;Bom Fim;Boa Vista do Sul;50;0;24;16;0;50
1045;0;Bom Fim;Bom Fim;3800;400;892;462;2100;1700
1046;0;Bom Fim;Bom Jesus;155;0;60;27;50;105
1047;0;Bom Fim;Camaquã;252;0;121;45;50;202
1048;0;Bom Fim;Campo Novo;0;0;0;0;0;0
1049;0;Bom Fim;Cascata;150;0;64;36;0;150
1050;0;Bom Fim;Cavalhada;105;50;27;21;50;55
1051;0;Bom Fim;Cel. Aparício Borges;107;0;38;14;50;57
1052;0;Bom Fim;Centro Histórico;2105;300;580;288;1050;1055
1053;0;Bom Fim;Chapéu do Sol;100;50;37;11;50;50
1054;0;Bom Fim;Chácara das Pedras;150;0;54;30;50;100
1055;0;Bom Fim;Cidade Baixa;1702;50;743;350;200;1502
1056;0;Bom Fim;Costa e Silva;55;0;36;7;0;55
1057;0;Bom Fim;Cristal;256;100;82;37;100;156
1058;0;Bom Fim;Cristo Redentor;6;0;4;0;0;6
1059;0;Bom Fim;Espírito Santo;100;0;18;17;50;50
1060;0;Bom Fim;Extrema;0;0;0;0;0;0
1061;0;Bom Fim;Farrapos;350;50;173;53;50;300
1062;0;Bom Fim;Farroupilha;1100;100;443;290;150;950
1063;0;Bom Fim;Floresta;500;250;71;44;350;150
1064;0;Bom Fim;Glória;53;0;23;13;0;53
1065;0;Bom Fim;Guarujá;150;0;76;43;0;150
1066;0;Bom Fim;Higienópolis;102;50;21;16;50;52
1067;0;Bom Fim;Humaitá;50;0;40;7;0;50
1068;0;Bom Fim;Hípica;100;0;0;0;100;0
1069;0;Bom Fim;Independência;3450;450;726;473;1850;1600
1070;0;Bom Fim;Ipanema;103;0;52;25;0;103
1071;0;Bom Fim;Jardim Botânico;105;0;50;34;0;105
1072;0;Bom Fim;Jardim Carvalho;152;0;81;56;0;152
1073;0;Bom Fim;Jardim Europa;50;50;0;0;50;0
1074;0;Bom Fim;Jardim Floresta;0;0;0;0;0;0
1075;0;Bom Fim;Jardim Isabel;0;0;0;0;0;0
1076;0;Bom Fim;Jardim Itú;302;50;151;65;50;252
1077;0;Bom Fim;Jardim Leopoldina;55;0;29;11;0;55
1078;0;Bom Fim;Jardim Lindóia;0;0;0;0;0;0
1079;0;Bom Fim;Jardim Sabará;50;0;19;9;0;50
1080;0;Bom Fim;Jardim São Pedro;150;0;43;31;50;100
1081;0;Bom Fim;Jardim do Salso;50;50;0;0;50;0
1082;0;Bom Fim;Lageado;50;0;26;14;0;50
1083;0;Bom Fim;Lami;0;0;0;0;0;0
1084;0;Bom Fim;Lomba do Pinheiro;52;50;0;1;50;2
1085;0;Bom Fim;Medianeira;300;100;58;34;200;100
1086;0;Bom Fim;Menino Deus;906;100;319;168;300;606
1087;0;Bom Fim;Moinhos de Vento;1100;100;351;140;600;500
1088;0;Bom Fim;Mont'Serrat;53;0;27;11;0;53
1089;0;Bom Fim;Morro Santana;6;0;3;0;0;6
1090;0;Bom Fim;Mário Quintana;229;50;65;31;100;129
1091;0;Bom Fim;Navegantes;150;50;30;11;100;50
1092;0;Bom Fim;Nonoai;202;0;51;32;100;102
1093;0;Bom Fim;Parque Santa Fé;50;0;31;10;0;50
1094;0;Bom Fim;Partenon;556;150;179;66;250;306
1095;0;Bom Fim;Passo D'Areia;257;150;38;39;150;107
1096;0;Bom Fim;Passo das Pedras;106;50;36;3;50;56
1097;0;Bom Fim;Pedra Redonda;0;0;0;0;0;0
1098;0;Bom Fim;Petrópolis;507;100;204;96;150;357
1099;0;Bom Fim;Pitinga;100;0;21;17;50;50
1100;0;Bom Fim;Ponta Grossa;50;50;0;0;50;0
1101;0;Bom Fim;Praia de Belas;250;0;88;56;50;200
1102;0;Bom Fim;Restinga;57;0;30;8;0;57
1103;0;Bom Fim;Rio Branco;2154;150;889;419;550;1604
1104;0;Bom Fim;Rubem Berta;102;0;47;40;0;102
1105;0;Bom Fim;Santa Cecília;800;250;258;82;500;300
1106;0;Bom Fim;Santa Maria Goretti;250;0;74;42;100;150
1107;0;Bom Fim;Santa Rosa de Lima;153;100;33;5;100;53
1108;0;Bom Fim;Santa Tereza;106;0;34;14;50;56
1109;0;Bom Fim;Santana;1201;200;399;233;398;803
1110;0;Bom Fim;Santo Antônio;302;50;58;29;200;102
1111;0;Bom Fim;Sarandi;331;50;163;71;50;281
1112;0;Bom Fim;Serraria;0;0;0;0;0;0
1113;0;Bom Fim;São Caetano;0;0;0;0;0;0
1114;0;Bom Fim;São Geraldo;350;0;175;86;0;350
1115;0;Bom Fim;São José;54;0;32;14;0;54
1116;0;Bom Fim;São João;200;0;129;37;50;150
1117;0;Bom Fim;São Sebastião;50;0;10;18;0;50
1118;0;Bom Fim;Sétimo Céu;0;0;0;0;0;0
1119;0;Bom Fim;Teresópolis;0;0;0;0;0;0
1120;0;Bom Fim;Tristeza;3;0;2;0;0;3
1121;0;Bom Fim;Três Figueiras;200;50;75;13;150;50
1122;0;Bom Fim;Vila Assunção;100;0;0;0;100;0
1123;0;Bom Fim;Vila Conceição;50;0;21;22;0;50
1124;0;Bom Fim;Vila Ipiranga;102;50;27;13;50;52
1125;0;Bom Fim;Vila Jardim;204;0;58;23;100;104
1126;0;Bom Fim;Vila João Pessoa;150;0;55;25;50;100
1127;0;Bom Fim;Vila Nova;79;0;43;16;0;79
1128;0;Bom Jesus;Aberta dos Morros;0;0;0;0;0;0
1129;0;Bom Jesus;Agronomia;730;300;135;44;500;230
1130;0;Bom Jesus;Anchieta;50;50;0;0;50;0
1131;0;Bom Jesus;Arquipélago;50;0;29;14;0;50
1132;0;Bom Jesus;Auxiliadora;72;0;49;14;0;72
1133;0;Bom Jesus;Azenha;35;0;0;0;35;0
1134;0;Bom Jesus;Bela Vista;100;100;0;0;100;0
1135;0;Bom Jesus;Belém Novo;150;50;47;16;50;100
1136;0;Bom Jesus;Belém Velho;180;50;82;22;50;130
1137;0;Bom Jesus;Boa Vista;200;50;70;18;100;100
1138;0;Bom Jesus;Boa Vista do Sul;150;50;54;13;50;100
1139;0;Bom Jesus;Bom Fim;120;0;38;19;50;70
1140;0;Bom Jesus;Bom Jesus;19610;5421;6170;1737;9745;9865
1141;0;Bom Jesus;Camaquã;150;0;84;21;0;150
1142;0;Bom Jesus;Campo Novo;350;100;61;15;250;100
1143;0;Bom Jesus;Cascata;53;0;25;8;0;53
1144;0;Bom Jesus;Cavalhada;29;0;21;3;0;29
1145;0;Bom Jesus;Cel. Aparício Borges;249;100;120;12;150;99
1146;0;Bom Jesus;Centro Histórico;396;50;121;27;200;196
1147;0;Bom Jesus;Chapéu do Sol;50;0;31;3;0;50
1148;0;Bom Jesus;Chácara das Pedras;2101;145;1070;299;245;1856
1149;0;Bom Jesus;Cidade Baixa;200;0;93;20;50;150
1150;0;Bom Jesus;Costa e Silva;253;100;88;24;100;153
1151;0;Bom Jesus;Cristal;153;0;42;20;50;103
1152;0;Bom Jesus;Cristo Redentor;54;0;33;4;0;54
1153;0;Bom Jesus;Espírito Santo;100;0;63;13;0;100
1154;0;Bom Jesus;Extrema;50;0;34;4;0;50
1155;0;Bom Jesus;Farrapos;8140;227;4354;1404;736;7404
1156;0;Bom Jesus;Farroupilha;0;0;0;0;0;0
1157;0;Bom Jesus;Floresta;111;50;13;4;85;26
1158;0;Bom Jesus;Glória;0;0;0;0;0;0
1159;0;Bom Jesus;Guarujá;200;0;120;40;0;200
1160;0;Bom Jesus;Higienópolis;100;0;54;19;0;100
1161;0;Bom Jesus;Humaitá;224;98;91;17;98;126
1162;0;Bom Jesus;Hípica;100;100;0;0;100;0
1163;0;Bom Jesus;Independência;100;0;28;9;50;50
1164;0;Bom Jesus;Ipanema;0;0;0;0;0;0
1165;0;Bom Jesus;Jardim Botânico;951;200;344;77;448;503
1166;0;Bom Jesus;Jardim Carvalho;2434;490;954;250;1024;1410
1167;0;Bom Jesus;Jardim Europa;600;0;286;77;150;450
1168;0;Bom Jesus;Jardim Floresta;203;0;94;32;50;153
1169;0;Bom Jesus;Jardim Isabel;100;0;56;21;0;100
1170;0;Bom Jesus;Jardim Itú;603;0;310;88;98;505
1171;0;Bom Jesus;Jardim Leopoldina;99;0;37;7;35;64
1172;0;Bom Jesus;Jardim Lindóia;150;0;64;16;50;100
1173;0;Bom Jesus;Jardim Sabará;1877;100;842;265;348;1529
1174;0;Bom Jesus;Jardim São Pedro;135;50;0;0;135;0
1175;0;Bom Jesus;Jardim do Salso;1797;297;768;168;647;1150
1176;0;Bom Jesus;Lageado;100;0;64;19;0;100
1177;0;Bom Jesus;Lami;0;0;0;0;0;0
1178;0;Bom Jesus;Lomba do Pinheiro;275;0;85;15;143;132
1179;0;Bom Jesus;Medianeira;250;100;94;21;100;150
1180;0;Bom Jesus;Menino Deus;79;0;47;15;0;79
1181;0;Bom Jesus;Moinhos de Vento;150;50;62;14;50;100
1182;0;Bom Jesus;Mont'Serrat;251;50;72;17;150;101
1183;0;Bom Jesus;Morro Santana;767;50;338;116;148;619
1184;0;Bom Jesus;Mário Quintana;371;0;142;29;135;236
1185;0;Bom Jesus;Navegantes;50;0;29;14;0;50
1186;0;Bom Jesus;Nonoai;116;0;32;15;50;66
1187;0;Bom Jesus;Parque Santa Fé;103;0;60;17;0;103
1188;0;Bom Jesus;Partenon;897;450;84;6;850;47
1189;0;Bom Jesus;Passo D'Areia;202;50;6;3;185;17
1190;0;Bom Jesus;Passo das Pedras;301;50;125;41;98;203
1191;0;Bom Jesus;Pedra Redonda;50;0;30;9;0;50
1192;0;Bom Jesus;Petrópolis;322;100;112;32;185;137
1193;0;Bom Jesus;Pitinga;250;0;140;50;0;250
1194;0;Bom Jesus;Ponta Grossa;100;0;31;17;50;50
1195;0;Bom Jesus;Praia de Belas;200;50;95;19;50;150
1196;0;Bom Jesus;Restinga;253;0;132;43;50;203
1197;0;Bom Jesus;Rio Branco;150;0;60;11;50;100
1198;0;Bom Jesus;Rubem Berta;202;0;65;32;50;152
1199;0;Bom Jesus;Santa Cecília;50;0;32;5;0;50
1200;0;Bom Jesus;Santa Maria Goretti;150;0;86;35;0;150
1201;0;Bom Jesus;Santa Rosa de Lima;139;50;1;0;135;4
1202;0;Bom Jesus;Santa Tereza;254;100;73;18;150;104
1203;0;Bom Jesus;Santana;107;48;10;7;83;24
1204;0;Bom Jesus;Santo Antônio;100;50;22;10;50;50
1205;0;Bom Jesus;Sarandi;276;0;96;46;100;176
1206;0;Bom Jesus;Serraria;50;0;41;9;0;50
1207;0;Bom Jesus;São Caetano;150;100;50;0;150;0
1208;0;Bom Jesus;São Geraldo;149;47;32;8;96;53
1209;0;Bom Jesus;São José;652;295;195;42;341;311
1210;0;Bom Jesus;São João;235;50;29;7;185;50
1211;0;Bom Jesus;São Sebastião;48;48;0;0;48;0
1212;0;Bom Jesus;Sétimo Céu;150;0;84;26;0;150
1213;0;Bom Jesus;Teresópolis;50;0;24;10;0;50
1214;0;Bom Jesus;Tristeza;3;0;2;1;0;3
1215;0;Bom Jesus;Três Figueiras;376;0;223;49;100;276
1216;0;Bom Jesus;Vila Assunção;100;50;35;9;50;50
1217;0;Bom Jesus;Vila Conceição;0;0;0;0;0;0
1218;0;Bom Jesus;Vila Ipiranga;814;350;209;83;450;364
1219;0;Bom Jesus;Vila Jardim;1766;784;403;142;1069;697
1220;0;Bom Jesus;Vila João Pessoa;563;100;189;63;235;328
1221;0;Bom Jesus;Vila Nova;159;50;31;17;85;74
1222;0;Camaquã;Aberta dos Morros;150;0;109;20;50;100
1223;0;Camaquã;Agronomia;50;0;29;13;0;50
1224;0;Camaquã;Anchieta;0;0;0;0;0;0
1225;0;Camaquã;Arquipélago;35;0;0;0;35;0
1226;0;Camaquã;Auxiliadora;0;0;0;0;0;0
1227;0;Camaquã;Azenha;101;0;52;22;0;101
1228;0;Camaquã;Bela Vista;51;0;26;13;0;51
1229;0;Camaquã;Belém Novo;150;0;56;28;50;100
1230;0;Camaquã;Belém Velho;151;0;58;17;48;103
1231;0;Camaquã;Boa Vista;50;0;36;9;0;50
1232;0;Camaquã;Boa Vista do Sul;0;0;0;0;0;0
1233;0;Camaquã;Bom Fim;250;0;120;45;50;200
1234;0;Camaquã;Bom Jesus;154;0;87;21;0;154
1235;0;Camaquã;Camaquã;11043;690;5598;2122;1342;9701
1236;0;Camaquã;Campo Novo;150;0;72;13;50;100
1237;0;Camaquã;Cascata;100;0;63;15;0;100
1238;0;Camaquã;Cavalhada;2164;300;1029;348;450;1714
1239;0;Camaquã;Cel. Aparício Borges;157;50;35;7;100;57
1240;0;Camaquã;Centro Histórico;154;0;70;35;0;154
1241;0;Camaquã;Chapéu do Sol;0;0;0;0;0;0
1242;0;Camaquã;Chácara das Pedras;50;0;0;0;50;0
1243;0;Camaquã;Cidade Baixa;0;0;0;0;0;0
1244;0;Camaquã;Costa e Silva;4;0;1;1;0;4
1245;0;Camaquã;Cristal;3181;536;1334;444;866;2315
1246;0;Camaquã;Cristo Redentor;106;0;75;18;0;106
1247;0;Camaquã;Espírito Santo;150;50;52;22;50;100
1248;0;Camaquã;Extrema;0;0;0;0;0;0
1249;0;Camaquã;Farrapos;9128;3939;3159;1120;2837;2037
1250;0;Camaquã;Farroupilha;0;0;0;0;0;0
1251;0;Camaquã;Floresta;198;98;52;19;98;100
1252;0;Camaquã;Glória;272;50;82;38;122;150
1253;0;Camaquã;Guarujá;400;100;156;54;150;250
1254;0;Camaquã;Higienópolis;51;0;29;7;0;51
1255;0;Camaquã;Humaitá;0;0;0;0;0;0
1256;0;Camaquã;Hípica;101;0;63;21;0;101
1257;0;Camaquã;Independência;50;50;0;0;50;0
1258;0;Camaquã;Ipanema;503;50;170;80;200;303
1259;0;Camaquã;Jardim Botânico;201;148;25;11;148;53
1260;0;Camaquã;Jardim Carvalho;50;50;0;0;50;0
1261;0;Camaquã;Jardim Europa;0;0;0;0;0;0
1262;0;Camaquã;Jardim Floresta;0;0;0;0;0;0
1263;0;Camaquã;Jardim Isabel;1350;150;687;230;250;1100
1264;0;Camaquã;Jardim Itú;202;0;124;36;0;202
1265;0;Camaquã;Jardim Leopoldina;52;50;1;0;50;2
1266;0;Camaquã;Jardim Lindóia;50;0;32;8;0;50
1267;0;Camaquã;Jardim Sabará;146;47;50;0;146;0
1268;0;Camaquã;Jardim São Pedro;100;50;0;0;100;0
1269;0;Camaquã;Jardim do Salso;50;0;29;12;0;50
1270;0;Camaquã;Lageado;50;0;26;8;0;50
1271;0;Camaquã;Lami;100;50;0;0;100;0
1272;0;Camaquã;Lomba do Pinheiro;103;0;35;10;50;53
1273;0;Camaquã;Medianeira;150;0;25;10;100;50
1274;0;Camaquã;Menino Deus;359;0;167;70;50;309
1275;0;Camaquã;Moinhos de Vento;150;50;55;32;50;100
1276;0;Camaquã;Mont'Serrat;149;0;60;23;48;101
1277;0;Camaquã;Morro Santana;56;0;32;9;0;56
1278;0;Camaquã;Mário Quintana;77;50;21;3;50;27
1279;0;Camaquã;Navegantes;100;50;0;0;100;0
1280;0;Camaquã;Nonoai;1815;292;730;259;564;1251
1281;0;Camaquã;Parque Santa Fé;50;0;27;12;0;50
1282;0;Camaquã;Partenon;56;0;37;11;0;56
1283;0;Camaquã;Passo D'Areia;8;0;4;4;0;8
1284;0;Camaquã;Passo das Pedras;154;48;67;21;48;106
1285;0;Camaquã;Pedra Redonda;550;150;178;63;250;300
1286;0;Camaquã;Petrópolis;308;150;79;38;150;158
1287;0;Camaquã;Pitinga;0;0;0;0;0;0
1288;0;Camaquã;Ponta Grossa;100;0;57;25;0;100
1289;0;Camaquã;Praia de Belas;100;0;28;12;50;50
1290;0;Camaquã;Restinga;14;0;9;1;0;14
1291;0;Camaquã;Rio Branco;303;100;112;14;200;103
1292;0;Camaquã;Rubem Berta;51;0;28;20;0;51
1293;0;Camaquã;Santa Cecília;100;0;55;28;0;100
1294;0;Camaquã;Santa Maria Goretti;136;100;0;0;136;0
1295;0;Camaquã;Santa Rosa de Lima;102;50;26;8;50;52
1296;0;Camaquã;Santa Tereza;357;198;96;30;198;159
1297;0;Camaquã;Santana;154;0;102;1;150;4
1298;0;Camaquã;Santo Antônio;98;0;0;0;98;0
1299;0;Camaquã;Sarandi;325;0;184;85;0;325
1300;0;Camaquã;Serraria;200;0;79;31;50;150
1301;0;Camaquã;São Caetano;150;0;60;19;50;100
1302;0;Camaquã;São Geraldo;48;0;0;0;48;0
1303;0;Camaquã;São José;3;0;2;0;0;3
1304;0;Camaquã;São João;50;0;30;12;0;50
1305;0;Camaquã;São Sebastião;50;0;30;10;0;50
1306;0;Camaquã;Sétimo Céu;1850;100;870;291;450;1400
1307;0;Camaquã;Teresópolis;500;100;175;70;200;300
1308;0;Camaquã;Tristeza;1247;492;367;203;542;705
1309;0;Camaquã;Três Figueiras;100;50;29;11;50;50
1310;0;Camaquã;Vila Assunção;450;150;143;17;300;150
1311;0;Camaquã;Vila Conceição;600;100;260;85;150;450
1312;0;Camaquã;Vila Ipiranga;48;48;0;0;48;0
1313;0;Camaquã;Vila Jardim;101;0;26;11;48;53
1314;0;Camaquã;Vila João Pessoa;150;0;56;18;50;100
1315;0;Camaquã;Vila Nova;275;0;143;57;0;275
1316;0;Campo Novo;Aberta dos Morros;2360;199;1231;328;335;2025
1317;0;Campo Novo;Agronomia;150;50;65;18;50;100
1318;0;Campo Novo;Anchieta;50;0;0;0;50;0
1319;0;Campo Novo;Arquipélago;50;0;22;10;0;50
1320;0;Campo Novo;Auxiliadora;1;0;0;1;0;1
1321;0;Campo Novo;Azenha;150;0;121;17;50;100
1322;0;Campo Novo;Bela Vista;21;0;15;5;0;21
1323;0;Campo Novo;Belém Novo;179;50;76;25;50;129
1324;0;Campo Novo;Belém Velho;1245;688;131;41;1009;236
1325;0;Campo Novo;Boa Vista;0;0;0;0;0;0
1326;0;Campo Novo;Boa Vista do Sul;11;0;5;2;0;11
1327;0;Campo Novo;Bom Fim;0;0;0;0;0;0
1328;0;Campo Novo;Bom Jesus;253;97;15;1;231;22
1329;0;Campo Novo;Camaquã;114;0;58;7;37;77
1330;0;Campo Novo;Campo Novo;4139;1666;885;221;2907;1232
1331;0;Campo Novo;Cascata;100;0;63;15;0;100
1332;0;Campo Novo;Cavalhada;218;0;73;26;98;120
1333;0;Campo Novo;Cel. Aparício Borges;203;50;65;11;100;103
1334;0;Campo Novo;Centro Histórico;75;0;0;0;74;1
1335;0;Campo Novo;Chapéu do Sol;50;0;0;0;50;0
1336;0;Campo Novo;Chácara das Pedras;49;0;25;12;0;49
1337;0;Campo Novo;Cidade Baixa;1;0;1;0;0;1
1338;0;Campo Novo;Costa e Silva;51;50;1;0;50;1
1339;0;Campo Novo;Cristal;37;0;19;11;0;37
1340;0;Campo Novo;Cristo Redentor;2;0;1;0;0;2
1341;0;Campo Novo;Espírito Santo;239;50;111;44;50;189
1342;0;Campo Novo;Extrema;0;0;0;0;0;0
1343;0;Campo Novo;Farrapos;4457;71;2427;782;432;4025
1344;0;Campo Novo;Farroupilha;0;0;0;0;0;0
1345;0;Campo Novo;Floresta;100;50;0;0;100;0
1346;0;Campo Novo;Glória;0;0;0;0;0;0
1347;0;Campo Novo;Guarujá;149;100;31;5;100;49
1348;0;Campo Novo;Higienópolis;0;0;0;0;0;0
1349;0;Campo Novo;Humaitá;0;0;0;0;0;0
1350;0;Campo Novo;Hípica;335;100;55;9;248;87
1351;0;Campo Novo;Independência;0;0;0;0;0;0
1352;0;Campo Novo;Ipanema;849;0;460;163;74;775
1353;0;Campo Novo;Jardim Botânico;50;48;1;1;48;2
1354;0;Campo Novo;Jardim Carvalho;30;0;22;4;0;30
1355;0;Campo Novo;Jardim Europa;0;0;0;0;0;0
1356;0;Campo Novo;Jardim Floresta;0;0;0;0;0;0
1357;0;Campo Novo;Jardim Isabel;87;0;25;7;37;50
1358;0;Campo Novo;Jardim Itú;50;50;0;0;50;0
1359;0;Campo Novo;Jardim Leopoldina;102;50;1;0;100;2
1360;0;Campo Novo;Jardim Lindóia;0;0;0;0;0;0
1361;0;Campo Novo;Jardim Sabará;0;0;0;0;0;0
1362;0;Campo Novo;Jardim São Pedro;50;50;0;0;50;0
1363;0;Campo Novo;Jardim do Salso;0;0;0;0;0;0
1364;0;Campo Novo;Lageado;0;0;0;0;0;0
1365;0;Campo Novo;Lami;0;0;0;0;0;0
1366;0;Campo Novo;Lomba do Pinheiro;187;98;30;1;148;39
1367;0;Campo Novo;Medianeira;106;0;51;11;37;69
1368;0;Campo Novo;Menino Deus;14;0;5;7;0;14
1369;0;Campo Novo;Moinhos de Vento;56;0;8;9;37;19
1370;0;Campo Novo;Mont'Serrat;50;0;25;7;0;50
1371;0;Campo Novo;Morro Santana;2;0;2;0;0;2
1372;0;Campo Novo;Mário Quintana;36;0;21;5;0;36
1373;0;Campo Novo;Navegantes;50;0;28;9;0;50
1374;0;Campo Novo;Nonoai;119;48;40;16;48;71
1375;0;Campo Novo;Parque Santa Fé;61;0;8;2;50;11
1376;0;Campo Novo;Partenon;71;0;50;10;0;71
1377;0;Campo Novo;Passo D'Areia;101;48;1;1;98;3
1378;0;Campo Novo;Passo das Pedras;53;50;2;0;50;3
1379;0;Campo Novo;Pedra Redonda;50;0;0;0;50;0
1380;0;Campo Novo;Petrópolis;103;0;70;17;0;103
1381;0;Campo Novo;Pitinga;0;0;0;0;0;0
1382;0;Campo Novo;Ponta Grossa;111;0;39;11;50;61
1383;0;Campo Novo;Praia de Belas;50;50;0;0;50;0
1384;0;Campo Novo;Restinga;821;295;106;24;720;101
1385;0;Campo Novo;Rio Branco;51;0;0;0;50;1
1386;0;Campo Novo;Rubem Berta;50;48;2;0;48;2
1387;0;Campo Novo;Santa Cecília;150;100;35;12;100;50
1388;0;Campo Novo;Santa Maria Goretti;0;0;0;0;0;0
1389;0;Campo Novo;Santa Rosa de Lima;0;0;0;0;0;0
1390;0;Campo Novo;Santa Tereza;152;100;32;10;100;52
1391;0;Campo Novo;Santana;27;0;17;9;0;27
1392;0;Campo Novo;Santo Antônio;69;0;44;13;0;69
1393;0;Campo Novo;Sarandi;272;0;109;43;85;187
1394;0;Campo Novo;Serraria;349;100;103;38;174;175
1395;0;Campo Novo;São Caetano;0;0;0;0;0;0
1396;0;Campo Novo;São Geraldo;75;0;14;6;50;25
1397;0;Campo Novo;São José;99;50;6;4;87;12
1398;0;Campo Novo;São João;0;0;0;0;0;0
1399;0;Campo Novo;São Sebastião;0;0;0;0;0;0
1400;0;Campo Novo;Sétimo Céu;100;50;0;0;100;0
1401;0;Campo Novo;Teresópolis;301;150;96;23;150;151
1402;0;Campo Novo;Tristeza;226;50;75;31;100;126
1403;0;Campo Novo;Três Figueiras;75;0;11;6;50;25
1404;0;Campo Novo;Vila Assunção;0;0;0;0;0;0
1405;0;Campo Novo;Vila Conceição;0;0;0;0;0;0
1406;0;Campo Novo;Vila Ipiranga;134;48;0;0;134;0
1407;0;Campo Novo;Vila Jardim;51;0;0;1;50;1
1408;0;Campo Novo;Vila João Pessoa;0;0;0;0;0;0
1409;0;Campo Novo;Vila Nova;1158;246;202;76;791;367
1410;0;Cascata;Aberta dos Morros;50;0;0;0;50;0
1411;0;Cascata;Agronomia;350;200;106;16;200;150
1412;0;Cascata;Anchieta;51;0;28;7;0;51
1413;0;Cascata;Arquipélago;100;0;28;9;50;50
1414;0;Cascata;Auxiliadora;102;50;27;8;50;52
1415;0;Cascata;Azenha;200;0;60;10;100;100
1416;0;Cascata;Bela Vista;54;50;3;0;50;4
1417;0;Cascata;Belém Novo;150;100;31;9;100;50
1418;0;Cascata;Belém Velho;743;150;330;86;200;543
1419;0;Cascata;Boa Vista;3;0;1;2;0;3
1420;0;Cascata;Boa Vista do Sul;50;0;0;0;50;0
1421;0;Cascata;Bom Fim;75;0;40;15;0;75
1422;0;Cascata;Bom Jesus;82;0;37;14;0;82
1423;0;Cascata;Camaquã;79;0;51;9;0;79
1424;0;Cascata;Campo Novo;51;0;34;8;0;51
1425;0;Cascata;Cascata;1175;200;532;131;300;875
1426;0;Cascata;Cavalhada;11;0;7;4;0;11
1427;0;Cascata;Cel. Aparício Borges;1349;400;405;100;650;699
1428;0;Cascata;Centro Histórico;104;100;2;1;100;4
1429;0;Cascata;Chapéu do Sol;51;0;35;9;0;51
1430;0;Cascata;Chácara das Pedras;100;0;27;6;50;50
1431;0;Cascata;Cidade Baixa;13;0;7;2;0;13
1432;0;Cascata;Costa e Silva;106;0;74;16;0;106
1433;0;Cascata;Cristal;60;0;32;18;0;60
1434;0;Cascata;Cristo Redentor;106;0;54;1;100;6
1435;0;Cascata;Espírito Santo;0;0;0;0;0;0
1436;0;Cascata;Extrema;50;0;28;9;0;50
1437;0;Cascata;Farrapos;6454;0;3810;1137;50;6404
1438;0;Cascata;Farroupilha;125;50;49;12;50;75
1439;0;Cascata;Floresta;25;0;14;8;0;25
1440;0;Cascata;Glória;1714;400;511;119;850;864
1441;0;Cascata;Guarujá;150;0;92;21;0;150
1442;0;Cascata;Higienópolis;102;0;66;14;0;102
1443;0;Cascata;Humaitá;50;0;27;9;0;50
1444;0;Cascata;Hípica;101;0;29;7;50;51
1445;0;Cascata;Independência;50;0;0;0;50;0
1446;0;Cascata;Ipanema;4;0;3;1;0;4
1447;0;Cascata;Jardim Botânico;733;150;257;63;300;433
1448;0;Cascata;Jardim Carvalho;539;200;180;50;250;289
1449;0;Cascata;Jardim Europa;50;0;31;4;0;50
1450;0;Cascata;Jardim Floresta;0;0;0;0;0;0
1451;0;Cascata;Jardim Isabel;0;0;0;0;0;0
1452;0;Cascata;Jardim Itú;50;0;27;4;0;50
1453;0;Cascata;Jardim Leopoldina;5;0;3;1;0;5
1454;0;Cascata;Jardim Lindóia;25;0;8;14;0;25
1455;0;Cascata;Jardim Sabará;0;0;0;0;0;0
1456;0;Cascata;Jardim São Pedro;0;0;0;0;0;0
1457;0;Cascata;Jardim do Salso;150;0;64;14;50;100
1458;0;Cascata;Lageado;125;0;46;14;50;75
1459;0;Cascata;Lami;0;0;0;0;0;0
1460;0;Cascata;Lomba do Pinheiro;682;150;234;53;300;382
1461;0;Cascata;Medianeira;50;0;25;9;0;50
1462;0;Cascata;Menino Deus;210;0;81;31;50;160
1463;0;Cascata;Moinhos de Vento;50;0;23;6;0;50
1464;0;Cascata;Mont'Serrat;127;50;48;14;50;77
1465;0;Cascata;Morro Santana;332;150;49;8;250;82
1466;0;Cascata;Mário Quintana;121;0;14;3;100;21
1467;0;Cascata;Navegantes;0;0;0;0;0;0
1468;0;Cascata;Nonoai;363;100;107;24;200;163
1469;0;Cascata;Parque Santa Fé;119;50;9;1;100;19
1470;0;Cascata;Partenon;408;0;232;60;0;408
1471;0;Cascata;Passo D'Areia;83;0;15;10;50;33
1472;0;Cascata;Passo das Pedras;30;0;13;8;0;30
1473;0;Cascata;Pedra Redonda;50;0;28;5;0;50
1474;0;Cascata;Petrópolis;200;0;82;21;50;150
1475;0;Cascata;Pitinga;71;50;8;5;50;21
1476;0;Cascata;Ponta Grossa;0;0;0;0;0;0
1477;0;Cascata;Praia de Belas;50;0;27;10;0;50
1478;0;Cascata;Restinga;196;50;25;12;150;46
1479;0;Cascata;Rio Branco;4;0;1;3;0;4
1480;0;Cascata;Rubem Berta;63;0;27;10;0;63
1481;0;Cascata;Santa Cecília;50;50;0;0;50;0
1482;0;Cascata;Santa Maria Goretti;0;0;0;0;0;0
1483;0;Cascata;Santa Rosa de Lima;171;0;59;20;50;121
1484;0;Cascata;Santa Tereza;186;100;23;6;150;36
1485;0;Cascata;Santana;331;0;199;28;100;231
1486;0;Cascata;Santo Antônio;252;50;57;14;150;102
1487;0;Cascata;Sarandi;222;100;36;14;150;72
1488;0;Cascata;Serraria;0;0;0;0;0;0
1489;0;Cascata;São Caetano;0;0;0;0;0;0
1490;0;Cascata;São Geraldo;100;50;0;0;100;0
1491;0;Cascata;São José;4086;450;1760;466;1100;2986
1492;0;Cascata;São João;0;0;0;0;0;0
1493;0;Cascata;São Sebastião;0;0;0;0;0;0
1494;0;Cascata;Sétimo Céu;0;0;0;0;0;0
1495;0;Cascata;Teresópolis;250;150;0;0;250;0
1496;0;Cascata;Tristeza;6;0;5;1;0;6
1497;0;Cascata;Três Figueiras;100;50;32;9;50;50
1498;0;Cascata;Vila Assunção;150;100;33;3;100;50
1499;0;Cascata;Vila Conceição;0;0;0;0;0;0
1500;0;Cascata;Vila Ipiranga;52;50;0;0;50;2
1501;0;Cascata;Vila Jardim;54;50;3;0;50;4
1502;0;Cascata;Vila João Pessoa;932;200;348;90;350;582
1503;0;Cascata;Vila Nova;931;200;147;48;750;181
1504;0;Cavalhada;Aberta dos Morros;560;0;289;107;98;462
1505;0;Cavalhada;Agronomia;0;0;0;0;0;0
1506;0;Cavalhada;Anchieta;125;50;16;2;100;25
1507;0;Cavalhada;Arquipélago;100;50;0;0;100;0
1508;0;Cavalhada;Auxiliadora;97;50;27;13;50;47
1509;0;Cavalhada;Azenha;162;0;58;24;50;112
1510;0;Cavalhada;Bela Vista;2;0;0;0;0;2
1511;0;Cavalhada;Belém Novo;0;0;0;0;0;0
1512;0;Cavalhada;Belém Velho;104;50;4;0;100;4
1513;0;Cavalhada;Boa Vista;101;0;51;23;0;101
1514;0;Cavalhada;Boa Vista do Sul;0;0;0;0;0;0
1515;0;Cavalhada;Bom Fim;62;50;3;6;50;12
1516;0;Cavalhada;Bom Jesus;54;0;34;9;0;54
1517;0;Cavalhada;Camaquã;2032;298;961;326;417;1615
1518;0;Cavalhada;Campo Novo;252;0;100;29;100;152
1519;0;Cavalhada;Cascata;0;0;0;0;0;0
1520;0;Cavalhada;Cavalhada;11261;5811;561;28;11115;146
1521;0;Cavalhada;Cel. Aparício Borges;104;50;33;13;50;54
1522;0;Cavalhada;Centro Histórico;155;50;25;13;100;55
1523;0;Cavalhada;Chapéu do Sol;100;50;0;0;100;0
1524;0;Cavalhada;Chácara das Pedras;0;0;0;0;0;0
1525;0;Cavalhada;Cidade Baixa;3;0;2;1;0;3
1526;0;Cavalhada;Costa e Silva;5;0;0;3;0;5
1527;0;Cavalhada;Cristal;5051;443;2582;898;527;4524
1528;0;Cavalhada;Cristo Redentor;75;0;17;4;50;25
1529;0;Cavalhada;Espírito Santo;1025;350;222;64;750;275
1530;0;Cavalhada;Extrema;50;50;0;0;50;0
1531;0;Cavalhada;Farrapos;24641;6621;10816;3876;3913;13779
1532;0;Cavalhada;Farroupilha;100;0;42;29;0;100
1533;0;Cavalhada;Floresta;148;98;26;10;98;50
1534;0;Cavalhada;Glória;151;0;96;25;0;151
1535;0;Cavalhada;Guarujá;273;48;94;34;98;175
1536;0;Cavalhada;Higienópolis;99;0;37;9;48;51
1537;0;Cavalhada;Humaitá;0;0;0;0;0;0
1538;0;Cavalhada;Hípica;327;0;198;76;0;327
1539;0;Cavalhada;Independência;0;0;0;0;0;0
1540;0;Cavalhada;Ipanema;1784;841;221;55;1556;228
1541;0;Cavalhada;Jardim Botânico;53;0;30;14;0;53
1542;0;Cavalhada;Jardim Carvalho;208;0;129;35;0;208
1543;0;Cavalhada;Jardim Europa;0;0;0;0;0;0
1544;0;Cavalhada;Jardim Floresta;0;0;0;0;0;0
1545;0;Cavalhada;Jardim Isabel;4100;250;2071;736;450;3650
1546;0;Cavalhada;Jardim Itú;198;0;75;19;98;100
1547;0;Cavalhada;Jardim Leopoldina;179;0;76;25;50;129
1548;0;Cavalhada;Jardim Lindóia;102;0;72;26;0;102
1549;0;Cavalhada;Jardim Sabará;148;50;25;13;98;50
1550;0;Cavalhada;Jardim São Pedro;50;0;27;9;0;50
1551;0;Cavalhada;Jardim do Salso;50;0;0;0;50;0
1552;0;Cavalhada;Lageado;36;0;0;0;36;0
1553;0;Cavalhada;Lami;150;50;25;13;100;50
1554;0;Cavalhada;Lomba do Pinheiro;105;0;60;15;0;105
1555;0;Cavalhada;Medianeira;175;0;43;20;100;75
1556;0;Cavalhada;Menino Deus;106;50;34;9;50;56
1557;0;Cavalhada;Moinhos de Vento;148;50;69;9;98;50
1558;0;Cavalhada;Mont'Serrat;87;0;1;0;86;1
1559;0;Cavalhada;Morro Santana;131;0;51;11;50;81
1560;0;Cavalhada;Mário Quintana;80;50;21;5;50;30
1561;0;Cavalhada;Navegantes;302;0;92;33;150;152
1562;0;Cavalhada;Nonoai;1204;443;333;120;623;581
1563;0;Cavalhada;Parque Santa Fé;324;100;53;8;248;76
1564;0;Cavalhada;Partenon;103;0;55;22;0;103
1565;0;Cavalhada;Passo D'Areia;29;0;8;8;0;29
1566;0;Cavalhada;Passo das Pedras;67;0;17;6;36;31
1567;0;Cavalhada;Pedra Redonda;2300;450;679;246;1150;1150
1568;0;Cavalhada;Petrópolis;250;148;78;9;196;54
1569;0;Cavalhada;Pitinga;0;0;0;0;0;0
1570;0;Cavalhada;Ponta Grossa;375;0;168;62;100;275
1571;0;Cavalhada;Praia de Belas;75;0;13;2;50;25
1572;0;Cavalhada;Restinga;258;50;99;24;100;158
1573;0;Cavalhada;Rio Branco;4;0;2;1;0;4
1574;0;Cavalhada;Rubem Berta;229;100;67;39;100;129
1575;0;Cavalhada;Santa Cecília;150;0;82;34;0;150
1576;0;Cavalhada;Santa Maria Goretti;150;0;77;40;0;150
1577;0;Cavalhada;Santa Rosa de Lima;51;0;24;8;0;51
1578;0;Cavalhada;Santa Tereza;829;98;385;140;148;681
1579;0;Cavalhada;Santana;264;0;123;24;148;116
1580;0;Cavalhada;Santo Antônio;221;50;62;32;100;121
1581;0;Cavalhada;Sarandi;472;0;213;82;100;372
1582;0;Cavalhada;Serraria;573;148;247;77;148;425
1583;0;Cavalhada;São Caetano;0;0;0;0;0;0
1584;0;Cavalhada;São Geraldo;48;0;0;0;48;0
1585;0;Cavalhada;São José;56;0;28;13;0;56
1586;0;Cavalhada;São João;75;0;44;16;0;75
1587;0;Cavalhada;São Sebastião;61;0;15;1;36;25
1588;0;Cavalhada;Sétimo Céu;5175;500;2368;874;1050;4125
1589;0;Cavalhada;Teresópolis;634;148;227;73;248;386
1590;0;Cavalhada;Tristeza;767;196;168;76;466;301
1591;0;Cavalhada;Três Figueiras;50;50;0;0;50;0
1592;0;Cavalhada;Vila Assunção;217;0;124;17;98;119
1593;0;Cavalhada;Vila Conceição;450;100;194;75;100;350
1594;0;Cavalhada;Vila Ipiranga;132;0;85;33;0;132
1595;0;Cavalhada;Vila Jardim;30;0;16;10;0;30
1596;0;Cavalhada;Vila João Pessoa;125;0;70;31;0;125
1597;0;Cavalhada;Vila Nova;1431;50;740;264;186;1245
1598;0;Cel. Aparício Borges;Aberta dos Morros;73;0;64;5;50;23
1599;0;Cel. Aparício Borges;Agronomia;100;0;27;7;50;50
1600;0;Cel. Aparício Borges;Anchieta;150;0;47;21;50;100
1601;0;Cel. Aparício Borges;Arquipélago;50;0;0;0;50;0
1602;0;Cel. Aparício Borges;Auxiliadora;76;0;60;8;50;26
1603;0;Cel. Aparício Borges;Azenha;132;0;49;23;50;82
1604;0;Cel. Aparício Borges;Bela Vista;150;50;29;4;100;50
1605;0;Cel. Aparício Borges;Belém Novo;100;0;30;8;50;50
1606;0;Cel. Aparício Borges;Belém Velho;108;50;5;1;100;8
1607;0;Cel. Aparício Borges;Boa Vista;0;0;0;0;0;0
1608;0;Cel. Aparício Borges;Boa Vista do Sul;50;0;23;7;0;50
1609;0;Cel. Aparício Borges;Bom Fim;53;0;3;0;50;3
1610;0;Cel. Aparício Borges;Bom Jesus;306;100;153;22;150;156
1611;0;Cel. Aparício Borges;Camaquã;150;50;31;5;100;50
1612;0;Cel. Aparício Borges;Campo Novo;151;50;34;3;100;51
1613;0;Cel. Aparício Borges;Cascata;1105;400;262;60;650;455
1614;0;Cel. Aparício Borges;Cavalhada;72;50;13;4;50;22
1615;0;Cel. Aparício Borges;Cel. Aparício Borges;8312;400;4122;1079;1000;7312
1616;0;Cel. Aparício Borges;Centro Histórico;152;0;108;21;50;102
1617;0;Cel. Aparício Borges;Chapéu do Sol;153;50;33;6;100;53
1618;0;Cel. Aparício Borges;Chácara das Pedras;76;50;10;11;50;26
1619;0;Cel. Aparício Borges;Cidade Baixa;150;50;38;5;100;50
1620;0;Cel. Aparício Borges;Costa e Silva;203;50;63;13;100;103
1621;0;Cel. Aparício Borges;Cristal;171;50;76;27;50;121
1622;0;Cel. Aparício Borges;Cristo Redentor;59;50;7;1;50;9
1623;0;Cel. Aparício Borges;Espírito Santo;50;50;0;0;50;0
1624;0;Cel. Aparício Borges;Extrema;100;0;56;14;0;100
1625;0;Cel. Aparício Borges;Farrapos;19779;6065;7992;2464;2823;12378
1626;0;Cel. Aparício Borges;Farroupilha;100;0;31;4;50;50
1627;0;Cel. Aparício Borges;Floresta;0;0;0;0;0;0
1628;0;Cel. Aparício Borges;Glória;2888;200;1367;421;650;2238
1629;0;Cel. Aparício Borges;Guarujá;100;0;24;8;50;50
1630;0;Cel. Aparício Borges;Higienópolis;50;0;31;6;0;50
1631;0;Cel. Aparício Borges;Humaitá;26;0;14;7;0;26
1632;0;Cel. Aparício Borges;Hípica;128;50;15;5;100;28
1633;0;Cel. Aparício Borges;Independência;45;0;22;15;0;45
1634;0;Cel. Aparício Borges;Ipanema;100;0;58;16;0;100
1635;0;Cel. Aparício Borges;Jardim Botânico;973;250;197;42;650;323
1636;0;Cel. Aparício Borges;Jardim Carvalho;435;150;142;41;200;235
1637;0;Cel. Aparício Borges;Jardim Europa;0;0;0;0;0;0
1638;0;Cel. Aparício Borges;Jardim Floresta;50;0;28;4;0;50
1639;0;Cel. Aparício Borges;Jardim Isabel;138;0;53;19;50;88
1640;0;Cel. Aparício Borges;Jardim Itú;288;50;82;35;150;138
1641;0;Cel. Aparício Borges;Jardim Leopoldina;76;0;40;14;0;76
1642;0;Cel. Aparício Borges;Jardim Lindóia;50;0;0;0;50;0
1643;0;Cel. Aparício Borges;Jardim Sabará;82;50;21;7;50;32
1644;0;Cel. Aparício Borges;Jardim São Pedro;100;100;0;0;100;0
1645;0;Cel. Aparício Borges;Jardim do Salso;626;100;317;74;100;526
1646;0;Cel. Aparício Borges;Lageado;50;50;0;0;50;0
1647;0;Cel. Aparício Borges;Lami;150;0;80;9;100;50
1648;0;Cel. Aparício Borges;Lomba do Pinheiro;500;100;148;32;250;250
1649;0;Cel. Aparício Borges;Medianeira;450;0;212;52;150;300
1650;0;Cel. Aparício Borges;Menino Deus;64;0;36;11;0;64
1651;0;Cel. Aparício Borges;Moinhos de Vento;145;0;103;17;50;95
1652;0;Cel. Aparício Borges;Mont'Serrat;50;0;0;0;50;0
1653;0;Cel. Aparício Borges;Morro Santana;109;50;30;14;50;59
1654;0;Cel. Aparício Borges;Mário Quintana;213;0;92;24;50;163
1655;0;Cel. Aparício Borges;Navegantes;0;0;0;0;0;0
1656;0;Cel. Aparício Borges;Nonoai;176;0;97;18;0;176
1657;0;Cel. Aparício Borges;Parque Santa Fé;100;50;25;11;50;50
1658;0;Cel. Aparício Borges;Partenon;1028;100;507;153;150;878
1659;0;Cel. Aparício Borges;Passo D'Areia;239;50;72;37;100;139
1660;0;Cel. Aparício Borges;Passo das Pedras;6;0;5;1;0;6
1661;0;Cel. Aparício Borges;Pedra Redonda;0;0;0;0;0;0
1662;0;Cel. Aparício Borges;Petrópolis;397;150;115;44;200;197
1663;0;Cel. Aparício Borges;Pitinga;0;0;0;0;0;0
1664;0;Cel. Aparício Borges;Ponta Grossa;50;0;34;9;0;50
1665;0;Cel. Aparício Borges;Praia de Belas;50;0;31;7;0;50
1666;0;Cel. Aparício Borges;Restinga;147;100;27;11;100;47
1667;0;Cel. Aparício Borges;Rio Branco;214;50;61;27;100;114
1668;0;Cel. Aparício Borges;Rubem Berta;200;100;57;10;100;100
1669;0;Cel. Aparício Borges;Santa Cecília;76;50;10;12;50;26
1670;0;Cel. Aparício Borges;Santa Maria Goretti;50;50;0;0;50;0
1671;0;Cel. Aparício Borges;Santa Rosa de Lima;28;0;20;4;0;28
1672;0;Cel. Aparício Borges;Santa Tereza;1037;0;569;199;0;1037
1673;0;Cel. Aparício Borges;Santana;153;50;58;27;50;103
1674;0;Cel. Aparício Borges;Santo Antônio;198;0;88;34;50;148
1675;0;Cel. Aparício Borges;Sarandi;60;0;34;15;0;60
1676;0;Cel. Aparício Borges;Serraria;45;0;24;11;0;45
1677;0;Cel. Aparício Borges;São Caetano;50;0;0;0;50;0
1678;0;Cel. Aparício Borges;São Geraldo;0;0;0;0;0;0
1679;0;Cel. Aparício Borges;São José;1600;650;235;35;1350;250
1680;0;Cel. Aparício Borges;São João;3;0;1;1;0;3
1681;0;Cel. Aparício Borges;São Sebastião;50;50;0;0;50;0
1682;0;Cel. Aparício Borges;Sétimo Céu;50;0;26;6;0;50
1683;0;Cel. Aparício Borges;Teresópolis;224;50;70;25;100;124
1684;0;Cel. Aparício Borges;Tristeza;56;50;4;2;50;6
1685;0;Cel. Aparício Borges;Três Figueiras;76;0;50;9;0;76
1686;0;Cel. Aparício Borges;Vila Assunção;50;50;0;0;50;0
1687;0;Cel. Aparício Borges;Vila Conceição;0;0;0;0;0;0
1688;0;Cel. Aparício Borges;Vila Ipiranga;50;50;0;0;50;0
1689;0;Cel. Aparício Borges;Vila Jardim;100;0;27;9;50;50
1690;0;Cel. Aparício Borges;Vila João Pessoa;3530;700;1264;281;1582;1948
1691;0;Cel. Aparício Borges;Vila Nova;476;100;175;55;250;226
1692;0;Centro Histórico;Aberta dos Morros;100;0;60;25;0;100
1693;0;Centro Histórico;Agronomia;0;0;0;0;0;0
1694;0;Centro Histórico;Anchieta;50;0;23;8;0;50
1695;0;Centro Histórico;Arquipélago;460;100;209;55;100;360
1696;0;Centro Histórico;Auxiliadora;554;50;79;31;400;154
1697;0;Centro Histórico;Azenha;401;150;89;35;250;151
1698;0;Centro Histórico;Bela Vista;605;0;178;80;250;355
1699;0;Centro Histórico;Belém Novo;100;0;22;9;50;50
1700;0;Centro Histórico;Belém Velho;66;0;15;1;50;16
1701;0;Centro Histórico;Boa Vista;377;0;161;78;50;327
1702;0;Centro Histórico;Boa Vista do Sul;100;0;71;10;50;50
1703;0;Centro Histórico;Bom Fim;2100;300;576;288;1050;1050
1704;0;Centro Histórico;Bom Jesus;379;50;101;34;200;179
1705;0;Centro Histórico;Camaquã;107;0;48;20;0;107
1706;0;Centro Histórico;Campo Novo;100;0;0;0;100;0
1707;0;Centro Histórico;Cascata;100;100;0;0;100;0
1708;0;Centro Histórico;Cavalhada;151;50;26;12;100;51
1709;0;Centro Histórico;Cel. Aparício Borges;323;0;198;64;50;273
1710;0;Centro Histórico;Centro Histórico;16105;4300;1202;421;14600;1505
1711;0;Centro Histórico;Chapéu do Sol;300;50;78;40;150;150
1712;0;Centro Histórico;Chácara das Pedras;100;50;20;10;50;50
1713;0;Centro Histórico;Cidade Baixa;2405;250;817;371;850;1555
1714;0;Centro Histórico;Costa e Silva;215;100;58;23;100;115
1715;0;Centro Histórico;Cristal;136;0;75;26;0;136
1716;0;Centro Histórico;Cristo Redentor;264;100;56;34;150;114
1717;0;Centro Histórico;Espírito Santo;300;0;176;91;0;300
1718;0;Centro Histórico;Extrema;100;0;65;24;0;100
1719;0;Centro Histórico;Farrapos;3166;50;1740;651;100;3066
1720;0;Centro Histórico;Farroupilha;11250;200;5604;2493;950;10300
1721;0;Centro Histórico;Floresta;787;200;199;87;500;287
1722;0;Centro Histórico;Glória;253;0;137;59;0;253
1723;0;Centro Histórico;Guarujá;50;0;23;15;0;50
1724;0;Centro Histórico;Higienópolis;604;50;191;85;250;354
1725;0;Centro Histórico;Humaitá;100;50;34;13;50;50
1726;0;Centro Histórico;Hípica;76;0;20;3;50;26
1727;0;Centro Histórico;Independência;2500;300;745;335;1200;1300
1728;0;Centro Histórico;Ipanema;166;0;61;24;50;116
1729;0;Centro Histórico;Jardim Botânico;335;0;185;82;0;335
1730;0;Centro Histórico;Jardim Carvalho;129;0;42;16;50;79
1731;0;Centro Histórico;Jardim Europa;200;0;29;11;150;50
1732;0;Centro Histórico;Jardim Floresta;0;0;0;0;0;0
1733;0;Centro Histórico;Jardim Isabel;0;0;0;0;0;0
1734;0;Centro Histórico;Jardim Itú;52;0;33;15;0;52
1735;0;Centro Histórico;Jardim Leopoldina;112;0;61;20;0;112
1736;0;Centro Histórico;Jardim Lindóia;125;0;86;18;50;75
1737;0;Centro Histórico;Jardim Sabará;252;50;49;23;150;102
1738;0;Centro Histórico;Jardim São Pedro;50;0;36;11;0;50
1739;0;Centro Histórico;Jardim do Salso;175;50;37;14;100;75
1740;0;Centro Histórico;Lageado;350;150;55;22;250;100
1741;0;Centro Histórico;Lami;50;0;25;11;0;50
1742;0;Centro Histórico;Lomba do Pinheiro;72;50;14;2;50;22
1743;0;Centro Histórico;Medianeira;525;150;103;52;300;225
1744;0;Centro Histórico;Menino Deus;1730;550;397;140;1250;480
1745;0;Centro Histórico;Moinhos de Vento;1827;150;841;404;300;1527
1746;0;Centro Histórico;Mont'Serrat;703;0;255;97;300;403
1747;0;Centro Histórico;Morro Santana;372;50;139;27;200;172
1748;0;Centro Histórico;Mário Quintana;133;0;46;13;50;83
1749;0;Centro Histórico;Navegantes;350;50;159;76;50;300
1750;0;Centro Histórico;Nonoai;230;50;68;36;100;130
1751;0;Centro Histórico;Parque Santa Fé;200;100;26;10;150;50
1752;0;Centro Histórico;Partenon;378;0;134;72;100;278
1753;0;Centro Histórico;Passo D'Areia;617;0;261;131;150;467
1754;0;Centro Histórico;Passo das Pedras;216;100;39;19;150;66
1755;0;Centro Histórico;Pedra Redonda;100;50;0;0;100;0
1756;0;Centro Histórico;Petrópolis;535;0;130;60;300;235
1757;0;Centro Histórico;Pitinga;50;0;0;0;50;0
1758;0;Centro Histórico;Ponta Grossa;120;0;12;4;100;20
1759;0;Centro Histórico;Praia de Belas;950;150;285;142;400;550
1760;0;Centro Histórico;Restinga;71;0;14;4;50;21
1761;0;Centro Histórico;Rio Branco;1865;150;897;375;250;1615
1762;0;Centro Histórico;Rubem Berta;154;100;35;13;100;54
1763;0;Centro Histórico;Santa Cecília;500;100;122;59;250;250
1764;0;Centro Histórico;Santa Maria Goretti;200;50;64;20;100;100
1765;0;Centro Histórico;Santa Rosa de Lima;3;0;1;1;0;3
1766;0;Centro Histórico;Santa Tereza;601;50;241;91;250;351
1767;0;Centro Histórico;Santana;716;0;223;124;250;466
1768;0;Centro Histórico;Santo Antônio;303;100;80;37;150;153
1769;0;Centro Histórico;Sarandi;193;0;54;27;100;93
1770;0;Centro Histórico;Serraria;0;0;0;0;0;0
1771;0;Centro Histórico;São Caetano;300;0;172;79;0;300
1772;0;Centro Histórico;São Geraldo;425;0;13;6;400;25
1773;0;Centro Histórico;São José;89;0;24;6;50;39
1774;0;Centro Histórico;São João;400;100;58;33;300;100
1775;0;Centro Histórico;São Sebastião;170;50;64;26;50;120
1776;0;Centro Histórico;Sétimo Céu;50;50;0;0;50;0
1777;0;Centro Histórico;Teresópolis;50;50;0;0;50;0
1778;0;Centro Histórico;Tristeza;68;0;31;16;0;68
1779;0;Centro Histórico;Três Figueiras;500;50;226;102;100;400
1780;0;Centro Histórico;Vila Assunção;250;0;52;31;150;100
1781;0;Centro Histórico;Vila Conceição;94;50;23;13;50;44
1782;0;Centro Histórico;Vila Ipiranga;279;50;84;43;100;179
1783;0;Centro Histórico;Vila Jardim;184;50;70;35;50;134
1784;0;Centro Histórico;Vila João Pessoa;101;0;27;14;50;51
1785;0;Centro Histórico;Vila Nova;296;50;118;41;150;146
1786;0;Chapéu do Sol;Aberta dos Morros;50;0;28;11;0;50
1787;0;Chapéu do Sol;Agronomia;50;0;0;0;50;0
1788;0;Chapéu do Sol;Anchieta;0;0;0;0;0;0
1789;0;Chapéu do Sol;Arquipélago;0;0;0;0;0;0
1790;0;Chapéu do Sol;Auxiliadora;54;50;2;2;50;4
1791;0;Chapéu do Sol;Azenha;200;50;26;12;150;50
1792;0;Chapéu do Sol;Bela Vista;54;50;4;0;50;4
1793;0;Chapéu do Sol;Belém Novo;250;0;166;36;50;200
1794;0;Chapéu do Sol;Belém Velho;103;0;30;8;50;53
1795;0;Chapéu do Sol;Boa Vista;0;0;0;0;0;0
1796;0;Chapéu do Sol;Boa Vista do Sul;50;0;25;11;0;50
1797;0;Chapéu do Sol;Bom Fim;100;50;37;11;50;50
1798;0;Chapéu do Sol;Bom Jesus;53;0;32;3;0;53
1799;0;Chapéu do Sol;Camaquã;4;0;3;0;0;4
1800;0;Chapéu do Sol;Campo Novo;50;0;0;0;50;0
1801;0;Chapéu do Sol;Cascata;100;0;72;12;0;100
1802;0;Chapéu do Sol;Cavalhada;104;50;3;1;100;4
1803;0;Chapéu do Sol;Cel. Aparício Borges;203;50;64;14;100;103
1804;0;Chapéu do Sol;Centro Histórico;304;50;81;41;150;154
1805;0;Chapéu do Sol;Chapéu do Sol;1000;0;422;68;500;500
1806;0;Chapéu do Sol;Chácara das Pedras;0;0;0;0;0;0
1807;0;Chapéu do Sol;Cidade Baixa;5;0;0;2;0;5
1808;0;Chapéu do Sol;Costa e Silva;55;50;5;0;50;5
1809;0;Chapéu do Sol;Cristal;54;50;2;0;50;4
1810;0;Chapéu do Sol;Cristo Redentor;5;0;3;2;0;5
1811;0;Chapéu do Sol;Espírito Santo;50;0;33;12;0;50
1812;0;Chapéu do Sol;Extrema;100;0;64;16;0;100
1813;0;Chapéu do Sol;Farrapos;1932;1101;564;134;419;823
1814;0;Chapéu do Sol;Farroupilha;50;0;28;19;0;50
1815;0;Chapéu do Sol;Floresta;50;0;28;16;0;50
1816;0;Chapéu do Sol;Glória;51;0;31;13;0;51
1817;0;Chapéu do Sol;Guarujá;0;0;0;0;0;0
1818;0;Chapéu do Sol;Higienópolis;101;0;23;20;50;51
1819;0;Chapéu do Sol;Humaitá;50;0;27;8;0;50
1820;0;Chapéu do Sol;Hípica;4852;1350;1625;363;2350;2502
1821;0;Chapéu do Sol;Independência;100;0;52;20;0;100
1822;0;Chapéu do Sol;Ipanema;54;50;3;0;50;4
1823;0;Chapéu do Sol;Jardim Botânico;154;100;28;14;100;54
1824;0;Chapéu do Sol;Jardim Carvalho;101;0;54;14;0;101
1825;0;Chapéu do Sol;Jardim Europa;50;0;24;14;0;50
1826;0;Chapéu do Sol;Jardim Floresta;0;0;0;0;0;0
1827;0;Chapéu do Sol;Jardim Isabel;0;0;0;0;0;0
1828;0;Chapéu do Sol;Jardim Itú;101;50;35;13;50;51
1829;0;Chapéu do Sol;Jardim Leopoldina;3;0;2;0;0;3
1830;0;Chapéu do Sol;Jardim Lindóia;0;0;0;0;0;0
1831;0;Chapéu do Sol;Jardim Sabará;0;0;0;0;0;0
1832;0;Chapéu do Sol;Jardim São Pedro;0;0;0;0;0;0
1833;0;Chapéu do Sol;Jardim do Salso;0;0;0;0;0;0
1834;0;Chapéu do Sol;Lageado;100;50;33;14;50;50
1835;0;Chapéu do Sol;Lami;0;0;0;0;0;0
1836;0;Chapéu do Sol;Lomba do Pinheiro;304;0;83;21;150;154
1837;0;Chapéu do Sol;Medianeira;0;0;0;0;0;0
1838;0;Chapéu do Sol;Menino Deus;4;0;3;0;0;4
1839;0;Chapéu do Sol;Moinhos de Vento;100;50;29;12;50;50
1840;0;Chapéu do Sol;Mont'Serrat;52;0;25;20;0;52
1841;0;Chapéu do Sol;Morro Santana;105;50;30;11;50;55
1842;0;Chapéu do Sol;Mário Quintana;155;50;33;7;100;55
1843;0;Chapéu do Sol;Navegantes;0;0;0;0;0;0
1844;0;Chapéu do Sol;Nonoai;105;0;50;24;0;105
1845;0;Chapéu do Sol;Parque Santa Fé;100;50;37;5;50;50
1846;0;Chapéu do Sol;Partenon;154;100;30;10;100;54
1847;0;Chapéu do Sol;Passo D'Areia;53;0;20;20;0;53
1848;0;Chapéu do Sol;Passo das Pedras;4;0;3;1;0;4
1849;0;Chapéu do Sol;Pedra Redonda;0;0;0;0;0;0
1850;0;Chapéu do Sol;Petrópolis;203;0;132;42;0;203
1851;0;Chapéu do Sol;Pitinga;200;50;78;27;50;150
1852;0;Chapéu do Sol;Ponta Grossa;100;0;36;5;50;50
1853;0;Chapéu do Sol;Praia de Belas;0;0;0;0;0;0
1854;0;Chapéu do Sol;Restinga;4954;300;2573;692;600;4354
1855;0;Chapéu do Sol;Rio Branco;5;0;3;1;0;5
1856;0;Chapéu do Sol;Rubem Berta;204;0;96;70;0;204
1857;0;Chapéu do Sol;Santa Cecília;100;50;22;14;50;50
1858;0;Chapéu do Sol;Santa Maria Goretti;50;0;29;0;0;50
1859;0;Chapéu do Sol;Santa Rosa de Lima;51;0;36;5;0;51
1860;0;Chapéu do Sol;Santa Tereza;355;100;138;28;200;155
1861;0;Chapéu do Sol;Santana;153;0;82;35;0;153
1862;0;Chapéu do Sol;Santo Antônio;0;0;0;0;0;0
1863;0;Chapéu do Sol;Sarandi;105;0;62;26;0;105
1864;0;Chapéu do Sol;Serraria;150;0;64;19;50;100
1865;0;Chapéu do Sol;São Caetano;100;50;0;0;100;0
1866;0;Chapéu do Sol;São Geraldo;0;0;0;0;0;0
1867;0;Chapéu do Sol;São José;4;0;1;3;0;4
1868;0;Chapéu do Sol;São João;50;0;29;12;0;50
1869;0;Chapéu do Sol;São Sebastião;0;0;0;0;0;0
1870;0;Chapéu do Sol;Sétimo Céu;0;0;0;0;0;0
1871;0;Chapéu do Sol;Teresópolis;50;0;0;0;50;0
1872;0;Chapéu do Sol;Tristeza;103;0;57;22;0;103
1873;0;Chapéu do Sol;Três Figueiras;50;0;23;12;0;50
1874;0;Chapéu do Sol;Vila Assunção;0;0;0;0;0;0
1875;0;Chapéu do Sol;Vila Conceição;0;0;0;0;0;0
1876;0;Chapéu do Sol;Vila Ipiranga;0;0;0;0;0;0
1877;0;Chapéu do Sol;Vila Jardim;4;0;3;1;0;4
1878;0;Chapéu do Sol;Vila João Pessoa;0;0;0;0;0;0
1879;0;Chapéu do Sol;Vila Nova;55;0;30;6;0;55
1880;0;Chácara das Pedras;Aberta dos Morros;100;50;0;0;100;0
1881;0;Chácara das Pedras;Agronomia;0;0;0;0;0;0
1882;0;Chácara das Pedras;Anchieta;0;0;0;0;0;0
1883;0;Chácara das Pedras;Arquipélago;0;0;0;0;0;0
1884;0;Chácara das Pedras;Auxiliadora;207;0;109;70;0;207
1885;0;Chácara das Pedras;Azenha;51;0;31;10;0;51
1886;0;Chácara das Pedras;Bela Vista;58;0;29;16;0;58
1887;0;Chácara das Pedras;Belém Novo;0;0;0;0;0;0
1888;0;Chácara das Pedras;Belém Velho;6;0;4;1;0;6
1889;0;Chácara das Pedras;Boa Vista;255;50;89;36;100;155
1890;0;Chácara das Pedras;Boa Vista do Sul;0;0;0;0;0;0
1891;0;Chácara das Pedras;Bom Fim;150;0;54;30;50;100
1892;0;Chácara das Pedras;Bom Jesus;2256;150;1155;338;249;2007
1893;0;Chácara das Pedras;Camaquã;56;0;2;0;50;6
1894;0;Chácara das Pedras;Campo Novo;100;0;56;24;0;100
1895;0;Chácara das Pedras;Cascata;100;0;27;6;50;50
1896;0;Chácara das Pedras;Cavalhada;13;0;7;2;0;13
1897;0;Chácara das Pedras;Cel. Aparício Borges;111;47;26;22;47;64
1898;0;Chácara das Pedras;Centro Histórico;106;47;24;13;47;59
1899;0;Chácara das Pedras;Chapéu do Sol;0;0;0;0;0;0
1900;0;Chácara das Pedras;Chácara das Pedras;3800;100;2024;998;100;3700
1901;0;Chácara das Pedras;Cidade Baixa;109;0;54;30;0;109
1902;0;Chácara das Pedras;Costa e Silva;60;0;36;13;0;60
1903;0;Chácara das Pedras;Cristal;115;0;42;8;50;65
1904;0;Chácara das Pedras;Cristo Redentor;260;47;91;38;97;163
1905;0;Chácara das Pedras;Espírito Santo;0;0;0;0;0;0
1906;0;Chácara das Pedras;Extrema;50;0;23;12;0;50
1907;0;Chácara das Pedras;Farrapos;325;60;24;0;325;0
1908;0;Chácara das Pedras;Farroupilha;0;0;0;0;0;0
1909;0;Chácara das Pedras;Floresta;50;0;32;13;0;50
1910;0;Chácara das Pedras;Glória;100;47;25;14;47;53
1911;0;Chácara das Pedras;Guarujá;0;0;0;0;0;0
1912;0;Chácara das Pedras;Higienópolis;5;0;3;2;0;5
1913;0;Chácara das Pedras;Humaitá;150;0;89;29;0;150
1914;0;Chácara das Pedras;Hípica;101;0;72;21;0;101
1915;0;Chácara das Pedras;Independência;150;0;62;49;0;150
1916;0;Chácara das Pedras;Ipanema;7;0;4;0;0;7
1917;0;Chácara das Pedras;Jardim Botânico;406;97;163;81;97;309
1918;0;Chácara das Pedras;Jardim Carvalho;305;0;202;66;0;305
1919;0;Chácara das Pedras;Jardim Europa;536;386;92;40;386;150
1920;0;Chácara das Pedras;Jardim Floresta;100;0;63;22;0;100
1921;0;Chácara das Pedras;Jardim Isabel;0;0;0;0;0;0
1922;0;Chácara das Pedras;Jardim Itú;148;47;64;15;47;101
1923;0;Chácara das Pedras;Jardim Leopoldina;406;0;257;76;0;406
1924;0;Chácara das Pedras;Jardim Lindóia;150;50;62;16;50;100
1925;0;Chácara das Pedras;Jardim Sabará;900;0;489;220;0;900
1926;0;Chácara das Pedras;Jardim São Pedro;150;100;27;14;100;50
1927;0;Chácara das Pedras;Jardim do Salso;200;50;82;39;50;150
1928;0;Chácara das Pedras;Lageado;50;0;31;11;0;50
1929;0;Chácara das Pedras;Lami;150;50;53;34;50;100
1930;0;Chácara das Pedras;Lomba do Pinheiro;204;50;31;6;146;58
1931;0;Chácara das Pedras;Medianeira;50;0;26;15;0;50
1932;0;Chácara das Pedras;Menino Deus;240;0;134;55;25;215
1933;0;Chácara das Pedras;Moinhos de Vento;100;0;0;0;100;0
1934;0;Chácara das Pedras;Mont'Serrat;228;48;25;17;173;55
1935;0;Chácara das Pedras;Morro Santana;262;0;139;56;0;262
1936;0;Chácara das Pedras;Mário Quintana;200;0;117;38;0;200
1937;0;Chácara das Pedras;Navegantes;47;47;0;0;47;0
1938;0;Chácara das Pedras;Nonoai;153;47;63;21;47;106
1939;0;Chácara das Pedras;Parque Santa Fé;100;0;67;18;0;100
1940;0;Chácara das Pedras;Partenon;281;48;74;19;170;111
1941;0;Chácara das Pedras;Passo D'Areia;301;144;21;22;236;65
1942;0;Chácara das Pedras;Passo das Pedras;62;0;31;18;0;62
1943;0;Chácara das Pedras;Pedra Redonda;0;0;0;0;0;0
1944;0;Chácara das Pedras;Petrópolis;757;49;284;116;342;415
1945;0;Chácara das Pedras;Pitinga;0;0;0;0;0;0
1946;0;Chácara das Pedras;Ponta Grossa;50;0;33;14;0;50
1947;0;Chácara das Pedras;Praia de Belas;100;0;24;14;50;50
1948;0;Chácara das Pedras;Restinga;116;0;64;27;0;116
1949;0;Chácara das Pedras;Rio Branco;334;50;101;67;126;208
1950;0;Chácara das Pedras;Rubem Berta;56;0;27;15;0;56
1951;0;Chácara das Pedras;Santa Cecília;200;50;80;51;50;150
1952;0;Chácara das Pedras;Santa Maria Goretti;50;50;0;0;50;0
1953;0;Chácara das Pedras;Santa Rosa de Lima;156;0;86;31;0;156
1954;0;Chácara das Pedras;Santa Tereza;66;0;34;19;0;66
1955;0;Chácara das Pedras;Santana;157;0;87;44;0;157
1956;0;Chácara das Pedras;Santo Antônio;55;0;25;14;0;55
1957;0;Chácara das Pedras;Sarandi;444;97;134;64;196;248
1958;0;Chácara das Pedras;Serraria;0;0;0;0;0;0
1959;0;Chácara das Pedras;São Caetano;0;0;0;0;0;0
1960;0;Chácara das Pedras;São Geraldo;100;0;52;22;0;100
1961;0;Chácara das Pedras;São José;158;0;101;31;0;158
1962;0;Chácara das Pedras;São João;0;0;0;0;0;0
1963;0;Chácara das Pedras;São Sebastião;200;0;94;28;50;150
1964;0;Chácara das Pedras;Sétimo Céu;0;0;0;0;0;0
1965;0;Chácara das Pedras;Teresópolis;0;0;0;0;0;0
1966;0;Chácara das Pedras;Tristeza;7;0;4;3;0;7
1967;0;Chácara das Pedras;Três Figueiras;515;143;139;60;315;200
1968;0;Chácara das Pedras;Vila Assunção;50;0;26;14;0;50
1969;0;Chácara das Pedras;Vila Conceição;50;0;24;12;0;50
1970;0;Chácara das Pedras;Vila Ipiranga;440;100;26;18;386;54
1971;0;Chácara das Pedras;Vila Jardim;1708;749;423;187;1049;659
1972;0;Chácara das Pedras;Vila João Pessoa;101;0;61;24;0;101
1973;0;Chácara das Pedras;Vila Nova;50;0;35;4;0;50
1974;0;Cidade Baixa;Aberta dos Morros;12;0;7;2;0;12
1975;0;Cidade Baixa;Agronomia;0;0;0;0;0;0
1976;0;Cidade Baixa;Anchieta;150;0;74;36;0;150
1977;0;Cidade Baixa;Arquipélago;224;100;47;18;148;76
1978;0;Cidade Baixa;Auxiliadora;153;0;62;27;50;103
1979;0;Cidade Baixa;Azenha;687;149;220;120;245;442
1980;0;Cidade Baixa;Bela Vista;497;50;160;36;300;197
1981;0;Cidade Baixa;Belém Novo;150;0;49;28;50;100
1982;0;Cidade Baixa;Belém Velho;25;0;19;4;0;25
1983;0;Cidade Baixa;Boa Vista;78;0;44;15;0;78
1984;0;Cidade Baixa;Boa Vista do Sul;150;50;46;13;50;100
1985;0;Cidade Baixa;Bom Fim;1386;50;583;279;200;1186
1986;0;Cidade Baixa;Bom Jesus;116;0;48;14;40;76
1987;0;Cidade Baixa;Camaquã;2;0;1;0;0;2
1988;0;Cidade Baixa;Campo Novo;0;0;0;0;0;0
1989;0;Cidade Baixa;Cascata;50;0;25;12;0;50
1990;0;Cidade Baixa;Cavalhada;27;0;15;10;0;27
1991;0;Cidade Baixa;Cel. Aparício Borges;141;50;31;4;100;41
1992;0;Cidade Baixa;Centro Histórico;1506;246;382;169;785;721
1993;0;Cidade Baixa;Chapéu do Sol;0;0;0;0;0;0
1994;0;Cidade Baixa;Chácara das Pedras;100;0;49;27;0;100
1995;0;Cidade Baixa;Cidade Baixa;6474;0;3212;1441;199;6275
1996;0;Cidade Baixa;Costa e Silva;120;50;31;16;50;70
1997;0;Cidade Baixa;Cristal;497;194;135;28;343;154
1998;0;Cidade Baixa;Cristo Redentor;14;0;7;3;0;14
1999;0;Cidade Baixa;Espírito Santo;100;0;49;26;0;100
2000;0;Cidade Baixa;Extrema;250;50;88;36;100;150
2001;0;Cidade Baixa;Farrapos;15054;111;7932;3916;387;14667
2002;0;Cidade Baixa;Farroupilha;2600;550;425;136;2000;600
2003;0;Cidade Baixa;Floresta;475;149;48;29;349;126
2004;0;Cidade Baixa;Glória;150;100;0;0;150;0
2005;0;Cidade Baixa;Guarujá;50;0;34;11;0;50
2006;0;Cidade Baixa;Higienópolis;103;50;2;0;100;3
2007;0;Cidade Baixa;Humaitá;50;0;0;0;50;0
2008;0;Cidade Baixa;Hípica;0;0;0;0;0;0
2009;0;Cidade Baixa;Independência;545;100;131;67;249;296
2010;0;Cidade Baixa;Ipanema;104;0;42;22;0;104
2011;0;Cidade Baixa;Jardim Botânico;134;0;89;16;50;84
2012;0;Cidade Baixa;Jardim Carvalho;53;0;29;16;0;53
2013;0;Cidade Baixa;Jardim Europa;26;0;17;4;0;26
2014;0;Cidade Baixa;Jardim Floresta;50;50;0;0;50;0
2015;0;Cidade Baixa;Jardim Isabel;0;0;0;0;0;0
2016;0;Cidade Baixa;Jardim Itú;47;0;34;7;0;47
2017;0;Cidade Baixa;Jardim Leopoldina;52;0;1;0;50;2
2018;0;Cidade Baixa;Jardim Lindóia;0;0;0;0;0;0
2019;0;Cidade Baixa;Jardim Sabará;45;0;23;12;0;45
2020;0;Cidade Baixa;Jardim São Pedro;50;0;27;9;0;50
2021;0;Cidade Baixa;Jardim do Salso;70;0;39;22;0;70
2022;0;Cidade Baixa;Lageado;50;0;30;14;0;50
2023;0;Cidade Baixa;Lami;0;0;0;0;0;0
2024;0;Cidade Baixa;Lomba do Pinheiro;52;0;35;7;0;52
2025;0;Cidade Baixa;Medianeira;430;100;166;53;200;230
2026;0;Cidade Baixa;Menino Deus;5981;859;2360;1175;1916;4065
2027;0;Cidade Baixa;Moinhos de Vento;290;0;95;52;90;200
2028;0;Cidade Baixa;Mont'Serrat;302;0;128;49;50;252
2029;0;Cidade Baixa;Morro Santana;78;0;17;6;50;28
2030;0;Cidade Baixa;Mário Quintana;215;50;115;21;100;115
2031;0;Cidade Baixa;Navegantes;201;50;59;27;100;101
2032;0;Cidade Baixa;Nonoai;103;0;3;0;100;3
2033;0;Cidade Baixa;Parque Santa Fé;176;0;10;7;150;26
2034;0;Cidade Baixa;Partenon;522;100;181;78;190;332
2035;0;Cidade Baixa;Passo D'Areia;121;0;61;31;0;121
2036;0;Cidade Baixa;Passo das Pedras;42;0;18;13;0;42
2037;0;Cidade Baixa;Pedra Redonda;0;0;0;0;0;0
2038;0;Cidade Baixa;Petrópolis;647;49;331;113;197;450
2039;0;Cidade Baixa;Pitinga;49;49;0;0;49;0
2040;0;Cidade Baixa;Ponta Grossa;0;0;0;0;0;0
2041;0;Cidade Baixa;Praia de Belas;1062;150;377;134;450;612
2042;0;Cidade Baixa;Restinga;133;49;47;11;49;84
2043;0;Cidade Baixa;Rio Branco;283;100;42;16;200;83
2044;0;Cidade Baixa;Rubem Berta;22;0;9;10;0;22
2045;0;Cidade Baixa;Santa Cecília;391;50;81;41;240;151
2046;0;Cidade Baixa;Santa Maria Goretti;0;0;0;0;0;0
2047;0;Cidade Baixa;Santa Rosa de Lima;50;0;31;10;0;50
2048;0;Cidade Baixa;Santa Tereza;297;50;101;51;100;197
2049;0;Cidade Baixa;Santana;2731;145;1280;708;325;2406
2050;0;Cidade Baixa;Santo Antônio;479;200;15;9;450;29
2051;0;Cidade Baixa;Sarandi;256;0;95;32;99;157
2052;0;Cidade Baixa;Serraria;0;0;0;0;0;0
2053;0;Cidade Baixa;São Caetano;50;0;26;11;0;50
2054;0;Cidade Baixa;São Geraldo;220;0;87;36;50;170
2055;0;Cidade Baixa;São José;56;0;27;19;0;56
2056;0;Cidade Baixa;São João;320;0;113;46;100;220
2057;0;Cidade Baixa;São Sebastião;70;0;45;16;0;70
2058;0;Cidade Baixa;Sétimo Céu;150;0;41;27;50;100
2059;0;Cidade Baixa;Teresópolis;76;50;14;6;50;26
2060;0;Cidade Baixa;Tristeza;38;0;26;6;0;38
2061;0;Cidade Baixa;Três Figueiras;150;0;23;11;100;50
2062;0;Cidade Baixa;Vila Assunção;76;0;39;13;0;76
2063;0;Cidade Baixa;Vila Conceição;50;0;24;12;0;50
2064;0;Cidade Baixa;Vila Ipiranga;53;0;30;13;0;53
2065;0;Cidade Baixa;Vila Jardim;64;0;7;4;50;14
2066;0;Cidade Baixa;Vila João Pessoa;200;100;63;19;100;100
2067;0;Cidade Baixa;Vila Nova;94;0;23;12;50;44
2068;0;Costa e Silva;Aberta dos Morros;75;0;15;2;50;25
2069;0;Costa e Silva;Agronomia;50;0;36;6;0;50
2070;0;Costa e Silva;Anchieta;0;0;0;0;0;0
2071;0;Costa e Silva;Arquipélago;50;0;29;13;0;50
2072;0;Costa e Silva;Auxiliadora;76;50;16;7;50;26
2073;0;Costa e Silva;Azenha;37;0;12;18;0;37
2074;0;Costa e Silva;Bela Vista;51;0;34;7;0;51
2075;0;Costa e Silva;Belém Novo;0;0;0;0;0;0
2076;0;Costa e Silva;Belém Velho;158;50;83;16;50;108
2077;0;Costa e Silva;Boa Vista;176;50;80;14;50;126
2078;0;Costa e Silva;Boa Vista do Sul;0;0;0;0;0;0
2079;0;Costa e Silva;Bom Fim;50;0;31;7;0;50
2080;0;Costa e Silva;Bom Jesus;172;100;44;10;100;72
2081;0;Costa e Silva;Camaquã;1;0;1;0;0;1
2082;0;Costa e Silva;Campo Novo;50;50;0;0;50;0
2083;0;Costa e Silva;Cascata;75;0;56;12;0;75
2084;0;Costa e Silva;Cavalhada;19;0;14;4;0;19
2085;0;Costa e Silva;Cel. Aparício Borges;166;50;39;9;100;66
2086;0;Costa e Silva;Centro Histórico;156;100;20;15;100;56
2087;0;Costa e Silva;Chapéu do Sol;50;50;0;0;50;0
2088;0;Costa e Silva;Chácara das Pedras;25;0;15;6;0;25
2089;0;Costa e Silva;Cidade Baixa;126;50;42;10;50;76
2090;0;Costa e Silva;Costa e Silva;3129;600;862;165;1800;1329
2091;0;Costa e Silva;Cristal;95;50;26;11;50;45
2092;0;Costa e Silva;Cristo Redentor;237;50;85;26;100;137
2093;0;Costa e Silva;Espírito Santo;0;0;0;0;0;0
2094;0;Costa e Silva;Extrema;100;0;64;10;0;100
2095;0;Costa e Silva;Farrapos;15327;4888;6372;1915;2070;9500
2096;0;Costa e Silva;Farroupilha;100;0;65;14;0;100
2097;0;Costa e Silva;Floresta;0;0;0;0;0;0
2098;0;Costa e Silva;Glória;177;0;119;30;0;177
2099;0;Costa e Silva;Guarujá;0;0;0;0;0;0
2100;0;Costa e Silva;Higienópolis;151;0;67;16;50;101
2101;0;Costa e Silva;Humaitá;0;0;0;0;0;0
2102;0;Costa e Silva;Hípica;50;50;0;0;50;0
2103;0;Costa e Silva;Independência;50;0;35;9;0;50
2104;0;Costa e Silva;Ipanema;56;0;5;0;50;6
2105;0;Costa e Silva;Jardim Botânico;84;0;53;10;0;84
2106;0;Costa e Silva;Jardim Carvalho;126;50;11;3;100;26
2107;0;Costa e Silva;Jardim Europa;0;0;0;0;0;0
2108;0;Costa e Silva;Jardim Floresta;50;50;0;0;50;0
2109;0;Costa e Silva;Jardim Isabel;50;0;34;8;0;50
2110;0;Costa e Silva;Jardim Itú;427;100;105;12;350;77
2111;0;Costa e Silva;Jardim Leopoldina;3255;650;1146;277;1550;1705
2112;0;Costa e Silva;Jardim Lindóia;150;0;101;16;0;150
2113;0;Costa e Silva;Jardim Sabará;276;50;136;43;50;226
2114;0;Costa e Silva;Jardim São Pedro;200;100;73;7;100;100
2115;0;Costa e Silva;Jardim do Salso;0;0;0;0;0;0
2116;0;Costa e Silva;Lageado;125;50;47;14;50;75
2117;0;Costa e Silva;Lami;0;0;0;0;0;0
2118;0;Costa e Silva;Lomba do Pinheiro;105;0;57;15;0;105
2119;0;Costa e Silva;Medianeira;50;50;0;0;50;0
2120;0;Costa e Silva;Menino Deus;40;0;17;14;0;40
2121;0;Costa e Silva;Moinhos de Vento;75;0;12;9;50;25
2122;0;Costa e Silva;Mont'Serrat;26;0;18;5;0;26
2123;0;Costa e Silva;Morro Santana;105;50;39;8;50;55
2124;0;Costa e Silva;Mário Quintana;585;100;221;54;200;385
2125;0;Costa e Silva;Navegantes;50;0;50;0;50;0
2126;0;Costa e Silva;Nonoai;76;0;47;17;0;76
2127;0;Costa e Silva;Parque Santa Fé;3048;1100;739;161;1967;1081
2128;0;Costa e Silva;Partenon;83;0;52;14;0;83
2129;0;Costa e Silva;Passo D'Areia;315;50;178;38;50;265
2130;0;Costa e Silva;Passo das Pedras;1016;250;281;96;500;516
2131;0;Costa e Silva;Pedra Redonda;50;0;27;8;0;50
2132;0;Costa e Silva;Petrópolis;76;50;17;6;50;26
2133;0;Costa e Silva;Pitinga;150;0;86;23;0;150
2134;0;Costa e Silva;Ponta Grossa;100;0;60;12;0;100
2135;0;Costa e Silva;Praia de Belas;0;0;0;0;0;0
2136;0;Costa e Silva;Restinga;271;50;70;16;150;121
2137;0;Costa e Silva;Rio Branco;19;0;10;5;0;19
2138;0;Costa e Silva;Rubem Berta;1900;750;296;186;1350;550
2139;0;Costa e Silva;Santa Cecília;87;50;14;15;50;37
2140;0;Costa e Silva;Santa Maria Goretti;62;0;54;5;0;62
2141;0;Costa e Silva;Santa Rosa de Lima;1342;700;289;94;850;492
2142;0;Costa e Silva;Santa Tereza;177;0;18;3;150;27
2143;0;Costa e Silva;Santana;71;0;11;7;50;21
2144;0;Costa e Silva;Santo Antônio;101;50;35;7;50;51
2145;0;Costa e Silva;Sarandi;1104;250;360;112;500;604
2146;0;Costa e Silva;Serraria;87;0;21;5;50;37
2147;0;Costa e Silva;São Caetano;0;0;0;0;0;0
2148;0;Costa e Silva;São Geraldo;62;50;9;3;50;12
2149;0;Costa e Silva;São José;108;0;41;2;50;58
2150;0;Costa e Silva;São João;75;0;53;10;0;75
2151;0;Costa e Silva;São Sebastião;650;150;232;40;300;350
2152;0;Costa e Silva;Sétimo Céu;0;0;0;0;0;0
2153;0;Costa e Silva;Teresópolis;100;50;37;6;50;50
2154;0;Costa e Silva;Tristeza;60;0;38;10;0;60
2155;0;Costa e Silva;Três Figueiras;325;50;137;34;100;225
2156;0;Costa e Silva;Vila Assunção;100;50;0;0;100;0
2157;0;Costa e Silva;Vila Conceição;0;0;0;0;0;0
2158;0;Costa e Silva;Vila Ipiranga;401;150;152;24;150;251
2159;0;Costa e Silva;Vila Jardim;156;0;37;7;100;56
2160;0;Costa e Silva;Vila João Pessoa;150;100;0;0;150;0
2161;0;Costa e Silva;Vila Nova;220;50;67;17;100;120
2162;0;Cristal;Aberta dos Morros;125;50;33;19;50;75
2163;0;Cristal;Agronomia;50;0;0;0;50;0
2164;0;Cristal;Anchieta;100;50;26;14;50;50
2165;0;Cristal;Arquipélago;50;50;0;0;50;0
2166;0;Cristal;Auxiliadora;2;0;0;1;0;2
2167;0;Cristal;Azenha;152;50;56;28;50;102
2168;0;Cristal;Bela Vista;148;48;30;6;98;50
2169;0;Cristal;Belém Novo;50;0;27;12;0;50
2170;0;Cristal;Belém Velho;102;0;61;25;0;102
2171;0;Cristal;Boa Vista;100;0;29;12;50;50
2172;0;Cristal;Boa Vista do Sul;200;100;0;0;200;0
2173;0;Cristal;Bom Fim;225;100;71;27;100;125
2174;0;Cristal;Bom Jesus;63;0;10;5;34;29
2175;0;Cristal;Camaquã;3066;545;1232;395;944;2122
2176;0;Cristal;Campo Novo;100;0;57;24;0;100
2177;0;Cristal;Cascata;50;0;29;14;0;50
2178;0;Cristal;Cavalhada;9952;445;5369;1865;545;9407
2179;0;Cristal;Cel. Aparício Borges;120;50;43;17;50;70
2180;0;Cristal;Centro Histórico;225;0;132;41;0;225
2181;0;Cristal;Chapéu do Sol;50;50;0;0;50;0
2182;0;Cristal;Chácara das Pedras;100;0;34;6;50;50
2183;0;Cristal;Cidade Baixa;500;200;132;34;348;152
2184;0;Cristal;Costa e Silva;101;50;30;7;50;51
2185;0;Cristal;Cristal;5609;1471;1580;596;2755;2854
2186;0;Cristal;Cristo Redentor;282;48;109;36;98;184
2187;0;Cristal;Espírito Santo;162;0;96;33;0;162
2188;0;Cristal;Extrema;50;50;0;0;50;0
2189;0;Cristal;Farrapos;6128;117;3228;1254;444;5684
2190;0;Cristal;Farroupilha;200;0;25;11;150;50
2191;0;Cristal;Floresta;319;0;91;47;150;169
2192;0;Cristal;Glória;50;0;0;0;50;0
2193;0;Cristal;Guarujá;150;100;0;0;150;0
2194;0;Cristal;Higienópolis;198;50;0;0;198;0
2195;0;Cristal;Humaitá;75;0;48;15;0;75
2196;0;Cristal;Hípica;25;0;12;3;0;25
2197;0;Cristal;Independência;12;0;7;3;0;12
2198;0;Cristal;Ipanema;294;100;52;23;200;94
2199;0;Cristal;Jardim Botânico;262;0;63;36;148;114
2200;0;Cristal;Jardim Carvalho;50;0;33;9;0;50
2201;0;Cristal;Jardim Europa;150;0;59;23;50;100
2202;0;Cristal;Jardim Floresta;125;0;98;16;50;75
2203;0;Cristal;Jardim Isabel;400;50;187;76;50;350
2204;0;Cristal;Jardim Itú;236;0;113;34;50;186
2205;0;Cristal;Jardim Leopoldina;300;100;24;8;250;50
2206;0;Cristal;Jardim Lindóia;50;0;50;0;50;0
2207;0;Cristal;Jardim Sabará;50;0;29;10;0;50
2208;0;Cristal;Jardim São Pedro;0;0;0;0;0;0
2209;0;Cristal;Jardim do Salso;100;0;60;16;0;100
2210;0;Cristal;Lageado;150;0;110;14;50;100
2211;0;Cristal;Lami;50;0;29;9;0;50
2212;0;Cristal;Lomba do Pinheiro;19;0;9;4;0;19
2213;0;Cristal;Medianeira;448;248;54;15;348;100
2214;0;Cristal;Menino Deus;306;50;58;17;197;109
2215;0;Cristal;Moinhos de Vento;50;0;29;11;0;50
2216;0;Cristal;Mont'Serrat;19;0;9;6;0;19
2217;0;Cristal;Morro Santana;106;50;29;16;50;56
2218;0;Cristal;Mário Quintana;182;48;20;6;148;34
2219;0;Cristal;Navegantes;25;0;14;4;0;25
2220;0;Cristal;Nonoai;2000;744;268;97;1521;479
2221;0;Cristal;Parque Santa Fé;148;0;56;19;48;100
2222;0;Cristal;Partenon;128;0;94;17;50;78
2223;0;Cristal;Passo D'Areia;199;98;36;10;133;66
2224;0;Cristal;Passo das Pedras;144;50;40;11;85;59
2225;0;Cristal;Pedra Redonda;350;100;142;49;100;250
2226;0;Cristal;Petrópolis;276;50;128;63;50;226
2227;0;Cristal;Pitinga;100;50;0;0;100;0
2228;0;Cristal;Ponta Grossa;110;48;41;8;48;62
2229;0;Cristal;Praia de Belas;333;100;66;16;220;113
2230;0;Cristal;Restinga;138;0;20;6;100;38
2231;0;Cristal;Rio Branco;223;98;71;29;98;125
2232;0;Cristal;Rubem Berta;200;100;34;12;150;50
2233;0;Cristal;Santa Cecília;300;0;172;57;0;300
2234;0;Cristal;Santa Maria Goretti;100;0;77;10;50;50
2235;0;Cristal;Santa Rosa de Lima;50;0;31;7;0;50
2236;0;Cristal;Santa Tereza;4158;497;1925;684;782;3376
2237;0;Cristal;Santana;275;50;73;29;150;125
2238;0;Cristal;Santo Antônio;200;100;63;20;100;100
2239;0;Cristal;Sarandi;153;0;51;33;50;103
2240;0;Cristal;Serraria;162;0;101;28;0;162
2241;0;Cristal;São Caetano;250;150;54;24;150;100
2242;0;Cristal;São Geraldo;50;50;0;0;50;0
2243;0;Cristal;São José;100;50;0;0;100;0
2244;0;Cristal;São João;100;0;64;11;0;100
2245;0;Cristal;São Sebastião;25;0;12;4;0;25
2246;0;Cristal;Sétimo Céu;497;100;186;44;235;262
2247;0;Cristal;Teresópolis;912;50;333;83;350;562
2248;0;Cristal;Tristeza;1176;298;386;153;498;678
2249;0;Cristal;Três Figueiras;50;50;0;0;50;0
2250;0;Cristal;Vila Assunção;1149;397;218;49;942;207
2251;0;Cristal;Vila Conceição;200;100;58;20;100;100
2252;0;Cristal;Vila Ipiranga;50;50;0;0;50;0
2253;0;Cristal;Vila Jardim;60;0;12;5;35;25
2254;0;Cristal;Vila João Pessoa;0;0;0;0;0;0
2255;0;Cristal;Vila Nova;521;100;206;63;150;371
2256;0;Cristo Redentor;Aberta dos Morros;0;0;0;0;0;0
2257;0;Cristo Redentor;Agronomia;50;0;50;0;50;0
2258;0;Cristo Redentor;Anchieta;181;50;34;8;131;50
2259;0;Cristo Redentor;Arquipélago;200;50;80;44;50;150
2260;0;Cristo Redentor;Auxiliadora;302;0;151;54;50;252
2261;0;Cristo Redentor;Azenha;26;0;12;13;0;26
2262;0;Cristo Redentor;Bela Vista;330;0;102;41;150;180
2263;0;Cristo Redentor;Belém Novo;0;0;0;0;0;0
2264;0;Cristo Redentor;Belém Velho;106;0;68;27;0;106
2265;0;Cristo Redentor;Boa Vista;401;99;103;20;249;152
2266;0;Cristo Redentor;Boa Vista do Sul;0;0;0;0;0;0
2267;0;Cristo Redentor;Bom Fim;0;0;0;0;0;0
2268;0;Cristo Redentor;Bom Jesus;36;0;22;4;0;36
2269;0;Cristo Redentor;Camaquã;79;0;59;12;0;79
2270;0;Cristo Redentor;Campo Novo;0;0;0;0;0;0
2271;0;Cristo Redentor;Cascata;97;0;47;0;97;0
2272;0;Cristo Redentor;Cavalhada;124;0;51;14;47;77
2273;0;Cristo Redentor;Cel. Aparício Borges;70;50;10;3;50;20
2274;0;Cristo Redentor;Centro Histórico;277;99;64;29;149;128
2275;0;Cristo Redentor;Chapéu do Sol;0;0;0;0;0;0
2276;0;Cristo Redentor;Chácara das Pedras;226;50;69;30;100;126
2277;0;Cristo Redentor;Cidade Baixa;4;0;1;1;0;4
2278;0;Cristo Redentor;Costa e Silva;195;50;55;24;97;98
2279;0;Cristo Redentor;Cristal;268;50;105;37;97;171
2280;0;Cristo Redentor;Cristo Redentor;2550;96;1257;475;572;1978
2281;0;Cristo Redentor;Espírito Santo;50;0;33;15;0;50
2282;0;Cristo Redentor;Extrema;50;50;0;0;50;0
2283;0;Cristo Redentor;Farrapos;12969;2627;6079;2506;2496;6571
2284;0;Cristo Redentor;Farroupilha;100;50;29;12;50;50
2285;0;Cristo Redentor;Floresta;100;50;22;9;50;50
2286;0;Cristo Redentor;Glória;50;47;3;0;47;3
2287;0;Cristo Redentor;Guarujá;50;0;31;9;0;50
2288;0;Cristo Redentor;Higienópolis;369;97;153;57;97;272
2289;0;Cristo Redentor;Humaitá;20;0;7;2;0;20
2290;0;Cristo Redentor;Hípica;100;0;67;18;0;100
2291;0;Cristo Redentor;Independência;50;0;32;11;0;50
2292;0;Cristo Redentor;Ipanema;7;0;6;1;0;7
2293;0;Cristo Redentor;Jardim Botânico;11;0;5;3;0;11
2294;0;Cristo Redentor;Jardim Carvalho;2;0;1;1;0;2
2295;0;Cristo Redentor;Jardim Europa;429;195;61;18;326;103
2296;0;Cristo Redentor;Jardim Floresta;1744;147;817;302;447;1297
2297;0;Cristo Redentor;Jardim Isabel;0;0;0;0;0;0
2298;0;Cristo Redentor;Jardim Itú;171;97;17;5;144;27
2299;0;Cristo Redentor;Jardim Leopoldina;56;0;30;21;0;56
2300;0;Cristo Redentor;Jardim Lindóia;1272;100;569;226;300;972
2301;0;Cristo Redentor;Jardim Sabará;103;0;54;29;0;103
2302;0;Cristo Redentor;Jardim São Pedro;3697;1450;642;196;2780;917
2303;0;Cristo Redentor;Jardim do Salso;50;0;26;9;0;50
2304;0;Cristo Redentor;Lageado;100;0;60;24;0;100
2305;0;Cristo Redentor;Lami;50;0;25;12;0;50
2306;0;Cristo Redentor;Lomba do Pinheiro;83;0;42;15;0;83
2307;0;Cristo Redentor;Medianeira;100;0;29;11;50;50
2308;0;Cristo Redentor;Menino Deus;121;0;74;28;0;121
2309;0;Cristo Redentor;Moinhos de Vento;100;50;31;8;50;50
2310;0;Cristo Redentor;Mont'Serrat;252;50;111;40;50;202
2311;0;Cristo Redentor;Morro Santana;217;0;72;24;100;117
2312;0;Cristo Redentor;Mário Quintana;73;0;45;5;0;73
2313;0;Cristo Redentor;Navegantes;103;50;3;0;100;3
2314;0;Cristo Redentor;Nonoai;115;0;66;22;0;115
2315;0;Cristo Redentor;Parque Santa Fé;100;0;55;26;0;100
2316;0;Cristo Redentor;Partenon;84;0;49;19;0;84
2317;0;Cristo Redentor;Passo D'Areia;965;99;323;138;378;587
2318;0;Cristo Redentor;Passo das Pedras;32;0;19;6;0;32
2319;0;Cristo Redentor;Pedra Redonda;0;0;0;0;0;0
2320;0;Cristo Redentor;Petrópolis;279;47;107;50;97;182
2321;0;Cristo Redentor;Pitinga;50;50;0;0;50;0
2322;0;Cristo Redentor;Ponta Grossa;50;0;0;0;50;0
2323;0;Cristo Redentor;Praia de Belas;50;0;28;15;0;50
2324;0;Cristo Redentor;Restinga;77;0;40;19;0;77
2325;0;Cristo Redentor;Rio Branco;81;47;21;11;47;34
2326;0;Cristo Redentor;Rubem Berta;52;0;2;0;50;2
2327;0;Cristo Redentor;Santa Cecília;0;0;0;0;0;0
2328;0;Cristo Redentor;Santa Maria Goretti;1600;50;871;326;150;1450
2329;0;Cristo Redentor;Santa Rosa de Lima;155;50;81;12;99;56
2330;0;Cristo Redentor;Santa Tereza;48;0;28;6;0;48
2331;0;Cristo Redentor;Santana;83;50;17;7;50;33
2332;0;Cristo Redentor;Santo Antônio;53;0;32;12;0;53
2333;0;Cristo Redentor;Sarandi;243;0;117;52;31;212
2334;0;Cristo Redentor;Serraria;20;0;15;1;0;20
2335;0;Cristo Redentor;São Caetano;50;0;27;16;0;50
2336;0;Cristo Redentor;São Geraldo;53;0;2;1;50;3
2337;0;Cristo Redentor;São José;58;0;25;14;0;58
2338;0;Cristo Redentor;São João;450;0;228;74;100;350
2339;0;Cristo Redentor;São Sebastião;489;194;148;50;244;245
2340;0;Cristo Redentor;Sétimo Céu;0;0;0;0;0;0
2341;0;Cristo Redentor;Teresópolis;120;50;36;17;50;70
2342;0;Cristo Redentor;Tristeza;37;0;24;8;0;37
2343;0;Cristo Redentor;Três Figueiras;400;50;158;73;100;300
2344;0;Cristo Redentor;Vila Assunção;70;50;15;5;50;20
2345;0;Cristo Redentor;Vila Conceição;0;0;0;0;0;0
2346;0;Cristo Redentor;Vila Ipiranga;2183;814;404;167;1483;700
2347;0;Cristo Redentor;Vila Jardim;503;150;175;72;181;322
2348;0;Cristo Redentor;Vila João Pessoa;47;47;0;0;47;0
2349;0;Cristo Redentor;Vila Nova;187;50;49;19;100;87
2350;0;Espírito Santo;Aberta dos Morros;1892;750;250;47;1642;250
2351;0;Espírito Santo;Agronomia;100;0;48;24;0;100
2352;0;Espírito Santo;Anchieta;0;0;0;0;0;0
2353;0;Espírito Santo;Arquipélago;50;0;29;9;0;50
2354;0;Espírito Santo;Auxiliadora;100;50;0;0;100;0
2355;0;Espírito Santo;Azenha;50;0;0;0;50;0
2356;0;Espírito Santo;Bela Vista;50;0;27;15;0;50
2357;0;Espírito Santo;Belém Novo;150;50;66;20;50;100
2358;0;Espírito Santo;Belém Velho;155;0;1;4;150;5
2359;0;Espírito Santo;Boa Vista;150;0;108;24;50;100
2360;0;Espírito Santo;Boa Vista do Sul;50;50;0;0;50;0
2361;0;Espírito Santo;Bom Fim;100;0;18;17;50;50
2362;0;Espírito Santo;Bom Jesus;106;0;65;16;0;106
2363;0;Espírito Santo;Camaquã;150;50;52;22;50;100
2364;0;Espírito Santo;Campo Novo;450;50;236;84;50;400
2365;0;Espírito Santo;Cascata;0;0;0;0;0;0
2366;0;Espírito Santo;Cavalhada;1058;350;238;73;750;308
2367;0;Espírito Santo;Cel. Aparício Borges;58;50;4;1;50;8
2368;0;Espírito Santo;Centro Histórico;304;0;179;92;0;304
2369;0;Espírito Santo;Chapéu do Sol;50;0;33;12;0;50
2370;0;Espírito Santo;Chácara das Pedras;0;0;0;0;0;0
2371;0;Espírito Santo;Cidade Baixa;100;0;49;26;0;100
2372;0;Espírito Santo;Costa e Silva;6;0;4;0;0;6
2373;0;Espírito Santo;Cristal;208;0;118;47;0;208
2374;0;Espírito Santo;Cristo Redentor;58;0;36;18;0;58
2375;0;Espírito Santo;Espírito Santo;2700;0;1312;506;300;2400
2376;0;Espírito Santo;Extrema;0;0;0;0;0;0
2377;0;Espírito Santo;Farrapos;100;0;0;0;100;0
2378;0;Espírito Santo;Farroupilha;0;0;0;0;0;0
2379;0;Espírito Santo;Floresta;50;0;0;0;50;0
2380;0;Espírito Santo;Glória;100;0;64;22;0;100
2381;0;Espírito Santo;Guarujá;1200;200;459;162;450;750
2382;0;Espírito Santo;Higienópolis;0;0;0;0;0;0
2383;0;Espírito Santo;Humaitá;50;0;39;11;0;50
2384;0;Espírito Santo;Hípica;250;100;106;20;100;150
2385;0;Espírito Santo;Independência;50;0;25;15;0;50
2386;0;Espírito Santo;Ipanema;904;100;421;148;250;654
2387;0;Espírito Santo;Jardim Botânico;107;0;37;15;50;57
2388;0;Espírito Santo;Jardim Carvalho;100;0;80;15;50;50
2389;0;Espírito Santo;Jardim Europa;0;0;0;0;0;0
2390;0;Espírito Santo;Jardim Floresta;50;0;28;9;0;50
2391;0;Espírito Santo;Jardim Isabel;150;0;85;15;100;50
2392;0;Espírito Santo;Jardim Itú;50;50;0;0;50;0
2393;0;Espírito Santo;Jardim Leopoldina;1;0;0;1;0;1
2394;0;Espírito Santo;Jardim Lindóia;0;0;0;0;0;0
2395;0;Espírito Santo;Jardim Sabará;0;0;0;0;0;0
2396;0;Espírito Santo;Jardim São Pedro;150;50;70;16;50;100
2397;0;Espírito Santo;Jardim do Salso;100;50;24;12;50;50
2398;0;Espírito Santo;Lageado;50;0;33;8;0;50
2399;0;Espírito Santo;Lami;0;0;0;0;0;0
2400;0;Espírito Santo;Lomba do Pinheiro;200;0;25;8;150;50
2401;0;Espírito Santo;Medianeira;200;0;101;26;100;100
2402;0;Espírito Santo;Menino Deus;109;50;6;3;100;9
2403;0;Espírito Santo;Moinhos de Vento;50;0;19;24;0;50
2404;0;Espírito Santo;Mont'Serrat;0;0;0;0;0;0
2405;0;Espírito Santo;Morro Santana;8;0;4;3;0;8
2406;0;Espírito Santo;Mário Quintana;130;100;24;2;100;30
2407;0;Espírito Santo;Navegantes;0;0;0;0;0;0
2408;0;Espírito Santo;Nonoai;100;50;24;15;50;50
2409;0;Espírito Santo;Parque Santa Fé;0;0;0;0;0;0
2410;0;Espírito Santo;Partenon;208;0;136;38;50;158
2411;0;Espírito Santo;Passo D'Areia;109;0;30;22;50;59
2412;0;Espírito Santo;Passo das Pedras;9;0;7;1;0;9
2413;0;Espírito Santo;Pedra Redonda;250;0;122;45;50;200
2414;0;Espírito Santo;Petrópolis;209;50;99;41;50;159
2415;0;Espírito Santo;Pitinga;50;50;0;0;50;0
2416;0;Espírito Santo;Ponta Grossa;500;100;276;50;150;350
2417;0;Espírito Santo;Praia de Belas;0;0;0;0;0;0
2418;0;Espírito Santo;Restinga;608;150;182;49;300;308
2419;0;Espírito Santo;Rio Branco;54;0;30;14;0;54
2420;0;Espírito Santo;Rubem Berta;0;0;0;0;0;0
2421;0;Espírito Santo;Santa Cecília;0;0;0;0;0;0
2422;0;Espírito Santo;Santa Maria Goretti;0;0;0;0;0;0
2423;0;Espírito Santo;Santa Rosa de Lima;50;0;0;0;50;0
2424;0;Espírito Santo;Santa Tereza;108;0;65;18;0;108
2425;0;Espírito Santo;Santana;205;0;92;48;50;155
2426;0;Espírito Santo;Santo Antônio;0;0;0;0;0;0
2427;0;Espírito Santo;Sarandi;131;0;69;35;0;131
2428;0;Espírito Santo;Serraria;1250;300;391;139;600;650
2429;0;Espírito Santo;São Caetano;0;0;0;0;0;0
2430;0;Espírito Santo;São Geraldo;150;0;76;47;0;150
2431;0;Espírito Santo;São José;7;0;4;1;0;7
2432;0;Espírito Santo;São João;0;0;0;0;0;0
2433;0;Espírito Santo;São Sebastião;0;0;0;0;0;0
2434;0;Espírito Santo;Sétimo Céu;50;0;29;11;0;50
2435;0;Espírito Santo;Teresópolis;100;0;25;21;50;50
2436;0;Espírito Santo;Tristeza;56;0;32;14;0;56
2437;0;Espírito Santo;Três Figueiras;0;0;0;0;0;0
2438;0;Espírito Santo;Vila Assunção;100;0;32;14;50;50
2439;0;Espírito Santo;Vila Conceição;200;150;30;5;150;50
2440;0;Espírito Santo;Vila Ipiranga;0;0;0;0;0;0
2441;0;Espírito Santo;Vila Jardim;2;0;0;2;0;2
2442;0;Espírito Santo;Vila João Pessoa;0;0;0;0;0;0
2443;0;Espírito Santo;Vila Nova;882;200;182;49;600;282
2444;0;Extrema;Aberta dos Morros;100;0;0;0;100;0
2445;0;Extrema;Agronomia;0;0;0;0;0;0
2446;0;Extrema;Anchieta;0;0;0;0;0;0
2447;0;Extrema;Arquipélago;75;0;36;23;0;75
2448;0;Extrema;Auxiliadora;2;0;1;1;0;2
2449;0;Extrema;Azenha;0;0;0;0;0;0
2450;0;Extrema;Bela Vista;21;0;16;4;0;21
2451;0;Extrema;Belém Novo;48;48;0;0;48;0
2452;0;Extrema;Belém Velho;56;50;5;1;50;6
2453;0;Extrema;Boa Vista;34;0;2;1;31;3
2454;0;Extrema;Boa Vista do Sul;50;0;26;9;0;50
2455;0;Extrema;Bom Fim;0;0;0;0;0;0
2456;0;Extrema;Bom Jesus;30;0;18;3;0;30
2457;0;Extrema;Camaquã;2;0;1;1;0;2
2458;0;Extrema;Campo Novo;0;0;0;0;0;0
2459;0;Extrema;Cascata;25;0;12;6;0;25
2460;0;Extrema;Cavalhada;60;48;8;3;48;12
2461;0;Extrema;Cel. Aparício Borges;50;0;28;5;0;50
2462;0;Extrema;Centro Histórico;39;0;25;9;0;39
2463;0;Extrema;Chapéu do Sol;36;0;17;6;0;36
2464;0;Extrema;Chácara das Pedras;25;0;10;5;0;25
2465;0;Extrema;Cidade Baixa;142;50;38;12;81;61
2466;0;Extrema;Costa e Silva;54;0;34;5;0;54
2467;0;Extrema;Cristal;62;50;4;3;50;12
2468;0;Extrema;Cristo Redentor;54;48;5;1;48;6
2469;0;Extrema;Espírito Santo;0;0;0;0;0;0
2470;0;Extrema;Extrema;198;98;68;16;98;100
2471;0;Extrema;Farrapos;2114;12;1188;422;116;1998
2472;0;Extrema;Farroupilha;0;0;0;0;0;0
2473;0;Extrema;Floresta;0;0;0;0;0;0
2474;0;Extrema;Glória;27;0;14;8;0;27
2475;0;Extrema;Guarujá;0;0;0;0;0;0
2476;0;Extrema;Higienópolis;2;0;2;0;0;2
2477;0;Extrema;Humaitá;119;100;14;2;100;19
2478;0;Extrema;Hípica;0;0;0;0;0;0
2479;0;Extrema;Independência;0;0;0;0;0;0
2480;0;Extrema;Ipanema;4;0;1;1;0;4
2481;0;Extrema;Jardim Botânico;47;0;25;12;0;47
2482;0;Extrema;Jardim Carvalho;14;0;9;4;0;14
2483;0;Extrema;Jardim Europa;0;0;0;0;0;0
2484;0;Extrema;Jardim Floresta;0;0;0;0;0;0
2485;0;Extrema;Jardim Isabel;0;0;0;0;0;0
2486;0;Extrema;Jardim Itú;3;0;2;1;0;3
2487;0;Extrema;Jardim Leopoldina;52;50;0;2;50;2
2488;0;Extrema;Jardim Lindóia;0;0;0;0;0;0
2489;0;Extrema;Jardim Sabará;111;50;6;2;100;11
2490;0;Extrema;Jardim São Pedro;0;0;0;0;0;0
2491;0;Extrema;Jardim do Salso;0;0;0;0;0;0
2492;0;Extrema;Lageado;228;0;139;18;98;130
2493;0;Extrema;Lami;104;0;55;19;0;104
2494;0;Extrema;Lomba do Pinheiro;136;50;24;4;98;38
2495;0;Extrema;Medianeira;19;0;13;6;0;19
2496;0;Extrema;Menino Deus;58;0;36;19;0;58
2497;0;Extrema;Moinhos de Vento;0;0;0;0;0;0
2498;0;Extrema;Mont'Serrat;28;0;16;7;0;28
2499;0;Extrema;Morro Santana;75;50;13;6;50;25
2500;0;Extrema;Mário Quintana;23;0;16;2;0;23
2501;0;Extrema;Navegantes;25;0;12;5;0;25
2502;0;Extrema;Nonoai;2;0;1;0;0;2
2503;0;Extrema;Parque Santa Fé;0;0;0;0;0;0
2504;0;Extrema;Partenon;156;100;16;5;131;25
2505;0;Extrema;Passo D'Areia;8;0;4;3;0;8
2506;0;Extrema;Passo das Pedras;8;0;7;1;0;8
2507;0;Extrema;Pedra Redonda;0;0;0;0;0;0
2508;0;Extrema;Petrópolis;8;0;6;2;0;8
2509;0;Extrema;Pitinga;150;50;60;14;50;100
2510;0;Extrema;Ponta Grossa;0;0;0;0;0;0
2511;0;Extrema;Praia de Belas;0;0;0;0;0;0
2512;0;Extrema;Restinga;174;0;81;16;48;126
2513;0;Extrema;Rio Branco;54;0;33;12;0;54
2514;0;Extrema;Rubem Berta;51;48;2;1;48;3
2515;0;Extrema;Santa Cecília;0;0;0;0;0;0
2516;0;Extrema;Santa Maria Goretti;0;0;0;0;0;0
2517;0;Extrema;Santa Rosa de Lima;102;0;12;2;80;22
2518;0;Extrema;Santa Tereza;128;48;44;15;48;80
2519;0;Extrema;Santana;4;0;3;1;0;4
2520;0;Extrema;Santo Antônio;3;0;3;0;0;3
2521;0;Extrema;Sarandi;95;50;25;13;50;45
2522;0;Extrema;Serraria;0;0;0;0;0;0
2523;0;Extrema;São Caetano;69;0;37;15;0;69
2524;0;Extrema;São Geraldo;107;0;42;16;32;75
2525;0;Extrema;São José;105;50;28;14;50;55
2526;0;Extrema;São João;0;0;0;0;0;0
2527;0;Extrema;São Sebastião;50;50;0;0;50;0
2528;0;Extrema;Sétimo Céu;0;0;0;0;0;0
2529;0;Extrema;Teresópolis;75;0;51;16;0;75
2530;0;Extrema;Tristeza;5;0;2;2;0;5
2531;0;Extrema;Três Figueiras;0;0;0;0;0;0
2532;0;Extrema;Vila Assunção;0;0;0;0;0;0
2533;0;Extrema;Vila Conceição;0;0;0;0;0;0
2534;0;Extrema;Vila Ipiranga;52;0;31;15;0;52
2535;0;Extrema;Vila Jardim;2;0;1;0;0;2
2536;0;Extrema;Vila João Pessoa;75;0;41;13;0;75
2537;0;Extrema;Vila Nova;214;100;86;12;147;67
2538;0;Farrapos;Aberta dos Morros;2028;4;1216;360;24;2004
2539;0;Farrapos;Agronomia;495;6;289;75;26;469
2540;0;Farrapos;Anchieta;2686;650;917;300;1069;1617
2541;0;Farrapos;Arquipélago;2059;14;1114;346;117;1942
2542;0;Farrapos;Auxiliadora;7346;1302;3504;1733;1213;3837
2543;0;Farrapos;Azenha;2845;14;1463;654;138;2707
2544;0;Farrapos;Bela Vista;7983;1755;3819;1570;1685;3503
2545;0;Farrapos;Belém Novo;2479;7;1404;515;22;2457
2546;0;Farrapos;Belém Velho;7769;3336;2868;824;1103;4097
2547;0;Farrapos;Boa Vista;3331;17;1926;730;41;3290
2548;0;Farrapos;Boa Vista do Sul;643;3;352;96;53;590
2549;0;Farrapos;Bom Fim;1981;62;998;459;117;1864
2550;0;Farrapos;Bom Jesus;4747;232;2482;729;783;3964
2551;0;Farrapos;Camaquã;10165;3921;3789;1385;2716;3195
2552;0;Farrapos;Campo Novo;2369;42;1415;342;118;2251
2553;0;Farrapos;Cascata;2556;17;1384;380;180;2376
2554;0;Farrapos;Cavalhada;15991;6598;5846;2043;3699;5343
2555;0;Farrapos;Cel. Aparício Borges;12526;6097;3772;1013;2964;4984
2556;0;Farrapos;Centro Histórico;4338;78;2154;983;404;3934
2557;0;Farrapos;Chapéu do Sol;2441;1102;883;209;426;1325
2558;0;Farrapos;Chácara das Pedras;1567;32;813;352;131;1436
2559;0;Farrapos;Cidade Baixa;3750;62;1828;838;227;3523
2560;0;Farrapos;Costa e Silva;9909;4898;3255;749;2084;4068
2561;0;Farrapos;Cristal;6261;130;3350;1178;488;5773
2562;0;Farrapos;Cristo Redentor;10902;2566;4987;2017;2272;4728
2563;0;Farrapos;Espírito Santo;878;14;462;160;133;745
2564;0;Farrapos;Extrema;289;5;177;52;9;280
2565;0;Farrapos;Farrapos;71576;686;40221;14646;1600;69976
2566;0;Farrapos;Farroupilha;1327;96;676;363;129;971
2567;0;Farrapos;Floresta;7968;1877;3550;1522;1515;3703
2568;0;Farrapos;Glória;3748;23;1981;811;118;3630
2569;0;Farrapos;Guarujá;770;74;376;126;137;633
2570;0;Farrapos;Higienópolis;4717;106;2724;980;160;4557
2571;0;Farrapos;Humaitá;40190;2530;20816;7298;4724;35466
2572;0;Farrapos;Hípica;2853;24;1826;406;46;2807
2573;0;Farrapos;Independência;5148;822;2383;1465;634;2590
2574;0;Farrapos;Ipanema;8760;2767;3799;1448;1667;3837
2575;0;Farrapos;Jardim Botânico;8731;1981;3781;1480;2003;3759
2576;0;Farrapos;Jardim Carvalho;3698;178;1937;656;575;3123
2577;0;Farrapos;Jardim Europa;877;73;474;158;93;784
2578;0;Farrapos;Jardim Floresta;3292;716;1392;631;549;1959
2579;0;Farrapos;Jardim Isabel;2111;583;964;348;389;1050
2580;0;Farrapos;Jardim Itú;3125;36;1864;631;111;3014
2581;0;Farrapos;Jardim Leopoldina;10081;3307;4190;1352;2323;3485
2582;0;Farrapos;Jardim Lindóia;2544;22;1324;643;110;2434
2583;0;Farrapos;Jardim Sabará;2656;167;1352;559;286;2370
2584;0;Farrapos;Jardim São Pedro;5304;0;3004;1193;106;5198
2585;0;Farrapos;Jardim do Salso;1026;10;555;182;104;922
2586;0;Farrapos;Lageado;4152;1375;1676;454;742;2348
2587;0;Farrapos;Lami;672;0;389;127;1;671
2588;0;Farrapos;Lomba do Pinheiro;3996;45;2225;601;173;3823
2589;0;Farrapos;Medianeira;1962;33;966;473;192;1770
2590;0;Farrapos;Menino Deus;5582;106;2941;1485;454;5128
2591;0;Farrapos;Moinhos de Vento;2494;73;1211;769;159;2335
2592;0;Farrapos;Mont'Serrat;4053;8;2172;929;252;3801
2593;0;Farrapos;Morro Santana;12375;5189;4389;1332;3116;4661
2594;0;Farrapos;Mário Quintana;19560;11164;5164;938;5180;7409
2595;0;Farrapos;Navegantes;14486;405;7887;2881;725;13761
2596;0;Farrapos;Nonoai;3697;147;2061;709;288;3409
2597;0;Farrapos;Parque Santa Fé;1079;13;589;235;47;1032
2598;0;Farrapos;Partenon;4535;34;2522;968;155;4380
2599;0;Farrapos;Passo D'Areia;5454;37;2139;1890;201;5253
2600;0;Farrapos;Passo das Pedras;10510;4886;3370;1045;2489;4250
2601;0;Farrapos;Pedra Redonda;504;4;302;98;4;500
2602;0;Farrapos;Petrópolis;5754;52;3237;1473;330;5424
2603;0;Farrapos;Pitinga;3814;1539;1372;327;801;1981
2604;0;Farrapos;Ponta Grossa;1611;102;898;239;106;1505
2605;0;Farrapos;Praia de Belas;1328;3;714;269;33;1295
2606;0;Farrapos;Restinga;5983;76;3385;884;290;5693
2607;0;Farrapos;Rio Branco;10379;2357;4377;2340;2413;3808
2608;0;Farrapos;Rubem Berta;3512;39;1677;1171;117;3395
2609;0;Farrapos;Santa Cecília;4351;796;2090;984;736;2247
2610;0;Farrapos;Santa Maria Goretti;2760;350;1283;292;687;2073
2611;0;Farrapos;Santa Rosa de Lima;3097;10;1755;474;144;2953
2612;0;Farrapos;Santa Tereza;5802;91;3163;1027;482;5320
2613;0;Farrapos;Santana;4189;11;2250;1176;93;4096
2614;0;Farrapos;Santo Antônio;8235;2300;3457;1492;1835;3279
2615;0;Farrapos;Sarandi;21740;4969;9158;4560;5532;8552
2616;0;Farrapos;Serraria;1063;29;576;177;93;970
2617;0;Farrapos;São Caetano;677;216;279;96;147;351
2618;0;Farrapos;São Geraldo;3969;57;2158;847;132;3837
2619;0;Farrapos;São José;4134;53;2434;668;195;3939
2620;0;Farrapos;São João;3525;255;1823;799;276;3249
2621;0;Farrapos;São Sebastião;1893;65;978;334;159;1734
2622;0;Farrapos;Sétimo Céu;602;4;352;113;19;583
2623;0;Farrapos;Teresópolis;1915;8;1049;434;102;1813
2624;0;Farrapos;Tristeza;10312;3197;4173;2222;2207;4146
2625;0;Farrapos;Três Figueiras;3427;892;1413;611;604;1858
2626;0;Farrapos;Vila Assunção;888;3;511;222;14;874
2627;0;Farrapos;Vila Conceição;1104;209;487;271;168;617
2628;0;Farrapos;Vila Ipiranga;3411;60;1890;750;210;3201
2629;0;Farrapos;Vila Jardim;8525;1955;3760;1792;1777;3620
2630;0;Farrapos;Vila João Pessoa;3184;37;1839;623;226;2958
2631;0;Farrapos;Vila Nova;18554;7787;6255;2294;4442;7149
2632;0;Farroupilha;Aberta dos Morros;100;0;54;30;0;100
2633;0;Farroupilha;Agronomia;0;0;0;0;0;0
2634;0;Farroupilha;Anchieta;0;0;0;0;0;0
2635;0;Farroupilha;Arquipélago;550;200;183;52;250;300
2636;0;Farroupilha;Auxiliadora;57;0;37;13;0;57
2637;0;Farroupilha;Azenha;451;50;193;111;50;401
2638;0;Farroupilha;Bela Vista;157;100;6;0;150;7
2639;0;Farroupilha;Belém Novo;50;0;0;0;50;0
2640;0;Farroupilha;Belém Velho;8;0;7;0;0;8
2641;0;Farroupilha;Boa Vista;158;0;62;39;50;108
2642;0;Farroupilha;Boa Vista do Sul;0;0;0;0;0;0
2643;0;Farroupilha;Bom Fim;1100;100;443;290;150;950
2644;0;Farroupilha;Bom Jesus;14;0;7;3;0;14
2645;0;Farroupilha;Camaquã;7;0;6;0;0;7
2646;0;Farroupilha;Campo Novo;0;0;0;0;0;0
2647;0;Farroupilha;Cascata;150;50;59;21;50;100
2648;0;Farroupilha;Cavalhada;129;0;57;39;0;129
2649;0;Farroupilha;Cel. Aparício Borges;123;0;47;8;50;73
2650;0;Farroupilha;Centro Histórico;11259;200;5609;2495;950;10309
2651;0;Farroupilha;Chapéu do Sol;50;0;28;19;0;50
2652;0;Farroupilha;Chácara das Pedras;0;0;0;0;0;0
2653;0;Farroupilha;Cidade Baixa;2606;550;429;138;2000;606
2654;0;Farroupilha;Costa e Silva;112;0;72;16;0;112
2655;0;Farroupilha;Cristal;234;0;42;17;150;84
2656;0;Farroupilha;Cristo Redentor;115;50;40;14;50;65
2657;0;Farroupilha;Espírito Santo;0;0;0;0;0;0
2658;0;Farroupilha;Extrema;0;0;0;0;0;0
2659;0;Farroupilha;Farrapos;567;96;251;173;129;211
2660;0;Farroupilha;Farroupilha;100;0;0;0;100;0
2661;0;Farroupilha;Floresta;250;50;76;41;100;150
2662;0;Farroupilha;Glória;108;100;3;4;100;8
2663;0;Farroupilha;Guarujá;0;0;0;0;0;0
2664;0;Farroupilha;Higienópolis;107;50;36;14;50;57
2665;0;Farroupilha;Humaitá;0;0;0;0;0;0
2666;0;Farroupilha;Hípica;0;0;0;0;0;0
2667;0;Farroupilha;Independência;600;0;146;105;300;300
2668;0;Farroupilha;Ipanema;60;0;37;12;0;60
2669;0;Farroupilha;Jardim Botânico;113;50;5;5;100;13
2670;0;Farroupilha;Jardim Carvalho;108;50;30;17;50;58
2671;0;Farroupilha;Jardim Europa;0;0;0;0;0;0
2672;0;Farroupilha;Jardim Floresta;0;0;0;0;0;0
2673;0;Farroupilha;Jardim Isabel;0;0;0;0;0;0
2674;0;Farroupilha;Jardim Itú;53;0;31;10;0;53
2675;0;Farroupilha;Jardim Leopoldina;59;0;47;9;0;59
2676;0;Farroupilha;Jardim Lindóia;50;0;0;0;50;0
2677;0;Farroupilha;Jardim Sabará;0;0;0;0;0;0
2678;0;Farroupilha;Jardim São Pedro;0;0;0;0;0;0
2679;0;Farroupilha;Jardim do Salso;0;0;0;0;0;0
2680;0;Farroupilha;Lageado;0;0;0;0;0;0
2681;0;Farroupilha;Lami;0;0;0;0;0;0
2682;0;Farroupilha;Lomba do Pinheiro;108;50;5;1;100;8
2683;0;Farroupilha;Medianeira;150;50;0;0;150;0
2684;0;Farroupilha;Menino Deus;3371;350;1312;744;950;2421
2685;0;Farroupilha;Moinhos de Vento;200;0;73;54;50;150
2686;0;Farroupilha;Mont'Serrat;108;100;4;2;100;8
2687;0;Farroupilha;Morro Santana;15;0;12;1;0;15
2688;0;Farroupilha;Mário Quintana;184;50;82;19;50;134
2689;0;Farroupilha;Navegantes;50;50;0;0;50;0
2690;0;Farroupilha;Nonoai;206;0;53;22;100;106
2691;0;Farroupilha;Parque Santa Fé;50;0;41;5;0;50
2692;0;Farroupilha;Partenon;363;0;169;78;50;313
2693;0;Farroupilha;Passo D'Areia;170;50;45;51;50;120
2694;0;Farroupilha;Passo das Pedras;63;0;38;9;0;63
2695;0;Farroupilha;Pedra Redonda;0;0;0;0;0;0
2696;0;Farroupilha;Petrópolis;224;0;111;40;50;174
2697;0;Farroupilha;Pitinga;0;0;0;0;0;0
2698;0;Farroupilha;Ponta Grossa;0;0;0;0;0;0
2699;0;Farroupilha;Praia de Belas;0;0;0;0;0;0
2700;0;Farroupilha;Restinga;134;0;51;12;50;84
2701;0;Farroupilha;Rio Branco;508;250;88;35;350;158
2702;0;Farroupilha;Rubem Berta;206;0;96;75;0;206
2703;0;Farroupilha;Santa Cecília;250;100;24;13;200;50
2704;0;Farroupilha;Santa Maria Goretti;100;0;60;3;0;100
2705;0;Farroupilha;Santa Rosa de Lima;108;0;57;20;0;108
2706;0;Farroupilha;Santa Tereza;72;0;35;18;0;72
2707;0;Farroupilha;Santana;5161;1100;829;446;3700;1461
2708;0;Farroupilha;Santo Antônio;56;0;34;14;0;56
2709;0;Farroupilha;Sarandi;283;0;122;67;50;233
2710;0;Farroupilha;Serraria;0;0;0;0;0;0
2711;0;Farroupilha;São Caetano;0;0;0;0;0;0
2712;0;Farroupilha;São Geraldo;100;0;57;33;0;100
2713;0;Farroupilha;São José;8;0;6;1;0;8
2714;0;Farroupilha;São João;50;0;21;13;0;50
2715;0;Farroupilha;São Sebastião;0;0;0;0;0;0
2716;0;Farroupilha;Sétimo Céu;0;0;0;0;0;0
2717;0;Farroupilha;Teresópolis;50;0;27;11;0;50
2718;0;Farroupilha;Tristeza;14;0;6;5;0;14
2719;0;Farroupilha;Três Figueiras;100;0;45;28;0;100
2720;0;Farroupilha;Vila Assunção;100;50;0;0;100;0
2721;0;Farroupilha;Vila Conceição;0;0;0;0;0;0
2722;0;Farroupilha;Vila Ipiranga;106;50;30;9;50;56
2723;0;Farroupilha;Vila Jardim;8;0;5;2;0;8
2724;0;Farroupilha;Vila João Pessoa;50;50;0;0;50;0
2725;0;Farroupilha;Vila Nova;33;0;20;5;0;33
2726;0;Floresta;Aberta dos Morros;100;0;24;16;50;50
2727;0;Floresta;Agronomia;100;0;52;18;0;100
2728;0;Floresta;Anchieta;50;0;0;0;50;0
2729;0;Floresta;Arquipélago;50;0;27;10;0;50
2730;0;Floresta;Auxiliadora;607;100;221;106;200;407
2731;0;Floresta;Azenha;201;0;46;35;100;101
2732;0;Floresta;Bela Vista;609;200;126;49;400;209
2733;0;Floresta;Belém Novo;50;50;0;0;50;0
2734;0;Floresta;Belém Velho;26;0;17;3;0;26
2735;0;Floresta;Boa Vista;56;0;29;16;0;56
2736;0;Floresta;Boa Vista do Sul;100;0;26;16;50;50
2737;0;Floresta;Bom Fim;500;250;71;44;350;150
2738;0;Floresta;Bom Jesus;181;50;43;15;100;81
2739;0;Floresta;Camaquã;209;100;56;23;100;109
2740;0;Floresta;Campo Novo;100;50;0;0;100;0
2741;0;Floresta;Cascata;50;0;24;15;0;50
2742;0;Floresta;Cavalhada;207;100;52;30;100;107
2743;0;Floresta;Cel. Aparício Borges;46;0;23;11;0;46
2744;0;Floresta;Centro Histórico;870;200;246;104;500;370
2745;0;Floresta;Chapéu do Sol;50;0;28;16;0;50
2746;0;Floresta;Chácara das Pedras;50;0;32;13;0;50
2747;0;Floresta;Cidade Baixa;511;150;68;38;350;161
2748;0;Floresta;Costa e Silva;27;0;24;2;0;27
2749;0;Floresta;Cristal;459;0;168;86;150;309
2750;0;Floresta;Cristo Redentor;139;50;47;15;50;89
2751;0;Floresta;Espírito Santo;50;0;0;0;50;0
2752;0;Floresta;Extrema;0;0;0;0;0;0
2753;0;Floresta;Farrapos;5709;1867;2284;1019;1458;1501
2754;0;Floresta;Farroupilha;250;50;76;41;100;150
2755;0;Floresta;Floresta;3400;200;1580;892;300;3100
2756;0;Floresta;Glória;105;50;26;18;50;55
2757;0;Floresta;Guarujá;50;0;30;14;0;50
2758;0;Floresta;Higienópolis;457;100;186;76;150;307
2759;0;Floresta;Humaitá;200;100;54;23;100;100
2760;0;Floresta;Hípica;0;0;0;0;0;0
2761;0;Floresta;Independência;300;100;52;35;200;100
2762;0;Floresta;Ipanema;69;0;42;22;0;69
2763;0;Floresta;Jardim Botânico;128;0;46;23;50;78
2764;0;Floresta;Jardim Carvalho;57;0;35;15;0;57
2765;0;Floresta;Jardim Europa;50;0;41;6;0;50
2766;0;Floresta;Jardim Floresta;150;0;57;17;50;100
2767;0;Floresta;Jardim Isabel;0;0;0;0;0;0
2768;0;Floresta;Jardim Itú;5;0;3;0;0;5
2769;0;Floresta;Jardim Leopoldina;113;0;32;14;50;63
2770;0;Floresta;Jardim Lindóia;50;0;30;8;0;50
2771;0;Floresta;Jardim Sabará;50;0;0;0;50;0
2772;0;Floresta;Jardim São Pedro;150;50;25;15;100;50
2773;0;Floresta;Jardim do Salso;0;0;0;0;0;0
2774;0;Floresta;Lageado;50;50;0;0;50;0
2775;0;Floresta;Lami;0;0;0;0;0;0
2776;0;Floresta;Lomba do Pinheiro;109;50;32;8;50;59
2777;0;Floresta;Medianeira;0;0;0;0;0;0
2778;0;Floresta;Menino Deus;402;150;82;45;250;152
2779;0;Floresta;Moinhos de Vento;1450;250;572;321;350;1100
2780;0;Floresta;Mont'Serrat;255;50;29;19;200;55
2781;0;Floresta;Morro Santana;96;50;34;9;50;46
2782;0;Floresta;Mário Quintana;131;0;76;19;0;131
2783;0;Floresta;Navegantes;300;50;114;51;100;200
2784;0;Floresta;Nonoai;212;0;50;37;100;112
2785;0;Floresta;Parque Santa Fé;0;0;0;0;0;0
2786;0;Floresta;Partenon;237;0;113;42;50;187
2787;0;Floresta;Passo D'Areia;392;50;148;112;100;292
2788;0;Floresta;Passo das Pedras;186;0;111;46;0;186
2789;0;Floresta;Pedra Redonda;0;0;0;0;0;0
2790;0;Floresta;Petrópolis;345;150;133;47;200;145
2791;0;Floresta;Pitinga;50;0;25;13;0;50
2792;0;Floresta;Ponta Grossa;100;0;54;23;0;100
2793;0;Floresta;Praia de Belas;150;0;42;33;50;100
2794;0;Floresta;Restinga;107;50;31;6;50;57
2795;0;Floresta;Rio Branco;968;150;365;212;250;718
2796;0;Floresta;Rubem Berta;160;50;64;27;50;110
2797;0;Floresta;Santa Cecília;50;0;26;12;0;50
2798;0;Floresta;Santa Maria Goretti;200;0;90;30;50;150
2799;0;Floresta;Santa Rosa de Lima;106;50;40;6;50;56
2800;0;Floresta;Santa Tereza;347;100;131;48;100;247
2801;0;Floresta;Santana;578;100;200;74;300;278
2802;0;Floresta;Santo Antônio;308;0;166;55;50;258
2803;0;Floresta;Sarandi;312;50;145;73;50;262
2804;0;Floresta;Serraria;50;0;0;0;50;0
2805;0;Floresta;São Caetano;50;50;0;0;50;0
2806;0;Floresta;São Geraldo;3701;1200;719;346;2401;1300
2807;0;Floresta;São José;77;0;41;23;0;77
2808;0;Floresta;São João;2517;200;1240;611;267;2250
2809;0;Floresta;São Sebastião;0;0;0;0;0;0
2810;0;Floresta;Sétimo Céu;50;0;32;12;0;50
2811;0;Floresta;Teresópolis;250;0;84;38;100;150
2812;0;Floresta;Tristeza;81;0;16;10;50;31
2813;0;Floresta;Três Figueiras;100;50;22;15;50;50
2814;0;Floresta;Vila Assunção;0;0;0;0;0;0
2815;0;Floresta;Vila Conceição;0;0;0;0;0;0
2816;0;Floresta;Vila Ipiranga;58;0;34;15;0;58
2817;0;Floresta;Vila Jardim;118;0;41;19;50;68
2818;0;Floresta;Vila João Pessoa;151;0;93;32;0;151
2819;0;Floresta;Vila Nova;131;50;51;12;50;81
2820;0;Glória;Aberta dos Morros;50;50;0;0;50;0
2821;0;Glória;Agronomia;100;0;58;16;0;100
2822;0;Glória;Anchieta;50;0;33;6;0;50
2823;0;Glória;Arquipélago;100;0;32;6;50;50
2824;0;Glória;Auxiliadora;109;0;69;27;0;109
2825;0;Glória;Azenha;252;50;74;33;100;152
2826;0;Glória;Bela Vista;163;50;64;34;50;113
2827;0;Glória;Belém Novo;300;0;156;71;0;300
2828;0;Glória;Belém Velho;121;0;70;24;0;121
2829;0;Glória;Boa Vista;206;50;95;31;50;156
2830;0;Glória;Boa Vista do Sul;100;0;57;15;0;100
2831;0;Glória;Bom Fim;50;0;20;13;0;50
2832;0;Glória;Bom Jesus;24;0;9;7;0;24
2833;0;Glória;Camaquã;311;50;89;39;150;161
2834;0;Glória;Campo Novo;0;0;0;0;0;0
2835;0;Glória;Cascata;1850;400;582;152;850;1000
2836;0;Glória;Cavalhada;198;0;122;38;0;198
2837;0;Glória;Cel. Aparício Borges;4337;200;2152;754;650;3687
2838;0;Glória;Centro Histórico;265;0;144;63;0;265
2839;0;Glória;Chapéu do Sol;50;0;31;13;0;50
2840;0;Glória;Chácara das Pedras;100;50;23;13;50;50
2841;0;Glória;Cidade Baixa;163;100;8;3;150;13
2842;0;Glória;Costa e Silva;320;0;192;56;0;320
2843;0;Glória;Cristal;100;0;21;13;50;50
2844;0;Glória;Cristo Redentor;77;50;19;4;50;27
2845;0;Glória;Espírito Santo;100;0;64;22;0;100
2846;0;Glória;Extrema;50;0;29;10;0;50
2847;0;Glória;Farrapos;0;0;0;0;0;0
2848;0;Glória;Farroupilha;100;100;0;0;100;0
2849;0;Glória;Floresta;100;50;22;18;50;50
2850;0;Glória;Glória;9206;1900;3330;1124;3700;5506
2851;0;Glória;Guarujá;50;0;30;8;0;50
2852;0;Glória;Higienópolis;60;0;32;17;0;60
2853;0;Glória;Humaitá;100;50;26;7;50;50
2854;0;Glória;Hípica;52;0;42;6;0;52
2855;0;Glória;Independência;0;0;0;0;0;0
2856;0;Glória;Ipanema;116;0;71;22;0;116
2857;0;Glória;Jardim Botânico;470;100;233;78;150;320
2858;0;Glória;Jardim Carvalho;459;150;127;40;250;209
2859;0;Glória;Jardim Europa;100;50;0;0;100;0
2860;0;Glória;Jardim Floresta;50;0;26;9;0;50
2861;0;Glória;Jardim Isabel;100;50;22;19;50;50
2862;0;Glória;Jardim Itú;4;0;3;0;0;4
2863;0;Glória;Jardim Leopoldina;68;0;41;15;0;68
2864;0;Glória;Jardim Lindóia;0;0;0;0;0;0
2865;0;Glória;Jardim Sabará;150;0;93;40;0;150
2866;0;Glória;Jardim São Pedro;50;0;29;13;0;50
2867;0;Glória;Jardim do Salso;250;0;120;45;50;200
2868;0;Glória;Lageado;50;0;27;10;0;50
2869;0;Glória;Lami;100;0;24;10;50;50
2870;0;Glória;Lomba do Pinheiro;1114;50;603;110;200;914
2871;0;Glória;Medianeira;500;50;84;34;350;150
2872;0;Glória;Menino Deus;489;50;177;86;150;339
2873;0;Glória;Moinhos de Vento;0;0;0;0;0;0
2874;0;Glória;Mont'Serrat;57;50;4;2;50;7
2875;0;Glória;Morro Santana;378;50;157;70;100;278
2876;0;Glória;Mário Quintana;261;0;149;43;0;261
2877;0;Glória;Navegantes;100;0;25;12;50;50
2878;0;Glória;Nonoai;663;200;189;78;300;363
2879;0;Glória;Parque Santa Fé;0;0;0;0;0;0
2880;0;Glória;Partenon;14327;4700;2678;982;9950;4377
2881;0;Glória;Passo D'Areia;183;100;38;18;100;83
2882;0;Glória;Passo das Pedras;75;50;18;3;50;25
2883;0;Glória;Pedra Redonda;50;0;0;0;50;0
2884;0;Glória;Petrópolis;386;50;162;75;100;286
2885;0;Glória;Pitinga;0;0;0;0;0;0
2886;0;Glória;Ponta Grossa;100;50;29;11;50;50
2887;0;Glória;Praia de Belas;200;50;82;30;50;150
2888;0;Glória;Restinga;600;150;262;58;150;450
2889;0;Glória;Rio Branco;16;0;10;4;0;16
2890;0;Glória;Rubem Berta;110;100;7;2;100;10
2891;0;Glória;Santa Cecília;400;0;202;107;0;400
2892;0;Glória;Santa Maria Goretti;50;0;31;2;0;50
2893;0;Glória;Santa Rosa de Lima;57;0;39;6;0;57
2894;0;Glória;Santa Tereza;683;200;286;48;300;383
2895;0;Glória;Santana;171;0;35;20;100;71
2896;0;Glória;Santo Antônio;359;50;89;36;200;159
2897;0;Glória;Sarandi;612;50;259;117;150;462
2898;0;Glória;Serraria;250;0;54;21;150;100
2899;0;Glória;São Caetano;0;0;0;0;0;0
2900;0;Glória;São Geraldo;250;0;154;71;0;250
2901;0;Glória;São José;867;250;314;90;400;467
2902;0;Glória;São João;350;100;145;66;100;250
2903;0;Glória;São Sebastião;50;0;35;11;0;50
2904;0;Glória;Sétimo Céu;0;0;0;0;0;0
2905;0;Glória;Teresópolis;2000;950;456;154;1350;650
2906;0;Glória;Tristeza;223;50;101;55;50;173
2907;0;Glória;Três Figueiras;250;100;72;33;100;150
2908;0;Glória;Vila Assunção;50;0;0;0;50;0
2909;0;Glória;Vila Conceição;0;0;0;0;0;0
2910;0;Glória;Vila Ipiranga;109;50;37;15;50;59
2911;0;Glória;Vila Jardim;116;0;32;15;50;66
2912;0;Glória;Vila João Pessoa;1251;150;553;221;250;1001
2913;0;Glória;Vila Nova;612;100;174;65;300;312
2914;0;Guarujá;Aberta dos Morros;326;50;159;51;76;250
2915;0;Guarujá;Agronomia;0;0;0;0;0;0
2916;0;Guarujá;Anchieta;50;0;24;11;0;50
2917;0;Guarujá;Arquipélago;0;0;0;0;0;0
2918;0;Guarujá;Auxiliadora;2;0;1;1;0;2
2919;0;Guarujá;Azenha;0;0;0;0;0;0
2920;0;Guarujá;Bela Vista;102;0;20;15;50;52
2921;0;Guarujá;Belém Novo;150;0;94;33;0;150
2922;0;Guarujá;Belém Velho;102;50;33;7;50;52
2923;0;Guarujá;Boa Vista;2;0;2;0;0;2
2924;0;Guarujá;Boa Vista do Sul;50;50;0;0;50;0
2925;0;Guarujá;Bom Fim;150;0;76;43;0;150
2926;0;Guarujá;Bom Jesus;206;0;122;41;0;206
2927;0;Guarujá;Camaquã;383;98;158;54;131;252
2928;0;Guarujá;Campo Novo;197;97;63;15;97;100
2929;0;Guarujá;Cascata;150;0;92;21;0;150
2930;0;Guarujá;Cavalhada;301;50;121;46;83;218
2931;0;Guarujá;Cel. Aparício Borges;95;0;31;9;33;62
2932;0;Guarujá;Centro Histórico;52;0;23;16;0;52
2933;0;Guarujá;Chapéu do Sol;0;0;0;0;0;0
2934;0;Guarujá;Chácara das Pedras;0;0;0;0;0;0
2935;0;Guarujá;Cidade Baixa;53;0;35;12;0;53
2936;0;Guarujá;Costa e Silva;5;0;5;0;0;5
2937;0;Guarujá;Cristal;165;98;9;7;147;18
2938;0;Guarujá;Cristo Redentor;57;0;36;9;0;57
2939;0;Guarujá;Espírito Santo;1197;198;459;162;447;750
2940;0;Guarujá;Extrema;0;0;0;0;0;0
2941;0;Guarujá;Farrapos;359;126;1;0;359;0
2942;0;Guarujá;Farroupilha;0;0;0;0;0;0
2943;0;Guarujá;Floresta;50;0;30;14;0;50
2944;0;Guarujá;Glória;51;0;31;8;0;51
2945;0;Guarujá;Guarujá;4993;981;2017;614;1893;3100
2946;0;Guarujá;Higienópolis;53;50;1;1;50;3
2947;0;Guarujá;Humaitá;100;0;67;16;0;100
2948;0;Guarujá;Hípica;348;0;194;40;48;300
2949;0;Guarujá;Independência;0;0;0;0;0;0
2950;0;Guarujá;Ipanema;628;95;228;71;276;352
2951;0;Guarujá;Jardim Botânico;104;0;68;18;0;104
2952;0;Guarujá;Jardim Carvalho;100;48;27;7;48;52
2953;0;Guarujá;Jardim Europa;0;0;0;0;0;0
2954;0;Guarujá;Jardim Floresta;0;0;0;0;0;0
2955;0;Guarujá;Jardim Isabel;200;0;116;52;0;200
2956;0;Guarujá;Jardim Itú;51;50;0;1;50;1
2957;0;Guarujá;Jardim Leopoldina;101;0;1;0;99;2
2958;0;Guarujá;Jardim Lindóia;0;0;0;0;0;0
2959;0;Guarujá;Jardim Sabará;0;0;0;0;0;0
2960;0;Guarujá;Jardim São Pedro;0;0;0;0;0;0
2961;0;Guarujá;Jardim do Salso;0;0;0;0;0;0
2962;0;Guarujá;Lageado;50;0;28;12;0;50
2963;0;Guarujá;Lami;0;0;0;0;0;0
2964;0;Guarujá;Lomba do Pinheiro;53;0;34;5;0;53
2965;0;Guarujá;Medianeira;0;0;0;0;0;0
2966;0;Guarujá;Menino Deus;62;0;5;5;50;12
2967;0;Guarujá;Moinhos de Vento;148;48;41;38;48;100
2968;0;Guarujá;Mont'Serrat;2;0;2;0;0;2
2969;0;Guarujá;Morro Santana;109;0;31;14;50;59
2970;0;Guarujá;Mário Quintana;63;0;18;2;34;29
2971;0;Guarujá;Navegantes;0;0;0;0;0;0
2972;0;Guarujá;Nonoai;151;148;2;0;148;3
2973;0;Guarujá;Parque Santa Fé;50;0;37;9;0;50
2974;0;Guarujá;Partenon;207;50;89;36;50;157
2975;0;Guarujá;Passo D'Areia;110;48;21;21;48;62
2976;0;Guarujá;Passo das Pedras;7;0;3;1;0;7
2977;0;Guarujá;Pedra Redonda;0;0;0;0;0;0
2978;0;Guarujá;Petrópolis;162;50;56;36;50;112
2979;0;Guarujá;Pitinga;84;0;34;2;34;50
2980;0;Guarujá;Ponta Grossa;847;100;393;93;297;550
2981;0;Guarujá;Praia de Belas;0;0;0;0;0;0
2982;0;Guarujá;Restinga;642;146;208;54;276;366
2983;0;Guarujá;Rio Branco;53;0;37;13;0;53
2984;0;Guarujá;Rubem Berta;3;0;1;1;0;3
2985;0;Guarujá;Santa Cecília;0;0;0;0;0;0
2986;0;Guarujá;Santa Maria Goretti;0;0;0;0;0;0
2987;0;Guarujá;Santa Rosa de Lima;151;0;90;19;0;151
2988;0;Guarujá;Santa Tereza;112;50;6;2;100;12
2989;0;Guarujá;Santana;54;0;32;10;0;54
2990;0;Guarujá;Santo Antônio;1;0;1;0;0;1
2991;0;Guarujá;Sarandi;179;0;70;38;50;129
2992;0;Guarujá;Serraria;1285;523;301;90;785;500
2993;0;Guarujá;São Caetano;0;0;0;0;0;0
2994;0;Guarujá;São Geraldo;50;0;35;12;0;50
2995;0;Guarujá;São José;51;48;1;1;48;3
2996;0;Guarujá;São João;0;0;0;0;0;0
2997;0;Guarujá;São Sebastião;150;50;49;25;50;100
2998;0;Guarujá;Sétimo Céu;0;0;0;0;0;0
2999;0;Guarujá;Teresópolis;0;0;0;0;0;0
3000;0;Guarujá;Tristeza;155;0;83;52;0;155
3001;0;Guarujá;Três Figueiras;100;0;58;27;0;100
3002;0;Guarujá;Vila Assunção;50;0;0;0;50;0
3003;0;Guarujá;Vila Conceição;200;0;89;37;50;150
3004;0;Guarujá;Vila Ipiranga;1;0;0;0;0;1
3005;0;Guarujá;Vila Jardim;147;48;27;14;95;52
3006;0;Guarujá;Vila João Pessoa;0;0;0;0;0;0
3007;0;Guarujá;Vila Nova;178;50;74;22;50;128
3008;0;Higienópolis;Aberta dos Morros;0;0;0;0;0;0
3009;0;Higienópolis;Agronomia;0;0;0;0;0;0
3010;0;Higienópolis;Anchieta;12;0;10;1;0;12
3011;0;Higienópolis;Arquipélago;50;50;0;0;50;0
3012;0;Higienópolis;Auxiliadora;888;150;342;150;300;588
3013;0;Higienópolis;Azenha;200;50;62;15;100;100
3014;0;Higienópolis;Bela Vista;65;0;29;22;0;65
3015;0;Higienópolis;Belém Novo;50;0;50;0;50;0
3016;0;Higienópolis;Belém Velho;175;0;107;31;0;175
3017;0;Higienópolis;Boa Vista;955;150;437;198;250;705
3018;0;Higienópolis;Boa Vista do Sul;50;0;0;0;50;0
3019;0;Higienópolis;Bom Fim;76;50;11;10;50;26
3020;0;Higienópolis;Bom Jesus;89;0;45;15;0;89
3021;0;Higienópolis;Camaquã;64;0;37;9;0;64
3022;0;Higienópolis;Campo Novo;0;0;0;0;0;0
3023;0;Higienópolis;Cascata;37;0;26;4;0;37
3024;0;Higienópolis;Cavalhada;124;0;54;8;50;74
3025;0;Higienópolis;Cel. Aparício Borges;80;0;47;13;0;80
3026;0;Higienópolis;Centro Histórico;445;50;113;45;250;195
3027;0;Higienópolis;Chapéu do Sol;100;0;23;19;50;50
3028;0;Higienópolis;Chácara das Pedras;0;0;0;0;0;0
3029;0;Higienópolis;Cidade Baixa;117;50;11;3;100;17
3030;0;Higienópolis;Costa e Silva;128;0;53;10;50;78
3031;0;Higienópolis;Cristal;285;50;50;13;200;85
3032;0;Higienópolis;Cristo Redentor;306;100;120;42;100;206
3033;0;Higienópolis;Espírito Santo;0;0;0;0;0;0
3034;0;Higienópolis;Extrema;0;0;0;0;0;0
3035;0;Higienópolis;Farrapos;7418;100;3906;1911;150;7268
3036;0;Higienópolis;Farroupilha;100;50;30;13;50;50
3037;0;Higienópolis;Floresta;450;100;180;75;150;300
3038;0;Higienópolis;Glória;57;0;30;15;0;57
3039;0;Higienópolis;Guarujá;50;50;0;0;50;0
3040;0;Higienópolis;Higienópolis;7531;1100;3199;1140;2600;4931
3041;0;Higienópolis;Humaitá;0;0;0;0;0;0
3042;0;Higienópolis;Hípica;0;0;0;0;0;0
3043;0;Higienópolis;Independência;276;150;66;29;150;126
3044;0;Higienópolis;Ipanema;77;0;15;5;50;27
3045;0;Higienópolis;Jardim Botânico;148;50;28;9;100;48
3046;0;Higienópolis;Jardim Carvalho;11;0;5;1;0;11
3047;0;Higienópolis;Jardim Europa;0;0;0;0;0;0
3048;0;Higienópolis;Jardim Floresta;126;50;38;19;50;76
3049;0;Higienópolis;Jardim Isabel;50;0;28;10;0;50
3050;0;Higienópolis;Jardim Itú;50;0;32;7;0;50
3051;0;Higienópolis;Jardim Leopoldina;273;0;134;53;50;223
3052;0;Higienópolis;Jardim Lindóia;201;50;56;24;100;101
3053;0;Higienópolis;Jardim Sabará;100;0;35;12;50;50
3054;0;Higienópolis;Jardim São Pedro;400;0;137;52;150;250
3055;0;Higienópolis;Jardim do Salso;50;0;0;0;50;0
3056;0;Higienópolis;Lageado;0;0;0;0;0;0
3057;0;Higienópolis;Lami;0;0;0;0;0;0
3058;0;Higienópolis;Lomba do Pinheiro;98;50;27;4;50;48
3059;0;Higienópolis;Medianeira;126;50;40;19;50;76
3060;0;Higienópolis;Menino Deus;86;0;41;23;0;86
3061;0;Higienópolis;Moinhos de Vento;100;0;77;10;50;50
3062;0;Higienópolis;Mont'Serrat;932;200;302;78;550;382
3063;0;Higienópolis;Morro Santana;132;0;77;31;0;132
3064;0;Higienópolis;Mário Quintana;145;0;90;16;0;145
3065;0;Higienópolis;Navegantes;120;50;15;2;100;20
3066;0;Higienópolis;Nonoai;144;50;20;10;100;44
3067;0;Higienópolis;Parque Santa Fé;0;0;0;0;0;0
3068;0;Higienópolis;Partenon;167;50;34;12;100;67
3069;0;Higienópolis;Passo D'Areia;2735;550;676;564;1100;1635
3070;0;Higienópolis;Passo das Pedras;167;50;37;14;100;67
3071;0;Higienópolis;Pedra Redonda;50;0;34;15;0;50
3072;0;Higienópolis;Petrópolis;455;0;181;71;150;305
3073;0;Higienópolis;Pitinga;100;0;67;18;0;100
3074;0;Higienópolis;Ponta Grossa;70;0;13;2;50;20
3075;0;Higienópolis;Praia de Belas;50;50;0;0;50;0
3076;0;Higienópolis;Restinga;88;0;56;12;0;88
3077;0;Higienópolis;Rio Branco;78;50;16;6;50;28
3078;0;Higienópolis;Rubem Berta;32;0;14;13;0;32
3079;0;Higienópolis;Santa Cecília;0;0;0;0;0;0
3080;0;Higienópolis;Santa Maria Goretti;1074;600;141;40;850;224
3081;0;Higienópolis;Santa Rosa de Lima;171;50;73;22;50;121
3082;0;Higienópolis;Santa Tereza;171;50;69;25;50;121
3083;0;Higienópolis;Santana;179;50;80;32;50;129
3084;0;Higienópolis;Santo Antônio;61;50;7;3;50;11
3085;0;Higienópolis;Sarandi;292;0;162;72;0;292
3086;0;Higienópolis;Serraria;50;0;32;14;0;50
3087;0;Higienópolis;São Caetano;0;0;0;0;0;0
3088;0;Higienópolis;São Geraldo;50;0;50;0;50;0
3089;0;Higienópolis;São José;75;50;14;5;50;25
3090;0;Higienópolis;São João;588;100;198;67;250;338
3091;0;Higienópolis;São Sebastião;200;50;61;21;100;100
3092;0;Higienópolis;Sétimo Céu;100;50;0;0;100;0
3093;0;Higienópolis;Teresópolis;50;0;0;0;50;0
3094;0;Higienópolis;Tristeza;88;0;56;16;0;88
3095;0;Higienópolis;Três Figueiras;337;50;133;48;100;237
3096;0;Higienópolis;Vila Assunção;62;0;35;15;0;62
3097;0;Higienópolis;Vila Conceição;50;0;24;10;0;50
3098;0;Higienópolis;Vila Ipiranga;171;100;14;7;150;21
3099;0;Higienópolis;Vila Jardim;112;0;59;26;0;112
3100;0;Higienópolis;Vila João Pessoa;50;0;29;9;0;50
3101;0;Higienópolis;Vila Nova;167;0;93;31;0;167
3102;0;Humaitá;Aberta dos Morros;100;0;66;20;0;100
3103;0;Humaitá;Agronomia;0;0;0;0;0;0
3104;0;Humaitá;Anchieta;581;200;98;22;431;150
3105;0;Humaitá;Arquipélago;50;0;30;6;0;50
3106;0;Humaitá;Auxiliadora;339;50;171;71;50;289
3107;0;Humaitá;Azenha;75;0;35;27;0;75
3108;0;Humaitá;Bela Vista;467;50;259;95;50;417
3109;0;Humaitá;Belém Novo;187;0;58;19;87;100
3110;0;Humaitá;Belém Velho;621;0;409;113;0;621
3111;0;Humaitá;Boa Vista;238;0;103;42;50;188
3112;0;Humaitá;Boa Vista do Sul;50;0;32;10;0;50
3113;0;Humaitá;Bom Fim;50;0;40;7;0;50
3114;0;Humaitá;Bom Jesus;986;100;494;136;100;886
3115;0;Humaitá;Camaquã;268;0;168;53;0;268
3116;0;Humaitá;Campo Novo;0;0;0;0;0;0
3117;0;Humaitá;Cascata;50;0;27;9;0;50
3118;0;Humaitá;Cavalhada;1369;0;820;319;0;1369
3119;0;Humaitá;Cel. Aparício Borges;1167;0;698;177;0;1167
3120;0;Humaitá;Centro Histórico;555;50;286;101;50;505
3121;0;Humaitá;Chapéu do Sol;50;0;27;8;0;50
3122;0;Humaitá;Chácara das Pedras;150;0;89;29;0;150
3123;0;Humaitá;Cidade Baixa;336;0;144;64;50;286
3124;0;Humaitá;Costa e Silva;695;0;449;86;0;695
3125;0;Humaitá;Cristal;1656;0;941;309;0;1656
3126;0;Humaitá;Cristo Redentor;921;0;564;204;0;921
3127;0;Humaitá;Espírito Santo;50;0;39;11;0;50
3128;0;Humaitá;Extrema;150;100;32;6;100;50
3129;0;Humaitá;Farrapos;8349;2545;2488;566;4749;3600
3130;0;Humaitá;Farroupilha;0;0;0;0;0;0
3131;0;Humaitá;Floresta;200;100;54;23;100;100
3132;0;Humaitá;Glória;226;50;95;33;50;176
3133;0;Humaitá;Guarujá;100;0;67;16;0;100
3134;0;Humaitá;Higienópolis;198;0;117;44;0;198
3135;0;Humaitá;Humaitá;6512;2274;1437;336;4512;2000
3136;0;Humaitá;Hípica;50;50;0;0;50;0
3137;0;Humaitá;Independência;100;0;62;24;0;100
3138;0;Humaitá;Ipanema;527;0;312;114;50;477
3139;0;Humaitá;Jardim Botânico;758;50;385;156;50;708
3140;0;Humaitá;Jardim Carvalho;410;0;201;64;50;360
3141;0;Humaitá;Jardim Europa;100;0;69;15;0;100
3142;0;Humaitá;Jardim Floresta;50;0;31;12;0;50
3143;0;Humaitá;Jardim Isabel;0;0;0;0;0;0
3144;0;Humaitá;Jardim Itú;199;0;127;37;0;199
3145;0;Humaitá;Jardim Leopoldina;527;0;330;98;0;527
3146;0;Humaitá;Jardim Lindóia;100;0;35;9;50;50
3147;0;Humaitá;Jardim Sabará;50;50;0;0;50;0
3148;0;Humaitá;Jardim São Pedro;150;50;64;9;50;100
3149;0;Humaitá;Jardim do Salso;50;50;0;0;50;0
3150;0;Humaitá;Lageado;87;0;30;8;37;50
3151;0;Humaitá;Lami;50;0;41;3;0;50
3152;0;Humaitá;Lomba do Pinheiro;585;0;358;75;0;585
3153;0;Humaitá;Medianeira;0;0;0;0;0;0
3154;0;Humaitá;Menino Deus;1422;0;751;424;0;1422
3155;0;Humaitá;Moinhos de Vento;100;50;25;12;50;50
3156;0;Humaitá;Mont'Serrat;297;50;117;50;100;197
3157;0;Humaitá;Morro Santana;896;0;550;175;0;896
3158;0;Humaitá;Mário Quintana;2588;0;1537;294;100;2488
3159;0;Humaitá;Navegantes;1148;398;211;58;798;350
3160;0;Humaitá;Nonoai;425;98;187;65;98;327
3161;0;Humaitá;Parque Santa Fé;0;0;0;0;0;0
3162;0;Humaitá;Partenon;899;48;504;171;48;851
3163;0;Humaitá;Passo D'Areia;1398;98;547;470;98;1300
3164;0;Humaitá;Passo das Pedras;804;0;494;132;0;804
3165;0;Humaitá;Pedra Redonda;100;0;34;5;50;50
3166;0;Humaitá;Petrópolis;1294;48;667;303;96;1198
3167;0;Humaitá;Pitinga;50;0;40;9;0;50
3168;0;Humaitá;Ponta Grossa;100;0;27;11;50;50
3169;0;Humaitá;Praia de Belas;100;0;67;22;0;100
3170;0;Humaitá;Restinga;1998;96;1062;259;231;1767
3171;0;Humaitá;Rio Branco;681;0;405;167;0;681
3172;0;Humaitá;Rubem Berta;488;49;211;134;98;390
3173;0;Humaitá;Santa Cecília;50;0;0;0;50;0
3174;0;Humaitá;Santa Maria Goretti;100;50;33;5;50;50
3175;0;Humaitá;Santa Rosa de Lima;305;50;140;41;50;255
3176;0;Humaitá;Santa Tereza;1215;48;630;195;48;1167
3177;0;Humaitá;Santana;787;50;398;197;50;737
3178;0;Humaitá;Santo Antônio;327;50;160;62;50;277
3179;0;Humaitá;Sarandi;3209;0;1638;852;148;3061
3180;0;Humaitá;Serraria;0;0;0;0;0;0
3181;0;Humaitá;São Caetano;100;0;63;22;0;100
3182;0;Humaitá;São Geraldo;150;0;47;37;50;100
3183;0;Humaitá;São José;699;0;420;106;0;699
3184;0;Humaitá;São João;503;100;127;42;303;200
3185;0;Humaitá;São Sebastião;150;0;36;8;100;50
3186;0;Humaitá;Sétimo Céu;50;0;33;2;0;50
3187;0;Humaitá;Teresópolis;100;0;30;9;50;50
3188;0;Humaitá;Tristeza;711;0;435;195;0;711
3189;0;Humaitá;Três Figueiras;200;0;129;38;0;200
3190;0;Humaitá;Vila Assunção;0;0;0;0;0;0
3191;0;Humaitá;Vila Conceição;0;0;0;0;0;0
3192;0;Humaitá;Vila Ipiranga;315;48;162;51;48;267
3193;0;Humaitá;Vila Jardim;493;0;280;148;0;493
3194;0;Humaitá;Vila João Pessoa;0;0;0;0;0;0
3195;0;Humaitá;Vila Nova;2431;0;1465;480;0;2431
3196;0;Hípica;Aberta dos Morros;1400;300;405;93;800;600
3197;0;Hípica;Agronomia;100;0;72;15;0;100
3198;0;Hípica;Anchieta;0;0;0;0;0;0
3199;0;Hípica;Arquipélago;77;0;45;9;0;77
3200;0;Hípica;Auxiliadora;6;0;5;0;0;6
3201;0;Hípica;Azenha;100;50;35;4;50;50
3202;0;Hípica;Bela Vista;134;100;18;10;100;34
3203;0;Hípica;Belém Novo;1681;450;685;147;650;1031
3204;0;Hípica;Belém Velho;286;0;50;21;200;86
3205;0;Hípica;Boa Vista;5;0;3;0;0;5
3206;0;Hípica;Boa Vista do Sul;100;0;64;9;0;100
3207;0;Hípica;Bom Fim;100;0;0;0;100;0
3208;0;Hípica;Bom Jesus;112;100;5;6;100;12
3209;0;Hípica;Camaquã;71;0;45;15;0;71
3210;0;Hípica;Campo Novo;364;100;80;15;250;114
3211;0;Hípica;Cascata;127;0;50;15;50;77
3212;0;Hípica;Cavalhada;217;0;131;40;0;217
3213;0;Hípica;Cel. Aparício Borges;214;50;66;13;100;114
3214;0;Hípica;Centro Histórico;106;0;38;10;50;56
3215;0;Hípica;Chapéu do Sol;4731;1350;1545;345;2350;2381
3216;0;Hípica;Chácara das Pedras;100;0;71;21;0;100
3217;0;Hípica;Cidade Baixa;8;0;4;0;0;8
3218;0;Hípica;Costa e Silva;59;50;8;0;50;9
3219;0;Hípica;Cristal;71;0;37;12;0;71
3220;0;Hípica;Cristo Redentor;190;0;125;33;0;190
3221;0;Hípica;Espírito Santo;250;100;106;20;100;150
3222;0;Hípica;Extrema;0;0;0;0;0;0
3223;0;Hípica;Farrapos;2931;0;1711;585;0;2931
3224;0;Hípica;Farroupilha;0;0;0;0;0;0
3225;0;Hípica;Floresta;0;0;0;0;0;0
3226;0;Hípica;Glória;55;0;41;6;0;55
3227;0;Hípica;Guarujá;290;0;159;28;50;240
3228;0;Hípica;Higienópolis;6;0;3;1;0;6
3229;0;Hípica;Humaitá;50;50;0;0;50;0
3230;0;Hípica;Hípica;7947;3000;951;169;6700;1247
3231;0;Hípica;Independência;50;0;0;0;50;0
3232;0;Hípica;Ipanema;235;50;123;38;50;185
3233;0;Hípica;Jardim Botânico;158;0;71;10;50;108
3234;0;Hípica;Jardim Carvalho;59;0;45;6;0;59
3235;0;Hípica;Jardim Europa;0;0;0;0;0;0
3236;0;Hípica;Jardim Floresta;150;100;35;9;100;50
3237;0;Hípica;Jardim Isabel;214;50;76;19;100;114
3238;0;Hípica;Jardim Itú;52;0;37;11;0;52
3239;0;Hípica;Jardim Leopoldina;9;0;6;0;0;9
3240;0;Hípica;Jardim Lindóia;100;50;50;0;100;0
3241;0;Hípica;Jardim Sabará;0;0;0;0;0;0
3242;0;Hípica;Jardim São Pedro;0;0;0;0;0;0
3243;0;Hípica;Jardim do Salso;150;0;76;15;50;100
3244;0;Hípica;Lageado;350;100;160;31;100;250
3245;0;Hípica;Lami;100;0;33;5;50;50
3246;0;Hípica;Lomba do Pinheiro;107;0;40;9;50;57
3247;0;Hípica;Medianeira;100;0;36;11;50;50
3248;0;Hípica;Menino Deus;187;0;51;16;100;87
3249;0;Hípica;Moinhos de Vento;50;0;37;5;0;50
3250;0;Hípica;Mont'Serrat;55;0;33;9;0;55
3251;0;Hípica;Morro Santana;164;50;73;18;50;114
3252;0;Hípica;Mário Quintana;72;0;15;1;50;22
3253;0;Hípica;Navegantes;50;0;33;10;0;50
3254;0;Hípica;Nonoai;222;50;118;28;50;172
3255;0;Hípica;Parque Santa Fé;0;0;0;0;0;0
3256;0;Hípica;Partenon;60;0;6;1;50;10
3257;0;Hípica;Passo D'Areia;33;0;12;14;0;33
3258;0;Hípica;Passo das Pedras;160;50;74;16;50;110
3259;0;Hípica;Pedra Redonda;100;0;28;9;50;50
3260;0;Hípica;Petrópolis;12;0;8;1;0;12
3261;0;Hípica;Pitinga;151;0;98;19;0;151
3262;0;Hípica;Ponta Grossa;866;250;290;69;400;466
3263;0;Hípica;Praia de Belas;0;0;0;0;0;0
3264;0;Hípica;Restinga;1357;300;490;124;578;779
3265;0;Hípica;Rio Branco;57;0;52;3;50;7
3266;0;Hípica;Rubem Berta;38;0;22;10;0;38
3267;0;Hípica;Santa Cecília;50;0;34;7;0;50
3268;0;Hípica;Santa Maria Goretti;0;0;0;0;0;0
3269;0;Hípica;Santa Rosa de Lima;105;0;33;11;50;55
3270;0;Hípica;Santa Tereza;13;0;10;0;0;13
3271;0;Hípica;Santana;81;0;15;9;50;31
3272;0;Hípica;Santo Antônio;153;0;99;32;0;153
3273;0;Hípica;Sarandi;123;50;46;13;50;73
3274;0;Hípica;Serraria;434;0;189;50;150;284
3275;0;Hípica;São Caetano;0;0;0;0;0;0
3276;0;Hípica;São Geraldo;100;50;36;4;50;50
3277;0;Hípica;São José;207;0;136;30;0;207
3278;0;Hípica;São João;130;50;39;25;50;80
3279;0;Hípica;São Sebastião;0;0;0;0;0;0
3280;0;Hípica;Sétimo Céu;0;0;0;0;0;0
3281;0;Hípica;Teresópolis;150;50;62;17;50;100
3282;0;Hípica;Tristeza;87;0;47;23;0;87
3283;0;Hípica;Três Figueiras;50;50;0;0;50;0
3284;0;Hípica;Vila Assunção;100;0;74;13;0;100
3285;0;Hípica;Vila Conceição;50;0;33;11;0;50
3286;0;Hípica;Vila Ipiranga;34;0;20;5;0;34
3287;0;Hípica;Vila Jardim;70;0;52;12;0;70
3288;0;Hípica;Vila João Pessoa;201;50;97;33;50;151
3289;0;Hípica;Vila Nova;433;50;178;45;150;283
3290;0;Independência;Aberta dos Morros;0;0;0;0;0;0
3291;0;Independência;Agronomia;0;0;0;0;0;0
3292;0;Independência;Anchieta;0;0;0;0;0;0
3293;0;Independência;Arquipélago;100;0;54;15;0;100
3294;0;Independência;Auxiliadora;5;0;1;4;0;5
3295;0;Independência;Azenha;250;100;62;23;150;100
3296;0;Independência;Bela Vista;505;150;154;78;200;305
3297;0;Independência;Belém Novo;50;0;29;17;0;50
3298;0;Independência;Belém Velho;58;0;30;14;0;58
3299;0;Independência;Boa Vista;104;0;49;31;0;104
3300;0;Independência;Boa Vista do Sul;0;0;0;0;0;0
3301;0;Independência;Bom Fim;3450;450;726;473;1850;1600
3302;0;Independência;Bom Jesus;110;0;31;12;50;60
3303;0;Independência;Camaquã;55;50;3;1;50;5
3304;0;Independência;Campo Novo;0;0;0;0;0;0
3305;0;Independência;Cascata;50;0;0;0;50;0
3306;0;Independência;Cavalhada;16;0;7;6;0;16
3307;0;Independência;Cel. Aparício Borges;115;0;58;36;0;115
3308;0;Independência;Centro Histórico;2508;300;751;336;1200;1308
3309;0;Independência;Chapéu do Sol;100;0;52;20;0;100
3310;0;Independência;Chácara das Pedras;150;0;62;49;0;150
3311;0;Independência;Cidade Baixa;655;100;189;95;250;405
3312;0;Independência;Costa e Silva;60;0;43;9;0;60
3313;0;Independência;Cristal;74;0;44;19;0;74
3314;0;Independência;Cristo Redentor;63;0;40;15;0;63
3315;0;Independência;Espírito Santo;50;0;25;15;0;50
3316;0;Independência;Extrema;0;0;0;0;0;0
3317;0;Independência;Farrapos;3506;819;1564;985;611;971
3318;0;Independência;Farroupilha;600;0;146;105;300;300
3319;0;Independência;Floresta;300;100;52;35;200;100
3320;0;Independência;Glória;5;0;3;2;0;5
3321;0;Independência;Guarujá;0;0;0;0;0;0
3322;0;Independência;Higienópolis;305;150;79;37;150;155
3323;0;Independência;Humaitá;100;0;62;24;0;100
3324;0;Independência;Hípica;50;0;0;0;50;0
3325;0;Independência;Independência;3200;600;796;402;1900;1300
3326;0;Independência;Ipanema;8;0;4;3;0;8
3327;0;Independência;Jardim Botânico;260;0;136;70;0;260
3328;0;Independência;Jardim Carvalho;204;50;84;37;50;154
3329;0;Independência;Jardim Europa;50;0;26;16;0;50
3330;0;Independência;Jardim Floresta;50;0;23;18;0;50
3331;0;Independência;Jardim Isabel;150;0;76;46;0;150
3332;0;Independência;Jardim Itú;152;0;50;27;50;102
3333;0;Independência;Jardim Leopoldina;57;0;19;23;0;57
3334;0;Independência;Jardim Lindóia;150;50;81;17;100;50
3335;0;Independência;Jardim Sabará;50;0;30;8;0;50
3336;0;Independência;Jardim São Pedro;0;0;0;0;0;0
3337;0;Independência;Jardim do Salso;50;0;0;0;50;0
3338;0;Independência;Lageado;50;0;19;12;0;50
3339;0;Independência;Lami;0;0;0;0;0;0
3340;0;Independência;Lomba do Pinheiro;159;0;65;15;50;109
3341;0;Independência;Medianeira;150;50;52;28;50;100
3342;0;Independência;Menino Deus;868;100;287;171;300;568
3343;0;Independência;Moinhos de Vento;1200;150;398;332;300;900
3344;0;Independência;Mont'Serrat;254;100;89;31;100;154
3345;0;Independência;Morro Santana;13;0;6;5;0;13
3346;0;Independência;Mário Quintana;172;0;92;10;100;72
3347;0;Independência;Navegantes;250;0;79;11;200;50
3348;0;Independência;Nonoai;155;50;31;14;100;55
3349;0;Independência;Parque Santa Fé;0;0;0;0;0;0
3350;0;Independência;Partenon;212;0;105;58;0;212
3351;0;Independência;Passo D'Areia;216;50;75;67;50;166
3352;0;Independência;Passo das Pedras;62;50;5;2;50;12
3353;0;Independência;Pedra Redonda;0;0;0;0;0;0
3354;0;Independência;Petrópolis;616;100;203;148;200;416
3355;0;Independência;Pitinga;50;50;0;0;50;0
3356;0;Independência;Ponta Grossa;0;0;0;0;0;0
3357;0;Independência;Praia de Belas;50;0;27;16;0;50
3358;0;Independência;Restinga;73;0;41;13;0;73
3359;0;Independência;Rio Branco;1108;50;451;278;250;858
3360;0;Independência;Rubem Berta;206;50;44;38;100;106
3361;0;Independência;Santa Cecília;100;0;49;32;0;100
3362;0;Independência;Santa Maria Goretti;50;0;21;20;0;50
3363;0;Independência;Santa Rosa de Lima;54;0;36;8;0;54
3364;0;Independência;Santa Tereza;266;50;117;44;50;216
3365;0;Independência;Santana;460;100;32;14;400;60
3366;0;Independência;Santo Antônio;156;0;105;42;50;106
3367;0;Independência;Sarandi;423;150;90;53;250;173
3368;0;Independência;Serraria;100;50;34;6;50;50
3369;0;Independência;São Caetano;50;0;0;0;50;0
3370;0;Independência;São Geraldo;300;50;128;78;50;250
3371;0;Independência;São José;160;0;98;30;0;160
3372;0;Independência;São João;450;0;181;62;200;250
3373;0;Independência;São Sebastião;150;50;54;24;50;100
3374;0;Independência;Sétimo Céu;0;0;0;0;0;0
3375;0;Independência;Teresópolis;150;50;57;30;50;100
3376;0;Independência;Tristeza;11;0;7;3;0;11
3377;0;Independência;Três Figueiras;100;0;58;25;0;100
3378;0;Independência;Vila Assunção;100;50;50;0;100;0
3379;0;Independência;Vila Conceição;0;0;0;0;0;0
3380;0;Independência;Vila Ipiranga;155;50;49;35;50;105
3381;0;Independência;Vila Jardim;59;0;5;1;50;9
3382;0;Independência;Vila João Pessoa;50;0;0;0;50;0
3383;0;Independência;Vila Nova;73;0;43;15;0;73
3384;0;Ipanema;Aberta dos Morros;400;0;215;69;50;350
3385;0;Ipanema;Agronomia;50;0;29;15;0;50
3386;0;Ipanema;Anchieta;50;0;21;18;0;50
3387;0;Ipanema;Arquipélago;50;0;26;9;0;50
3388;0;Ipanema;Auxiliadora;7;0;4;3;0;7
3389;0;Ipanema;Azenha;251;100;60;27;150;101
3390;0;Ipanema;Bela Vista;107;50;35;13;50;57
3391;0;Ipanema;Belém Novo;150;0;62;18;50;100
3392;0;Ipanema;Belém Velho;311;50;127;47;100;211
3393;0;Ipanema;Boa Vista;3;0;2;1;0;3
3394;0;Ipanema;Boa Vista do Sul;0;0;0;0;0;0
3395;0;Ipanema;Bom Fim;100;0;49;25;0;100
3396;0;Ipanema;Bom Jesus;12;0;2;1;0;12
3397;0;Ipanema;Camaquã;507;50;174;80;200;307
3398;0;Ipanema;Campo Novo;1100;0;597;212;100;1000
3399;0;Ipanema;Cascata;0;0;0;0;0;0
3400;0;Ipanema;Cavalhada;1982;850;321;88;1610;372
3401;0;Ipanema;Cel. Aparício Borges;115;0;71;17;0;115
3402;0;Ipanema;Centro Histórico;160;0;60;21;50;110
3403;0;Ipanema;Chapéu do Sol;50;50;0;0;50;0
3404;0;Ipanema;Chácara das Pedras;0;0;0;0;0;0
3405;0;Ipanema;Cidade Baixa;106;0;42;24;0;106
3406;0;Ipanema;Costa e Silva;61;0;8;0;50;11
3407;0;Ipanema;Cristal;421;100;129;45;200;221
3408;0;Ipanema;Cristo Redentor;15;0;8;5;0;15
3409;0;Ipanema;Espírito Santo;900;100;419;148;250;650
3410;0;Ipanema;Extrema;0;0;0;0;0;0
3411;0;Ipanema;Farrapos;7492;2742;3169;1198;1552;2684
3412;0;Ipanema;Farroupilha;50;0;32;10;0;50
3413;0;Ipanema;Floresta;50;0;27;18;0;50
3414;0;Ipanema;Glória;103;0;58;22;0;103
3415;0;Ipanema;Guarujá;650;100;227;70;300;350
3416;0;Ipanema;Higienópolis;55;0;3;2;50;5
3417;0;Ipanema;Humaitá;50;0;0;0;50;0
3418;0;Ipanema;Hípica;251;50;139;40;50;201
3419;0;Ipanema;Independência;0;0;0;0;0;0
3420;0;Ipanema;Ipanema;4910;2900;238;75;4500;410
3421;0;Ipanema;Jardim Botânico;11;0;7;2;0;11
3422;0;Ipanema;Jardim Carvalho;6;0;4;2;0;6
3423;0;Ipanema;Jardim Europa;0;0;0;0;0;0
3424;0;Ipanema;Jardim Floresta;50;0;0;0;50;0
3425;0;Ipanema;Jardim Isabel;2500;600;802;279;1150;1350
3426;0;Ipanema;Jardim Itú;0;0;0;0;0;0
3427;0;Ipanema;Jardim Leopoldina;10;0;6;1;0;10
3428;0;Ipanema;Jardim Lindóia;50;0;0;0;50;0
3429;0;Ipanema;Jardim Sabará;50;50;0;0;50;0
3430;0;Ipanema;Jardim São Pedro;0;0;0;0;0;0
3431;0;Ipanema;Jardim do Salso;50;0;0;0;50;0
3432;0;Ipanema;Lageado;0;0;0;0;0;0
3433;0;Ipanema;Lami;0;0;0;0;0;0
3434;0;Ipanema;Lomba do Pinheiro;58;0;36;7;0;58
3435;0;Ipanema;Medianeira;100;100;0;0;100;0
3436;0;Ipanema;Menino Deus;164;50;45;14;100;64
3437;0;Ipanema;Moinhos de Vento;100;0;52;41;0;100
3438;0;Ipanema;Mont'Serrat;53;0;31;13;0;53
3439;0;Ipanema;Morro Santana;115;50;38;14;50;65
3440;0;Ipanema;Mário Quintana;71;0;12;3;50;21
3441;0;Ipanema;Navegantes;0;0;0;0;0;0
3442;0;Ipanema;Nonoai;306;0;96;40;150;156
3443;0;Ipanema;Parque Santa Fé;0;0;0;0;0;0
3444;0;Ipanema;Partenon;114;0;55;24;0;114
3445;0;Ipanema;Passo D'Areia;116;0;18;28;50;66
3446;0;Ipanema;Passo das Pedras;13;0;8;3;0;13
3447;0;Ipanema;Pedra Redonda;550;200;170;69;250;300
3448;0;Ipanema;Petrópolis;116;0;63;34;0;116
3449;0;Ipanema;Pitinga;50;0;23;9;0;50
3450;0;Ipanema;Ponta Grossa;250;100;95;23;100;150
3451;0;Ipanema;Praia de Belas;0;0;0;0;0;0
3452;0;Ipanema;Restinga;570;0;317;79;0;570
3453;0;Ipanema;Rio Branco;60;0;31;18;0;60
3454;0;Ipanema;Rubem Berta;55;0;23;12;0;55
3455;0;Ipanema;Santa Cecília;100;0;26;11;50;50
3456;0;Ipanema;Santa Maria Goretti;0;0;0;0;0;0
3457;0;Ipanema;Santa Rosa de Lima;3;0;0;1;0;3
3458;0;Ipanema;Santa Tereza;515;50;92;40;350;165
3459;0;Ipanema;Santana;111;0;48;32;0;111
3460;0;Ipanema;Santo Antônio;104;0;55;23;0;104
3461;0;Ipanema;Sarandi;203;0;108;62;0;203
3462;0;Ipanema;Serraria;700;100;275;97;200;500
3463;0;Ipanema;São Caetano;0;0;0;0;0;0
3464;0;Ipanema;São Geraldo;0;0;0;0;0;0
3465;0;Ipanema;São José;209;50;102;32;50;159
3466;0;Ipanema;São João;150;0;84;42;0;150
3467;0;Ipanema;São Sebastião;50;0;29;12;0;50
3468;0;Ipanema;Sétimo Céu;1200;0;576;213;250;950
3469;0;Ipanema;Teresópolis;500;300;51;27;400;100
3470;0;Ipanema;Tristeza;662;100;274;114;200;462
3471;0;Ipanema;Três Figueiras;50;50;0;0;50;0
3472;0;Ipanema;Vila Assunção;100;0;63;17;0;100
3473;0;Ipanema;Vila Conceição;1011;150;513;194;161;850
3474;0;Ipanema;Vila Ipiranga;4;0;2;2;0;4
3475;0;Ipanema;Vila Jardim;60;0;7;0;50;10
3476;0;Ipanema;Vila João Pessoa;50;0;0;0;50;0
3477;0;Ipanema;Vila Nova;1271;50;640;236;200;1071
3478;0;Jardim Botânico;Aberta dos Morros;50;0;24;15;0;50
3479;0;Jardim Botânico;Agronomia;76;0;18;2;50;26
3480;0;Jardim Botânico;Anchieta;0;0;0;0;0;0
3481;0;Jardim Botânico;Arquipélago;53;0;28;13;0;53
3482;0;Jardim Botânico;Auxiliadora;100;50;25;10;50;50
3483;0;Jardim Botânico;Azenha;270;100;114;26;150;120
3484;0;Jardim Botânico;Bela Vista;324;148;44;17;247;77
3485;0;Jardim Botânico;Belém Novo;100;0;32;10;50;50
3486;0;Jardim Botânico;Belém Velho;103;0;27;14;50;53
3487;0;Jardim Botânico;Boa Vista;103;0;52;22;0;103
3488;0;Jardim Botânico;Boa Vista do Sul;0;0;0;0;0;0
3489;0;Jardim Botânico;Bom Fim;45;0;26;9;0;45
3490;0;Jardim Botânico;Bom Jesus;552;196;129;23;408;144
3491;0;Jardim Botânico;Camaquã;174;147;12;7;147;27
3492;0;Jardim Botânico;Campo Novo;50;50;0;0;50;0
3493;0;Jardim Botânico;Cascata;546;148;151;43;285;261
3494;0;Jardim Botânico;Cavalhada;37;0;21;8;0;37
3495;0;Jardim Botânico;Cel. Aparício Borges;787;246;105;32;610;177
3496;0;Jardim Botânico;Centro Histórico;182;0;99;45;0;182
3497;0;Jardim Botânico;Chapéu do Sol;150;100;27;14;100;50
3498;0;Jardim Botânico;Chácara das Pedras;264;98;87;41;98;166
3499;0;Jardim Botânico;Cidade Baixa;116;0;78;16;38;78
3500;0;Jardim Botânico;Costa e Silva;58;0;35;9;0;58
3501;0;Jardim Botânico;Cristal;356;0;133;50;135;221
3502;0;Jardim Botânico;Cristo Redentor;5;0;4;1;0;5
3503;0;Jardim Botânico;Espírito Santo;100;0;32;14;50;50
3504;0;Jardim Botânico;Extrema;100;0;56;21;0;100
3505;0;Jardim Botânico;Farrapos;13744;2007;6554;2464;2279;8496
3506;0;Jardim Botânico;Farroupilha;100;50;0;0;100;0
3507;0;Jardim Botânico;Floresta;53;0;2;1;50;3
3508;0;Jardim Botânico;Glória;278;98;130;33;136;142
3509;0;Jardim Botânico;Guarujá;100;0;66;18;0;100
3510;0;Jardim Botânico;Higienópolis;150;50;32;8;100;50
3511;0;Jardim Botânico;Humaitá;150;50;60;15;50;100
3512;0;Jardim Botânico;Hípica;65;0;8;3;50;15
3513;0;Jardim Botânico;Independência;201;0;110;51;0;201
3514;0;Jardim Botânico;Ipanema;4;0;4;0;0;4
3515;0;Jardim Botânico;Jardim Botânico;5742;97;3028;1115;658;5084
3516;0;Jardim Botânico;Jardim Carvalho;260;150;64;22;150;110
3517;0;Jardim Botânico;Jardim Europa;100;100;0;0;100;0
3518;0;Jardim Botânico;Jardim Floresta;0;0;0;0;0;0
3519;0;Jardim Botânico;Jardim Isabel;50;0;28;10;0;50
3520;0;Jardim Botânico;Jardim Itú;51;0;26;15;0;51
3521;0;Jardim Botânico;Jardim Leopoldina;3;0;1;1;0;3
3522;0;Jardim Botânico;Jardim Lindóia;150;0;58;20;50;100
3523;0;Jardim Botânico;Jardim Sabará;150;0;81;6;100;50
3524;0;Jardim Botânico;Jardim São Pedro;76;0;39;21;0;76
3525;0;Jardim Botânico;Jardim do Salso;635;199;106;26;535;100
3526;0;Jardim Botânico;Lageado;0;0;0;0;0;0
3527;0;Jardim Botânico;Lami;0;0;0;0;0;0
3528;0;Jardim Botânico;Lomba do Pinheiro;492;97;207;46;145;347
3529;0;Jardim Botânico;Medianeira;318;48;92;34;148;170
3530;0;Jardim Botânico;Menino Deus;58;48;3;4;48;10
3531;0;Jardim Botânico;Moinhos de Vento;148;49;33;10;98;50
3532;0;Jardim Botânico;Mont'Serrat;250;200;0;0;250;0
3533;0;Jardim Botânico;Morro Santana;92;0;51;2;87;5
3534;0;Jardim Botânico;Mário Quintana;58;0;7;2;37;21
3535;0;Jardim Botânico;Navegantes;50;0;0;0;50;0
3536;0;Jardim Botânico;Nonoai;89;0;30;16;37;52
3537;0;Jardim Botânico;Parque Santa Fé;0;0;0;0;0;0
3538;0;Jardim Botânico;Partenon;529;0;295;91;48;481
3539;0;Jardim Botânico;Passo D'Areia;401;50;123;33;246;155
3540;0;Jardim Botânico;Passo das Pedras;223;48;67;31;98;125
3541;0;Jardim Botânico;Pedra Redonda;0;0;0;0;0;0
3542;0;Jardim Botânico;Petrópolis;1685;441;233;21;1605;80
3543;0;Jardim Botânico;Pitinga;0;0;0;0;0;0
3544;0;Jardim Botânico;Ponta Grossa;153;50;24;9;100;53
3545;0;Jardim Botânico;Praia de Belas;50;0;31;9;0;50
3546;0;Jardim Botânico;Restinga;202;50;84;25;50;152
3547;0;Jardim Botânico;Rio Branco;93;0;47;24;0;93
3548;0;Jardim Botânico;Rubem Berta;148;48;50;35;48;100
3549;0;Jardim Botânico;Santa Cecília;129;0;66;26;0;129
3550;0;Jardim Botânico;Santa Maria Goretti;50;0;31;10;0;50
3551;0;Jardim Botânico;Santa Rosa de Lima;300;0;157;57;50;250
3552;0;Jardim Botânico;Santa Tereza;189;100;45;14;100;89
3553;0;Jardim Botânico;Santana;80;0;41;22;0;80
3554;0;Jardim Botânico;Santo Antônio;324;98;121;51;98;226
3555;0;Jardim Botânico;Sarandi;99;0;56;29;0;99
3556;0;Jardim Botânico;Serraria;50;0;28;14;0;50
3557;0;Jardim Botânico;São Caetano;0;0;0;0;0;0
3558;0;Jardim Botânico;São Geraldo;0;0;0;0;0;0
3559;0;Jardim Botânico;São José;225;48;103;31;48;177
3560;0;Jardim Botânico;São João;174;50;63;5;148;26
3561;0;Jardim Botânico;São Sebastião;50;50;0;0;50;0
3562;0;Jardim Botânico;Sétimo Céu;50;0;32;11;0;50
3563;0;Jardim Botânico;Teresópolis;70;50;15;4;50;20
3564;0;Jardim Botânico;Tristeza;4;0;3;0;0;4
3565;0;Jardim Botânico;Três Figueiras;150;0;61;20;50;100
3566;0;Jardim Botânico;Vila Assunção;50;0;35;10;0;50
3567;0;Jardim Botânico;Vila Conceição;0;0;0;0;0;0
3568;0;Jardim Botânico;Vila Ipiranga;191;50;28;20;138;53
3569;0;Jardim Botânico;Vila Jardim;4;0;1;1;0;4
3570;0;Jardim Botânico;Vila João Pessoa;584;248;132;54;348;236
3571;0;Jardim Botânico;Vila Nova;68;0;44;15;0;68
3572;0;Jardim Carvalho;Aberta dos Morros;0;0;0;0;0;0
3573;0;Jardim Carvalho;Agronomia;3347;1300;334;45;3047;300
3574;0;Jardim Carvalho;Anchieta;100;0;25;14;50;50
3575;0;Jardim Carvalho;Arquipélago;100;0;0;0;100;0
3576;0;Jardim Carvalho;Auxiliadora;151;0;1;0;150;1
3577;0;Jardim Carvalho;Azenha;200;100;67;22;100;100
3578;0;Jardim Carvalho;Bela Vista;152;0;61;19;50;102
3579;0;Jardim Carvalho;Belém Novo;200;50;92;36;50;150
3580;0;Jardim Carvalho;Belém Velho;3;0;2;1;0;3
3581;0;Jardim Carvalho;Boa Vista;350;100;138;46;100;250
3582;0;Jardim Carvalho;Boa Vista do Sul;50;0;35;5;0;50
3583;0;Jardim Carvalho;Bom Fim;150;0;80;55;0;150
3584;0;Jardim Carvalho;Bom Jesus;2958;500;1263;340;1050;1908
3585;0;Jardim Carvalho;Camaquã;52;50;2;0;50;2
3586;0;Jardim Carvalho;Campo Novo;100;0;67;13;0;100
3587;0;Jardim Carvalho;Cascata;750;200;326;90;250;500
3588;0;Jardim Carvalho;Cavalhada;314;0;196;59;0;314
3589;0;Jardim Carvalho;Cel. Aparício Borges;662;150;283;82;200;462
3590;0;Jardim Carvalho;Centro Histórico;153;0;53;20;50;103
3591;0;Jardim Carvalho;Chapéu do Sol;100;0;53;14;0;100
3592;0;Jardim Carvalho;Chácara das Pedras;300;0;198;65;0;300
3593;0;Jardim Carvalho;Cidade Baixa;51;0;28;14;0;51
3594;0;Jardim Carvalho;Costa e Silva;155;50;25;12;100;55
3595;0;Jardim Carvalho;Cristal;67;0;45;11;0;67
3596;0;Jardim Carvalho;Cristo Redentor;8;0;5;1;0;8
3597;0;Jardim Carvalho;Espírito Santo;100;0;80;15;50;50
3598;0;Jardim Carvalho;Extrema;50;0;30;18;0;50
3599;0;Jardim Carvalho;Farrapos;100;50;31;17;50;50
3600;0;Jardim Carvalho;Farroupilha;100;50;25;17;50;50
3601;0;Jardim Carvalho;Floresta;50;0;29;15;0;50
3602;0;Jardim Carvalho;Glória;450;150;122;39;250;200
3603;0;Jardim Carvalho;Guarujá;100;50;27;7;50;50
3604;0;Jardim Carvalho;Higienópolis;1;0;1;0;0;1
3605;0;Jardim Carvalho;Humaitá;200;0;87;30;50;150
3606;0;Jardim Carvalho;Hípica;100;0;67;16;0;100
3607;0;Jardim Carvalho;Independência;200;50;80;37;50;150
3608;0;Jardim Carvalho;Ipanema;2;0;1;1;0;2
3609;0;Jardim Carvalho;Jardim Botânico;404;150;153;54;150;254
3610;0;Jardim Carvalho;Jardim Carvalho;19955;2000;9707;2826;4854;15101
3611;0;Jardim Carvalho;Jardim Europa;350;50;87;39;200;150
3612;0;Jardim Carvalho;Jardim Floresta;50;0;27;10;0;50
3613;0;Jardim Carvalho;Jardim Isabel;200;0;84;29;50;150
3614;0;Jardim Carvalho;Jardim Itú;300;50;115;45;100;200
3615;0;Jardim Carvalho;Jardim Leopoldina;4;0;2;1;0;4
3616;0;Jardim Carvalho;Jardim Lindóia;50;0;29;7;0;50
3617;0;Jardim Carvalho;Jardim Sabará;600;50;288;113;100;500
3618;0;Jardim Carvalho;Jardim São Pedro;0;0;0;0;0;0
3619;0;Jardim Carvalho;Jardim do Salso;1400;250;544;192;450;950
3620;0;Jardim Carvalho;Lageado;100;0;66;15;0;100
3621;0;Jardim Carvalho;Lami;100;0;55;18;0;100
3622;0;Jardim Carvalho;Lomba do Pinheiro;1154;350;438;132;400;754
3623;0;Jardim Carvalho;Medianeira;150;50;62;21;50;100
3624;0;Jardim Carvalho;Menino Deus;167;0;102;45;0;167
3625;0;Jardim Carvalho;Moinhos de Vento;400;100;132;63;150;250
3626;0;Jardim Carvalho;Mont'Serrat;150;50;55;27;50;100
3627;0;Jardim Carvalho;Morro Santana;558;150;187;51;250;308
3628;0;Jardim Carvalho;Mário Quintana;290;100;114;33;100;190
3629;0;Jardim Carvalho;Navegantes;100;50;28;13;50;50
3630;0;Jardim Carvalho;Nonoai;101;50;29;8;50;51
3631;0;Jardim Carvalho;Parque Santa Fé;100;0;0;0;100;0
3632;0;Jardim Carvalho;Partenon;2858;1550;325;89;2450;408
3633;0;Jardim Carvalho;Passo D'Areia;9;0;3;5;0;9
3634;0;Jardim Carvalho;Passo das Pedras;309;50;109;19;200;109
3635;0;Jardim Carvalho;Pedra Redonda;0;0;0;0;0;0
3636;0;Jardim Carvalho;Petrópolis;462;150;137;40;250;212
3637;0;Jardim Carvalho;Pitinga;100;0;57;29;0;100
3638;0;Jardim Carvalho;Ponta Grossa;100;0;57;26;0;100
3639;0;Jardim Carvalho;Praia de Belas;150;0;85;45;0;150
3640;0;Jardim Carvalho;Restinga;366;100;174;48;150;216
3641;0;Jardim Carvalho;Rio Branco;102;50;32;9;50;52
3642;0;Jardim Carvalho;Rubem Berta;202;0;133;58;50;152
3643;0;Jardim Carvalho;Santa Cecília;100;0;57;15;0;100
3644;0;Jardim Carvalho;Santa Maria Goretti;150;50;53;10;50;100
3645;0;Jardim Carvalho;Santa Rosa de Lima;200;50;101;23;50;150
3646;0;Jardim Carvalho;Santa Tereza;161;0;82;38;0;161
3647;0;Jardim Carvalho;Santana;103;0;56;29;0;103
3648;0;Jardim Carvalho;Santo Antônio;402;150;64;39;250;152
3649;0;Jardim Carvalho;Sarandi;370;50;88;48;200;170
3650;0;Jardim Carvalho;Serraria;150;50;33;5;100;50
3651;0;Jardim Carvalho;São Caetano;100;50;29;14;50;50
3652;0;Jardim Carvalho;São Geraldo;100;50;28;10;50;50
3653;0;Jardim Carvalho;São José;803;100;290;76;400;403
3654;0;Jardim Carvalho;São João;100;0;32;9;50;50
3655;0;Jardim Carvalho;São Sebastião;50;50;0;0;50;0
3656;0;Jardim Carvalho;Sétimo Céu;0;0;0;0;0;0
3657;0;Jardim Carvalho;Teresópolis;100;50;0;0;100;0
3658;0;Jardim Carvalho;Tristeza;55;0;33;9;0;55
3659;0;Jardim Carvalho;Três Figueiras;150;0;80;24;0;150
3660;0;Jardim Carvalho;Vila Assunção;50;0;29;12;0;50
3661;0;Jardim Carvalho;Vila Conceição;0;0;0;0;0;0
3662;0;Jardim Carvalho;Vila Ipiranga;200;150;30;15;150;50
3663;0;Jardim Carvalho;Vila Jardim;703;0;443;107;150;553
3664;0;Jardim Carvalho;Vila João Pessoa;1500;50;799;264;150;1350
3665;0;Jardim Carvalho;Vila Nova;387;100;128;53;150;237
3666;0;Jardim Europa;Aberta dos Morros;0;0;0;0;0;0
3667;0;Jardim Europa;Agronomia;0;0;0;0;0;0
3668;0;Jardim Europa;Anchieta;0;0;0;0;0;0
3669;0;Jardim Europa;Arquipélago;0;0;0;0;0;0
3670;0;Jardim Europa;Auxiliadora;51;0;24;12;0;51
3671;0;Jardim Europa;Azenha;100;0;29;10;50;50
3672;0;Jardim Europa;Bela Vista;53;0;32;12;0;53
3673;0;Jardim Europa;Belém Novo;0;0;0;0;0;0
3674;0;Jardim Europa;Belém Velho;8;0;5;1;0;8
3675;0;Jardim Europa;Boa Vista;270;0;142;36;119;151
3676;0;Jardim Europa;Boa Vista do Sul;0;0;0;0;0;0
3677;0;Jardim Europa;Bom Fim;50;50;0;0;50;0
3678;0;Jardim Europa;Bom Jesus;613;0;293;80;150;463
3679;0;Jardim Europa;Camaquã;0;0;0;0;0;0
3680;0;Jardim Europa;Campo Novo;0;0;0;0;0;0
3681;0;Jardim Europa;Cascata;50;0;31;4;0;50
3682;0;Jardim Europa;Cavalhada;19;0;11;2;0;19
3683;0;Jardim Europa;Cel. Aparício Borges;16;0;13;2;0;16
3684;0;Jardim Europa;Centro Histórico;208;0;35;12;150;58
3685;0;Jardim Europa;Chapéu do Sol;50;0;24;14;0;50
3686;0;Jardim Europa;Chácara das Pedras;550;400;92;40;400;150
3687;0;Jardim Europa;Cidade Baixa;53;0;27;12;0;53
3688;0;Jardim Europa;Costa e Silva;9;0;6;2;0;9
3689;0;Jardim Europa;Cristal;170;0;70;28;50;120
3690;0;Jardim Europa;Cristo Redentor;511;200;101;29;350;161
3691;0;Jardim Europa;Espírito Santo;0;0;0;0;0;0
3692;0;Jardim Europa;Extrema;0;0;0;0;0;0
3693;0;Jardim Europa;Farrapos;150;50;60;14;50;100
3694;0;Jardim Europa;Farroupilha;0;0;0;0;0;0
3695;0;Jardim Europa;Floresta;50;0;41;6;0;50
3696;0;Jardim Europa;Glória;100;50;0;0;100;0
3697;0;Jardim Europa;Guarujá;0;0;0;0;0;0
3698;0;Jardim Europa;Higienópolis;0;0;0;0;0;0
3699;0;Jardim Europa;Humaitá;100;0;69;15;0;100
3700;0;Jardim Europa;Hípica;0;0;0;0;0;0
3701;0;Jardim Europa;Independência;50;0;26;16;0;50
3702;0;Jardim Europa;Ipanema;7;0;3;3;0;7
3703;0;Jardim Europa;Jardim Botânico;111;100;7;3;100;11
3704;0;Jardim Europa;Jardim Carvalho;351;50;88;39;200;151
3705;0;Jardim Europa;Jardim Europa;1500;200;762;250;300;1200
3706;0;Jardim Europa;Jardim Floresta;0;0;0;0;0;0
3707;0;Jardim Europa;Jardim Isabel;0;0;0;0;0;0
3708;0;Jardim Europa;Jardim Itú;501;50;200;76;150;351
3709;0;Jardim Europa;Jardim Leopoldina;58;0;34;9;0;58
3710;0;Jardim Europa;Jardim Lindóia;200;0;110;55;0;200
3711;0;Jardim Europa;Jardim Sabará;200;0;77;46;50;150
3712;0;Jardim Europa;Jardim São Pedro;150;0;52;27;50;100
3713;0;Jardim Europa;Jardim do Salso;100;50;28;11;50;50
3714;0;Jardim Europa;Lageado;0;0;0;0;0;0
3715;0;Jardim Europa;Lami;0;0;0;0;0;0
3716;0;Jardim Europa;Lomba do Pinheiro;57;0;34;5;0;57
3717;0;Jardim Europa;Medianeira;0;0;0;0;0;0
3718;0;Jardim Europa;Menino Deus;165;0;86;59;0;165
3719;0;Jardim Europa;Moinhos de Vento;50;0;23;18;0;50
3720;0;Jardim Europa;Mont'Serrat;100;0;0;0;100;0
3721;0;Jardim Europa;Morro Santana;207;0;94;31;46;161
3722;0;Jardim Europa;Mário Quintana;231;0;74;15;100;131
3723;0;Jardim Europa;Navegantes;0;0;0;0;0;0
3724;0;Jardim Europa;Nonoai;53;0;28;11;0;53
3725;0;Jardim Europa;Parque Santa Fé;0;0;0;0;0;0
3726;0;Jardim Europa;Partenon;211;50;7;3;200;11
3727;0;Jardim Europa;Passo D'Areia;763;150;195;132;350;413
3728;0;Jardim Europa;Passo das Pedras;61;0;37;13;0;61
3729;0;Jardim Europa;Pedra Redonda;0;0;0;0;0;0
3730;0;Jardim Europa;Petrópolis;516;50;152;81;250;266
3731;0;Jardim Europa;Pitinga;50;0;35;4;0;50
3732;0;Jardim Europa;Ponta Grossa;0;0;0;0;0;0
3733;0;Jardim Europa;Praia de Belas;0;0;0;0;0;0
3734;0;Jardim Europa;Restinga;19;0;12;3;0;19
3735;0;Jardim Europa;Rio Branco;208;0;82;10;150;58
3736;0;Jardim Europa;Rubem Berta;201;0;59;70;50;151
3737;0;Jardim Europa;Santa Cecília;0;0;0;0;0;0
3738;0;Jardim Europa;Santa Maria Goretti;50;50;0;0;50;0
3739;0;Jardim Europa;Santa Rosa de Lima;251;100;52;19;150;101
3740;0;Jardim Europa;Santa Tereza;114;0;61;30;0;114
3741;0;Jardim Europa;Santana;107;50;27;27;50;57
3742;0;Jardim Europa;Santo Antônio;101;50;24;16;50;51
3743;0;Jardim Europa;Sarandi;980;50;465;236;100;880
3744;0;Jardim Europa;Serraria;0;0;0;0;0;0
3745;0;Jardim Europa;São Caetano;0;0;0;0;0;0
3746;0;Jardim Europa;São Geraldo;100;0;22;10;50;50
3747;0;Jardim Europa;São José;158;50;37;9;100;58
3748;0;Jardim Europa;São João;100;0;47;32;0;100
3749;0;Jardim Europa;São Sebastião;100;50;0;0;100;0
3750;0;Jardim Europa;Sétimo Céu;0;0;0;0;0;0
3751;0;Jardim Europa;Teresópolis;300;0;163;47;50;250
3752;0;Jardim Europa;Tristeza;59;50;7;2;50;9
3753;0;Jardim Europa;Três Figueiras;300;100;85;38;150;150
3754;0;Jardim Europa;Vila Assunção;0;0;0;0;0;0
3755;0;Jardim Europa;Vila Conceição;0;0;0;0;0;0
3756;0;Jardim Europa;Vila Ipiranga;3251;500;1548;608;700;2551
3757;0;Jardim Europa;Vila Jardim;658;150;225;112;250;408
3758;0;Jardim Europa;Vila João Pessoa;100;0;69;16;0;100
3759;0;Jardim Europa;Vila Nova;180;0;90;34;0;180
3760;0;Jardim Floresta;Aberta dos Morros;50;0;0;0;50;0
3761;0;Jardim Floresta;Agronomia;0;0;0;0;0;0
3762;0;Jardim Floresta;Anchieta;0;0;0;0;0;0
3763;0;Jardim Floresta;Arquipélago;100;50;22;14;50;50
3764;0;Jardim Floresta;Auxiliadora;107;0;59;33;0;107
3765;0;Jardim Floresta;Azenha;0;0;0;0;0;0
3766;0;Jardim Floresta;Bela Vista;111;0;66;23;0;111
3767;0;Jardim Floresta;Belém Novo;0;0;0;0;0;0
3768;0;Jardim Floresta;Belém Velho;119;50;39;15;50;69
3769;0;Jardim Floresta;Boa Vista;205;50;91;36;50;155
3770;0;Jardim Floresta;Boa Vista do Sul;0;0;0;0;0;0
3771;0;Jardim Floresta;Bom Fim;0;0;0;0;0;0
3772;0;Jardim Floresta;Bom Jesus;271;0;125;53;48;223
3773;0;Jardim Floresta;Camaquã;8;0;5;2;0;8
3774;0;Jardim Floresta;Campo Novo;0;0;0;0;0;0
3775;0;Jardim Floresta;Cascata;0;0;0;0;0;0
3776;0;Jardim Floresta;Cavalhada;34;0;22;7;0;34
3777;0;Jardim Floresta;Cel. Aparício Borges;78;0;44;10;0;78
3778;0;Jardim Floresta;Centro Histórico;16;0;8;5;0;16
3779;0;Jardim Floresta;Chapéu do Sol;0;0;0;0;0;0
3780;0;Jardim Floresta;Chácara das Pedras;100;0;63;22;0;100
3781;0;Jardim Floresta;Cidade Baixa;58;50;0;4;50;8
3782;0;Jardim Floresta;Costa e Silva;70;50;12;4;50;20
3783;0;Jardim Floresta;Cristal;183;0;121;34;50;133
3784;0;Jardim Floresta;Cristo Redentor;1840;150;884;334;419;1421
3785;0;Jardim Floresta;Espírito Santo;50;0;28;9;0;50
3786;0;Jardim Floresta;Extrema;0;0;0;0;0;0
3787;0;Jardim Floresta;Farrapos;2090;759;596;276;796;510
3788;0;Jardim Floresta;Farroupilha;0;0;0;0;0;0
3789;0;Jardim Floresta;Floresta;135;0;57;17;35;100
3790;0;Jardim Floresta;Glória;55;0;29;10;0;55
3791;0;Jardim Floresta;Guarujá;0;0;0;0;0;0
3792;0;Jardim Floresta;Higienópolis;155;48;54;30;48;107
3793;0;Jardim Floresta;Humaitá;50;0;31;12;0;50
3794;0;Jardim Floresta;Hípica;150;98;36;10;98;52
3795;0;Jardim Floresta;Independência;50;0;23;18;0;50
3796;0;Jardim Floresta;Ipanema;71;0;12;6;50;21
3797;0;Jardim Floresta;Jardim Botânico;18;0;11;3;0;18
3798;0;Jardim Floresta;Jardim Carvalho;57;0;32;12;0;57
3799;0;Jardim Floresta;Jardim Europa;0;0;0;0;0;0
3800;0;Jardim Floresta;Jardim Floresta;981;198;324;166;381;600
3801;0;Jardim Floresta;Jardim Isabel;0;0;0;0;0;0
3802;0;Jardim Floresta;Jardim Itú;196;96;44;29;96;100
3803;0;Jardim Floresta;Jardim Leopoldina;65;0;49;13;0;65
3804;0;Jardim Floresta;Jardim Lindóia;1844;480;630;269;794;1050
3805;0;Jardim Floresta;Jardim Sabará;100;0;47;33;0;100
3806;0;Jardim Floresta;Jardim São Pedro;385;100;123;72;135;250
3807;0;Jardim Floresta;Jardim do Salso;50;0;32;10;0;50
3808;0;Jardim Floresta;Lageado;0;0;0;0;0;0
3809;0;Jardim Floresta;Lami;0;0;0;0;0;0
3810;0;Jardim Floresta;Lomba do Pinheiro;209;146;39;8;146;63
3811;0;Jardim Floresta;Medianeira;50;0;28;13;0;50
3812;0;Jardim Floresta;Menino Deus;131;50;45;21;50;81
3813;0;Jardim Floresta;Moinhos de Vento;0;0;0;0;0;0
3814;0;Jardim Floresta;Mont'Serrat;90;0;38;15;35;55
3815;0;Jardim Floresta;Morro Santana;75;0;47;12;0;75
3816;0;Jardim Floresta;Mário Quintana;95;0;59;15;0;95
3817;0;Jardim Floresta;Navegantes;100;0;50;25;0;100
3818;0;Jardim Floresta;Nonoai;8;0;6;0;0;8
3819;0;Jardim Floresta;Parque Santa Fé;0;0;0;0;0;0
3820;0;Jardim Floresta;Partenon;320;0;174;53;48;272
3821;0;Jardim Floresta;Passo D'Areia;610;200;108;66;435;175
3822;0;Jardim Floresta;Passo das Pedras;21;0;15;2;0;21
3823;0;Jardim Floresta;Pedra Redonda;0;0;0;0;0;0
3824;0;Jardim Floresta;Petrópolis;311;0;96;46;135;176
3825;0;Jardim Floresta;Pitinga;0;0;0;0;0;0
3826;0;Jardim Floresta;Ponta Grossa;150;0;82;31;0;150
3827;0;Jardim Floresta;Praia de Belas;0;0;0;0;0;0
3828;0;Jardim Floresta;Restinga;178;50;17;5;146;32
3829;0;Jardim Floresta;Rio Branco;119;0;32;26;50;69
3830;0;Jardim Floresta;Rubem Berta;57;0;28;24;0;57
3831;0;Jardim Floresta;Santa Cecília;50;0;27;15;0;50
3832;0;Jardim Floresta;Santa Maria Goretti;200;50;94;26;50;150
3833;0;Jardim Floresta;Santa Rosa de Lima;351;96;127;29;146;205
3834;0;Jardim Floresta;Santa Tereza;74;0;38;14;0;74
3835;0;Jardim Floresta;Santana;122;0;68;35;0;122
3836;0;Jardim Floresta;Santo Antônio;57;50;6;0;50;7
3837;0;Jardim Floresta;Sarandi;690;48;214;101;346;344
3838;0;Jardim Floresta;Serraria;0;0;0;0;0;0
3839;0;Jardim Floresta;São Caetano;0;0;0;0;0;0
3840;0;Jardim Floresta;São Geraldo;100;0;57;23;0;100
3841;0;Jardim Floresta;São José;68;0;46;9;0;68
3842;0;Jardim Floresta;São João;50;0;25;15;0;50
3843;0;Jardim Floresta;São Sebastião;443;144;138;69;193;250
3844;0;Jardim Floresta;Sétimo Céu;0;0;0;0;0;0
3845;0;Jardim Floresta;Teresópolis;50;0;32;10;0;50
3846;0;Jardim Floresta;Tristeza;74;0;40;21;0;74
3847;0;Jardim Floresta;Três Figueiras;100;0;51;28;0;100
3848;0;Jardim Floresta;Vila Assunção;50;0;0;0;50;0
3849;0;Jardim Floresta;Vila Conceição;0;0;0;0;0;0
3850;0;Jardim Floresta;Vila Ipiranga;404;48;230;39;198;206
3851;0;Jardim Floresta;Vila Jardim;163;0;57;33;50;113
3852;0;Jardim Floresta;Vila João Pessoa;0;0;0;0;0;0
3853;0;Jardim Floresta;Vila Nova;97;0;27;7;50;47
3854;0;Jardim Isabel;Aberta dos Morros;54;50;3;1;50;4
3855;0;Jardim Isabel;Agronomia;0;0;0;0;0;0
3856;0;Jardim Isabel;Anchieta;0;0;0;0;0;0
3857;0;Jardim Isabel;Arquipélago;0;0;0;0;0;0
3858;0;Jardim Isabel;Auxiliadora;33;0;24;4;0;33
3859;0;Jardim Isabel;Azenha;0;0;0;0;0;0
3860;0;Jardim Isabel;Bela Vista;32;0;19;7;0;32
3861;0;Jardim Isabel;Belém Novo;0;0;0;0;0;0
3862;0;Jardim Isabel;Belém Velho;159;50;8;0;150;9
3863;0;Jardim Isabel;Boa Vista;31;0;18;7;0;31
3864;0;Jardim Isabel;Boa Vista do Sul;0;0;0;0;0;0
3865;0;Jardim Isabel;Bom Fim;0;0;0;0;0;0
3866;0;Jardim Isabel;Bom Jesus;81;0;49;18;0;81
3867;0;Jardim Isabel;Camaquã;758;150;355;103;250;508
3868;0;Jardim Isabel;Campo Novo;76;0;13;5;50;26
3869;0;Jardim Isabel;Cascata;0;0;0;0;0;0
3870;0;Jardim Isabel;Cavalhada;1944;250;833;299;450;1494
3871;0;Jardim Isabel;Cel. Aparício Borges;190;0;82;29;50;140
3872;0;Jardim Isabel;Centro Histórico;5;0;1;3;0;5
3873;0;Jardim Isabel;Chapéu do Sol;0;0;0;0;0;0
3874;0;Jardim Isabel;Chácara das Pedras;0;0;0;0;0;0
3875;0;Jardim Isabel;Cidade Baixa;7;0;5;0;0;7
3876;0;Jardim Isabel;Costa e Silva;24;0;15;4;0;24
3877;0;Jardim Isabel;Cristal;226;50;96;36;50;176
3878;0;Jardim Isabel;Cristo Redentor;16;0;12;2;0;16
3879;0;Jardim Isabel;Espírito Santo;150;0;85;15;100;50
3880;0;Jardim Isabel;Extrema;0;0;0;0;0;0
3881;0;Jardim Isabel;Farrapos;6604;579;3523;1300;372;5560
3882;0;Jardim Isabel;Farroupilha;0;0;0;0;0;0
3883;0;Jardim Isabel;Floresta;0;0;0;0;0;0
3884;0;Jardim Isabel;Glória;68;50;12;4;50;18
3885;0;Jardim Isabel;Guarujá;141;0;78;41;0;141
3886;0;Jardim Isabel;Higienópolis;11;0;6;2;0;11
3887;0;Jardim Isabel;Humaitá;0;0;0;0;0;0
3888;0;Jardim Isabel;Hípica;191;50;60;20;100;91
3889;0;Jardim Isabel;Independência;80;0;40;22;0;80
3890;0;Jardim Isabel;Ipanema;1796;600;398;116;1150;646
3891;0;Jardim Isabel;Jardim Botânico;37;0;19;8;0;37
3892;0;Jardim Isabel;Jardim Carvalho;135;0;47;21;50;85
3893;0;Jardim Isabel;Jardim Europa;0;0;0;0;0;0
3894;0;Jardim Isabel;Jardim Floresta;0;0;0;0;0;0
3895;0;Jardim Isabel;Jardim Isabel;711;300;210;84;400;311
3896;0;Jardim Isabel;Jardim Itú;53;50;2;1;50;3
3897;0;Jardim Isabel;Jardim Leopoldina;18;0;10;4;0;18
3898;0;Jardim Isabel;Jardim Lindóia;0;0;0;0;0;0
3899;0;Jardim Isabel;Jardim Sabará;13;0;8;1;0;13
3900;0;Jardim Isabel;Jardim São Pedro;0;0;0;0;0;0
3901;0;Jardim Isabel;Jardim do Salso;0;0;0;0;0;0
3902;0;Jardim Isabel;Lageado;0;0;0;0;0;0
3903;0;Jardim Isabel;Lami;0;0;0;0;0;0
3904;0;Jardim Isabel;Lomba do Pinheiro;78;0;13;6;50;28
3905;0;Jardim Isabel;Medianeira;0;0;0;0;0;0
3906;0;Jardim Isabel;Menino Deus;116;100;9;4;100;16
3907;0;Jardim Isabel;Moinhos de Vento;0;0;0;0;0;0
3908;0;Jardim Isabel;Mont'Serrat;31;0;20;6;0;31
3909;0;Jardim Isabel;Morro Santana;89;0;77;3;50;39
3910;0;Jardim Isabel;Mário Quintana;30;0;20;6;0;30
3911;0;Jardim Isabel;Navegantes;0;0;0;0;0;0
3912;0;Jardim Isabel;Nonoai;228;100;14;8;200;28
3913;0;Jardim Isabel;Parque Santa Fé;0;0;0;0;0;0
3914;0;Jardim Isabel;Partenon;129;50;14;7;100;29
3915;0;Jardim Isabel;Passo D'Areia;15;0;7;4;0;15
3916;0;Jardim Isabel;Passo das Pedras;65;0;8;2;50;15
3917;0;Jardim Isabel;Pedra Redonda;350;50;204;62;50;300
3918;0;Jardim Isabel;Petrópolis;65;0;49;13;0;65
3919;0;Jardim Isabel;Pitinga;0;0;0;0;0;0
3920;0;Jardim Isabel;Ponta Grossa;50;0;0;0;50;0
3921;0;Jardim Isabel;Praia de Belas;50;0;35;11;0;50
3922;0;Jardim Isabel;Restinga;35;0;19;5;0;35
3923;0;Jardim Isabel;Rio Branco;5;0;3;2;0;5
3924;0;Jardim Isabel;Rubem Berta;34;0;18;10;0;34
3925;0;Jardim Isabel;Santa Cecília;50;0;28;11;0;50
3926;0;Jardim Isabel;Santa Maria Goretti;0;0;0;0;0;0
3927;0;Jardim Isabel;Santa Rosa de Lima;59;50;3;2;50;9
3928;0;Jardim Isabel;Santa Tereza;141;50;21;7;100;41
3929;0;Jardim Isabel;Santana;60;50;5;2;50;10
3930;0;Jardim Isabel;Santo Antônio;7;0;3;3;0;7
3931;0;Jardim Isabel;Sarandi;107;50;30;12;50;57
3932;0;Jardim Isabel;Serraria;0;0;0;0;0;0
3933;0;Jardim Isabel;São Caetano;0;0;0;0;0;0
3934;0;Jardim Isabel;São Geraldo;0;0;0;0;0;0
3935;0;Jardim Isabel;São José;25;0;17;4;0;25
3936;0;Jardim Isabel;São João;0;0;0;0;0;0
3937;0;Jardim Isabel;São Sebastião;0;0;0;0;0;0
3938;0;Jardim Isabel;Sétimo Céu;317;0;180;60;50;267
3939;0;Jardim Isabel;Teresópolis;0;0;0;0;0;0
3940;0;Jardim Isabel;Tristeza;546;150;202;55;300;246
3941;0;Jardim Isabel;Três Figueiras;0;0;0;0;0;0
3942;0;Jardim Isabel;Vila Assunção;0;0;0;0;0;0
3943;0;Jardim Isabel;Vila Conceição;100;50;30;10;50;50
3944;0;Jardim Isabel;Vila Ipiranga;57;0;30;15;0;57
3945;0;Jardim Isabel;Vila Jardim;7;0;5;1;0;7
3946;0;Jardim Isabel;Vila João Pessoa;126;0;49;10;50;76
3947;0;Jardim Isabel;Vila Nova;317;100;95;30;150;167
3948;0;Jardim Itú;Aberta dos Morros;0;0;0;0;0;0
3949;0;Jardim Itú;Agronomia;150;0;88;26;0;150
3950;0;Jardim Itú;Anchieta;250;100;66;19;150;100
3951;0;Jardim Itú;Arquipélago;50;0;28;11;0;50
3952;0;Jardim Itú;Auxiliadora;154;0;59;25;50;104
3953;0;Jardim Itú;Azenha;100;0;80;11;0;100
3954;0;Jardim Itú;Bela Vista;154;0;101;35;0;154
3955;0;Jardim Itú;Belém Novo;0;0;0;0;0;0
3956;0;Jardim Itú;Belém Velho;8;0;3;2;0;8
3957;0;Jardim Itú;Boa Vista;203;0;86;31;50;153
3958;0;Jardim Itú;Boa Vista do Sul;100;100;0;0;100;0
3959;0;Jardim Itú;Bom Fim;300;50;150;64;50;250
3960;0;Jardim Itú;Bom Jesus;709;0;388;99;100;609
3961;0;Jardim Itú;Camaquã;203;0;123;37;0;203
3962;0;Jardim Itú;Campo Novo;50;50;0;0;50;0
3963;0;Jardim Itú;Cascata;50;0;27;4;0;50
3964;0;Jardim Itú;Cavalhada;222;0;89;25;100;122
3965;0;Jardim Itú;Cel. Aparício Borges;360;50;127;48;150;210
3966;0;Jardim Itú;Centro Histórico;58;0;36;16;0;58
3967;0;Jardim Itú;Chapéu do Sol;100;50;34;13;50;50
3968;0;Jardim Itú;Chácara das Pedras;150;50;63;15;50;100
3969;0;Jardim Itú;Cidade Baixa;106;0;65;24;0;106
3970;0;Jardim Itú;Costa e Silva;508;100;164;26;350;158
3971;0;Jardim Itú;Cristal;320;0;167;50;50;270
3972;0;Jardim Itú;Cristo Redentor;211;100;45;8;150;61
3973;0;Jardim Itú;Espírito Santo;50;50;0;0;50;0
3974;0;Jardim Itú;Extrema;0;0;0;0;0;0
3975;0;Jardim Itú;Farrapos;50;0;26;9;0;50
3976;0;Jardim Itú;Farroupilha;50;0;30;9;0;50
3977;0;Jardim Itú;Floresta;0;0;0;0;0;0
3978;0;Jardim Itú;Glória;2;0;2;0;0;2
3979;0;Jardim Itú;Guarujá;50;50;0;0;50;0
3980;0;Jardim Itú;Higienópolis;153;0;79;37;0;153
3981;0;Jardim Itú;Humaitá;100;0;74;13;0;100
3982;0;Jardim Itú;Hípica;51;0;37;10;0;51
3983;0;Jardim Itú;Independência;150;0;49;26;50;100
3984;0;Jardim Itú;Ipanema;8;0;7;1;0;8
3985;0;Jardim Itú;Jardim Botânico;106;0;60;29;0;106
3986;0;Jardim Itú;Jardim Carvalho;303;50;117;45;100;203
3987;0;Jardim Itú;Jardim Europa;500;50;200;76;150;350
3988;0;Jardim Itú;Jardim Floresta;200;100;44;29;100;100
3989;0;Jardim Itú;Jardim Isabel;50;50;0;0;50;0
3990;0;Jardim Itú;Jardim Itú;9002;3000;2132;790;5400;3602
3991;0;Jardim Itú;Jardim Leopoldina;707;100;284;102;250;457
3992;0;Jardim Itú;Jardim Lindóia;400;50;150;70;150;250
3993;0;Jardim Itú;Jardim Sabará;1750;650;380;144;1150;600
3994;0;Jardim Itú;Jardim São Pedro;250;100;93;34;100;150
3995;0;Jardim Itú;Jardim do Salso;100;50;34;10;50;50
3996;0;Jardim Itú;Lageado;50;0;30;10;0;50
3997;0;Jardim Itú;Lami;50;0;29;5;0;50
3998;0;Jardim Itú;Lomba do Pinheiro;154;0;91;29;0;154
3999;0;Jardim Itú;Medianeira;50;50;0;0;50;0
4000;0;Jardim Itú;Menino Deus;109;50;3;2;100;9
4001;0;Jardim Itú;Moinhos de Vento;100;50;21;23;50;50
4002;0;Jardim Itú;Mont'Serrat;252;50;130;43;50;202
4003;0;Jardim Itú;Morro Santana;710;100;235;69;350;360
4004;0;Jardim Itú;Mário Quintana;583;100;205;51;250;333
4005;0;Jardim Itú;Navegantes;0;0;0;0;0;0
4006;0;Jardim Itú;Nonoai;55;0;4;1;50;5
4007;0;Jardim Itú;Parque Santa Fé;351;100;62;23;251;100
4008;0;Jardim Itú;Partenon;210;0;97;31;50;160
4009;0;Jardim Itú;Passo D'Areia;710;100;399;105;100;610
4010;0;Jardim Itú;Passo das Pedras;3423;350;1468;511;964;2459
4011;0;Jardim Itú;Pedra Redonda;0;0;0;0;0;0
4012;0;Jardim Itú;Petrópolis;460;0;227;110;50;410
4013;0;Jardim Itú;Pitinga;0;0;0;0;0;0
4014;0;Jardim Itú;Ponta Grossa;0;0;0;0;0;0
4015;0;Jardim Itú;Praia de Belas;100;0;62;23;0;100
4016;0;Jardim Itú;Restinga;272;50;123;42;50;222
4017;0;Jardim Itú;Rio Branco;58;0;35;12;0;58
4018;0;Jardim Itú;Rubem Berta;603;200;236;125;250;353
4019;0;Jardim Itú;Santa Cecília;100;100;0;0;100;0
4020;0;Jardim Itú;Santa Maria Goretti;500;50;229;80;100;400
4021;0;Jardim Itú;Santa Rosa de Lima;503;50;236;75;100;403
4022;0;Jardim Itú;Santa Tereza;310;100;65;23;200;110
4023;0;Jardim Itú;Santana;158;50;80;17;100;58
4024;0;Jardim Itú;Santo Antônio;52;0;34;8;0;52
4025;0;Jardim Itú;Sarandi;634;100;289;150;100;534
4026;0;Jardim Itú;Serraria;150;50;73;18;50;100
4027;0;Jardim Itú;São Caetano;100;100;0;0;100;0
4028;0;Jardim Itú;São Geraldo;0;0;0;0;0;0
4029;0;Jardim Itú;São José;156;150;3;1;150;6
4030;0;Jardim Itú;São João;150;50;24;14;100;50
4031;0;Jardim Itú;São Sebastião;500;0;228;82;100;400
4032;0;Jardim Itú;Sétimo Céu;0;0;0;0;0;0
4033;0;Jardim Itú;Teresópolis;150;50;63;26;50;100
4034;0;Jardim Itú;Tristeza;60;0;7;2;50;10
4035;0;Jardim Itú;Três Figueiras;50;0;0;0;50;0
4036;0;Jardim Itú;Vila Assunção;0;0;0;0;0;0
4037;0;Jardim Itú;Vila Conceição;200;0;137;43;0;200
4038;0;Jardim Itú;Vila Ipiranga;1402;350;595;247;400;1002
4039;0;Jardim Itú;Vila Jardim;1407;100;711;319;150;1257
4040;0;Jardim Itú;Vila João Pessoa;201;50;94;27;50;151
4041;0;Jardim Itú;Vila Nova;83;0;20;9;50;33
4042;0;Jardim Leopoldina;Aberta dos Morros;50;0;28;7;0;50
4043;0;Jardim Leopoldina;Agronomia;150;0;66;18;50;100
4044;0;Jardim Leopoldina;Anchieta;150;50;38;7;100;50
4045;0;Jardim Leopoldina;Arquipélago;100;100;0;0;100;0
4046;0;Jardim Leopoldina;Auxiliadora;50;50;0;0;50;0
4047;0;Jardim Leopoldina;Azenha;0;0;0;0;0;0
4048;0;Jardim Leopoldina;Bela Vista;50;0;36;8;0;50
4049;0;Jardim Leopoldina;Belém Novo;100;50;0;0;100;0
4050;0;Jardim Leopoldina;Belém Velho;108;50;32;13;50;58
4051;0;Jardim Leopoldina;Boa Vista;50;0;0;0;50;0
4052;0;Jardim Leopoldina;Boa Vista do Sul;100;50;0;0;100;0
4053;0;Jardim Leopoldina;Bom Fim;50;0;27;10;0;50
4054;0;Jardim Leopoldina;Bom Jesus;158;0;67;12;50;108
4055;0;Jardim Leopoldina;Camaquã;48;48;0;0;48;0
4056;0;Jardim Leopoldina;Campo Novo;98;50;0;0;98;0
4057;0;Jardim Leopoldina;Cascata;0;0;0;0;0;0
4058;0;Jardim Leopoldina;Cavalhada;243;0;118;41;35;208
4059;0;Jardim Leopoldina;Cel. Aparício Borges;108;0;60;17;0;108
4060;0;Jardim Leopoldina;Centro Histórico;107;0;59;18;0;107
4061;0;Jardim Leopoldina;Chapéu do Sol;0;0;0;0;0;0
4062;0;Jardim Leopoldina;Chácara das Pedras;400;0;252;75;0;400
4063;0;Jardim Leopoldina;Cidade Baixa;50;0;0;0;50;0
4064;0;Jardim Leopoldina;Costa e Silva;4357;650;1816;484;1550;2807
4065;0;Jardim Leopoldina;Cristal;289;97;29;9;230;59
4066;0;Jardim Leopoldina;Cristo Redentor;58;0;31;22;0;58
4067;0;Jardim Leopoldina;Espírito Santo;0;0;0;0;0;0
4068;0;Jardim Leopoldina;Extrema;50;50;0;0;50;0
4069;0;Jardim Leopoldina;Farrapos;9074;3341;3536;1110;2538;2263
4070;0;Jardim Leopoldina;Farroupilha;50;0;40;7;0;50
4071;0;Jardim Leopoldina;Floresta;100;0;22;13;50;50
4072;0;Jardim Leopoldina;Glória;50;0;30;9;0;50
4073;0;Jardim Leopoldina;Guarujá;100;0;0;0;100;0
4074;0;Jardim Leopoldina;Higienópolis;253;0;124;48;50;203
4075;0;Jardim Leopoldina;Humaitá;100;0;61;14;0;100
4076;0;Jardim Leopoldina;Hípica;0;0;0;0;0;0
4077;0;Jardim Leopoldina;Independência;50;0;16;21;0;50
4078;0;Jardim Leopoldina;Ipanema;7;0;4;2;0;7
4079;0;Jardim Leopoldina;Jardim Botânico;8;0;5;1;0;8
4080;0;Jardim Leopoldina;Jardim Carvalho;0;0;0;0;0;0
4081;0;Jardim Leopoldina;Jardim Europa;50;0;29;7;0;50
4082;0;Jardim Leopoldina;Jardim Floresta;50;0;37;11;0;50
4083;0;Jardim Leopoldina;Jardim Isabel;50;0;29;6;0;50
4084;0;Jardim Leopoldina;Jardim Itú;698;98;280;101;246;452
4085;0;Jardim Leopoldina;Jardim Leopoldina;16637;3137;6692;1836;6233;10404
4086;0;Jardim Leopoldina;Jardim Lindóia;100;0;32;14;50;50
4087;0;Jardim Leopoldina;Jardim Sabará;500;50;252;101;50;450
4088;0;Jardim Leopoldina;Jardim São Pedro;100;0;60;21;0;100
4089;0;Jardim Leopoldina;Jardim do Salso;150;150;0;0;150;0
4090;0;Jardim Leopoldina;Lageado;0;0;0;0;0;0
4091;0;Jardim Leopoldina;Lami;100;0;29;5;50;50
4092;0;Jardim Leopoldina;Lomba do Pinheiro;202;48;63;13;98;104
4093;0;Jardim Leopoldina;Medianeira;50;0;36;10;0;50
4094;0;Jardim Leopoldina;Menino Deus;58;0;35;15;0;58
4095;0;Jardim Leopoldina;Moinhos de Vento;133;50;35;0;133;0
4096;0;Jardim Leopoldina;Mont'Serrat;150;0;87;32;0;150
4097;0;Jardim Leopoldina;Morro Santana;643;0;351;114;35;608
4098;0;Jardim Leopoldina;Mário Quintana;1581;194;656;205;473;1108
4099;0;Jardim Leopoldina;Navegantes;0;0;0;0;0;0
4100;0;Jardim Leopoldina;Nonoai;0;0;0;0;0;0
4101;0;Jardim Leopoldina;Parque Santa Fé;1872;639;507;141;1072;800
4102;0;Jardim Leopoldina;Partenon;243;50;115;21;135;108
4103;0;Jardim Leopoldina;Passo D'Areia;58;0;28;12;0;58
4104;0;Jardim Leopoldina;Passo das Pedras;1587;445;603;183;529;1058
4105;0;Jardim Leopoldina;Pedra Redonda;50;0;30;10;0;50
4106;0;Jardim Leopoldina;Petrópolis;258;0;155;58;0;258
4107;0;Jardim Leopoldina;Pitinga;50;0;29;11;0;50
4108;0;Jardim Leopoldina;Ponta Grossa;0;0;0;0;0;0
4109;0;Jardim Leopoldina;Praia de Belas;0;0;0;0;0;0
4110;0;Jardim Leopoldina;Restinga;7;0;3;3;0;7
4111;0;Jardim Leopoldina;Rio Branco;93;0;30;18;35;58
4112;0;Jardim Leopoldina;Rubem Berta;3026;592;994;529;1274;1752
4113;0;Jardim Leopoldina;Santa Cecília;0;0;0;0;0;0
4114;0;Jardim Leopoldina;Santa Maria Goretti;50;0;34;12;0;50
4115;0;Jardim Leopoldina;Santa Rosa de Lima;1578;296;587;148;776;802
4116;0;Jardim Leopoldina;Santa Tereza;158;50;65;17;50;108
4117;0;Jardim Leopoldina;Santana;8;0;3;4;0;8
4118;0;Jardim Leopoldina;Santo Antônio;98;48;0;0;98;0
4119;0;Jardim Leopoldina;Sarandi;506;50;177;99;148;358
4120;0;Jardim Leopoldina;Serraria;50;0;30;6;0;50
4121;0;Jardim Leopoldina;São Caetano;0;0;0;0;0;0
4122;0;Jardim Leopoldina;São Geraldo;50;0;25;13;0;50
4123;0;Jardim Leopoldina;São José;157;0;40;8;98;59
4124;0;Jardim Leopoldina;São João;50;0;31;15;0;50
4125;0;Jardim Leopoldina;São Sebastião;385;0;98;37;235;150
4126;0;Jardim Leopoldina;Sétimo Céu;50;50;0;0;50;0
4127;0;Jardim Leopoldina;Teresópolis;50;0;28;10;0;50
4128;0;Jardim Leopoldina;Tristeza;7;0;4;3;0;7
4129;0;Jardim Leopoldina;Três Figueiras;133;50;0;0;133;0
4130;0;Jardim Leopoldina;Vila Assunção;50;0;26;15;0;50
4131;0;Jardim Leopoldina;Vila Conceição;0;0;0;0;0;0
4132;0;Jardim Leopoldina;Vila Ipiranga;103;0;63;22;0;103
4133;0;Jardim Leopoldina;Vila Jardim;6;0;3;2;0;6
4134;0;Jardim Leopoldina;Vila João Pessoa;0;0;0;0;0;0
4135;0;Jardim Leopoldina;Vila Nova;108;0;28;15;50;58
4136;0;Jardim Lindóia;Aberta dos Morros;25;0;17;5;0;25
4137;0;Jardim Lindóia;Agronomia;0;0;0;0;0;0
4138;0;Jardim Lindóia;Anchieta;100;50;27;15;50;50
4139;0;Jardim Lindóia;Arquipélago;100;50;0;0;100;0
4140;0;Jardim Lindóia;Auxiliadora;77;0;45;20;0;77
4141;0;Jardim Lindóia;Azenha;50;0;22;11;0;50
4142;0;Jardim Lindóia;Bela Vista;159;0;68;29;50;109
4143;0;Jardim Lindóia;Belém Novo;50;50;0;0;50;0
4144;0;Jardim Lindóia;Belém Velho;64;0;34;17;0;64
4145;0;Jardim Lindóia;Boa Vista;150;50;30;14;100;50
4146;0;Jardim Lindóia;Boa Vista do Sul;0;0;0;0;0;0
4147;0;Jardim Lindóia;Bom Fim;0;0;0;0;0;0
4148;0;Jardim Lindóia;Bom Jesus;88;0;18;4;50;38
4149;0;Jardim Lindóia;Camaquã;56;0;36;8;0;56
4150;0;Jardim Lindóia;Campo Novo;0;0;0;0;0;0
4151;0;Jardim Lindóia;Cascata;50;0;23;19;0;50
4152;0;Jardim Lindóia;Cavalhada;112;0;73;30;0;112
4153;0;Jardim Lindóia;Cel. Aparício Borges;81;0;20;6;50;31
4154;0;Jardim Lindóia;Centro Histórico;140;0;96;26;50;90
4155;0;Jardim Lindóia;Chapéu do Sol;0;0;0;0;0;0
4156;0;Jardim Lindóia;Chácara das Pedras;119;50;43;12;50;69
4157;0;Jardim Lindóia;Cidade Baixa;9;0;3;2;0;9
4158;0;Jardim Lindóia;Costa e Silva;67;0;45;9;0;67
4159;0;Jardim Lindóia;Cristal;91;0;71;10;50;41
4160;0;Jardim Lindóia;Cristo Redentor;1434;100;632;289;300;1134
4161;0;Jardim Lindóia;Espírito Santo;0;0;0;0;0;0
4162;0;Jardim Lindóia;Extrema;0;0;0;0;0;0
4163;0;Jardim Lindóia;Farrapos;3906;0;2215;879;50;3856
4164;0;Jardim Lindóia;Farroupilha;50;0;0;0;50;0
4165;0;Jardim Lindóia;Floresta;19;0;10;4;0;19
4166;0;Jardim Lindóia;Glória;0;0;0;0;0;0
4167;0;Jardim Lindóia;Guarujá;0;0;0;0;0;0
4168;0;Jardim Lindóia;Higienópolis;230;50;73;35;100;130
4169;0;Jardim Lindóia;Humaitá;69;0;12;4;50;19
4170;0;Jardim Lindóia;Hípica;100;50;50;0;100;0
4171;0;Jardim Lindóia;Independência;150;50;81;17;100;50
4172;0;Jardim Lindóia;Ipanema;63;0;9;1;50;13
4173;0;Jardim Lindóia;Jardim Botânico;116;0;36;11;50;66
4174;0;Jardim Lindóia;Jardim Carvalho;17;0;10;2;0;17
4175;0;Jardim Lindóia;Jardim Europa;175;0;96;51;0;175
4176;0;Jardim Lindóia;Jardim Floresta;1735;500;542;227;850;885
4177;0;Jardim Lindóia;Jardim Isabel;0;0;0;0;0;0
4178;0;Jardim Lindóia;Jardim Itú;347;50;112;62;150;197
4179;0;Jardim Lindóia;Jardim Leopoldina;113;0;43;14;50;63
4180;0;Jardim Lindóia;Jardim Lindóia;1925;300;706;224;1100;825
4181;0;Jardim Lindóia;Jardim Sabará;0;0;0;0;0;0
4182;0;Jardim Lindóia;Jardim São Pedro;392;100;78;42;250;142
4183;0;Jardim Lindóia;Jardim do Salso;50;0;25;17;0;50
4184;0;Jardim Lindóia;Lageado;0;0;0;0;0;0
4185;0;Jardim Lindóia;Lami;100;0;74;17;50;50
4186;0;Jardim Lindóia;Lomba do Pinheiro;61;0;36;12;0;61
4187;0;Jardim Lindóia;Medianeira;50;50;0;0;50;0
4188;0;Jardim Lindóia;Menino Deus;155;0;50;25;50;105
4189;0;Jardim Lindóia;Moinhos de Vento;61;0;4;5;50;11
4190;0;Jardim Lindóia;Mont'Serrat;38;0;24;9;0;38
4191;0;Jardim Lindóia;Morro Santana;76;0;51;12;0;76
4192;0;Jardim Lindóia;Mário Quintana;101;0;66;8;0;101
4193;0;Jardim Lindóia;Navegantes;50;0;32;16;0;50
4194;0;Jardim Lindóia;Nonoai;84;50;16;4;50;34
4195;0;Jardim Lindóia;Parque Santa Fé;100;0;28;15;50;50
4196;0;Jardim Lindóia;Partenon;241;100;82;31;100;141
4197;0;Jardim Lindóia;Passo D'Areia;388;0;115;71;150;238
4198;0;Jardim Lindóia;Passo das Pedras;272;150;15;2;250;22
4199;0;Jardim Lindóia;Pedra Redonda;50;0;29;12;0;50
4200;0;Jardim Lindóia;Petrópolis;415;50;138;75;150;265
4201;0;Jardim Lindóia;Pitinga;0;0;0;0;0;0
4202;0;Jardim Lindóia;Ponta Grossa;50;0;25;17;0;50
4203;0;Jardim Lindóia;Praia de Belas;0;0;0;0;0;0
4204;0;Jardim Lindóia;Restinga;42;0;21;10;0;42
4205;0;Jardim Lindóia;Rio Branco;163;0;34;18;100;63
4206;0;Jardim Lindóia;Rubem Berta;157;50;4;0;150;7
4207;0;Jardim Lindóia;Santa Cecília;50;0;0;0;50;0
4208;0;Jardim Lindóia;Santa Maria Goretti;250;0;158;75;0;250
4209;0;Jardim Lindóia;Santa Rosa de Lima;708;250;178;59;400;308
4210;0;Jardim Lindóia;Santa Tereza;156;0;109;27;50;106
4211;0;Jardim Lindóia;Santana;17;0;7;5;0;17
4212;0;Jardim Lindóia;Santo Antônio;6;0;4;1;0;6
4213;0;Jardim Lindóia;Sarandi;882;200;229;122;450;432
4214;0;Jardim Lindóia;Serraria;0;0;0;0;0;0
4215;0;Jardim Lindóia;São Caetano;0;0;0;0;0;0
4216;0;Jardim Lindóia;São Geraldo;50;0;31;16;0;50
4217;0;Jardim Lindóia;São José;14;0;7;4;0;14
4218;0;Jardim Lindóia;São João;150;0;27;13;100;50
4219;0;Jardim Lindóia;São Sebastião;1168;250;476;184;450;718
4220;0;Jardim Lindóia;Sétimo Céu;0;0;0;0;0;0
4221;0;Jardim Lindóia;Teresópolis;0;0;0;0;0;0
4222;0;Jardim Lindóia;Tristeza;130;50;43;20;50;80
4223;0;Jardim Lindóia;Três Figueiras;0;0;0;0;0;0
4224;0;Jardim Lindóia;Vila Assunção;0;0;0;0;0;0
4225;0;Jardim Lindóia;Vila Conceição;0;0;0;0;0;0
4226;0;Jardim Lindóia;Vila Ipiranga;159;0;34;16;100;59
4227;0;Jardim Lindóia;Vila Jardim;333;50;152;84;50;283
4228;0;Jardim Lindóia;Vila João Pessoa;69;0;42;12;0;69
4229;0;Jardim Lindóia;Vila Nova;66;0;36;16;0;66
4230;0;Jardim Sabará;Aberta dos Morros;50;0;26;17;0;50
4231;0;Jardim Sabará;Agronomia;250;50;129;40;50;200
4232;0;Jardim Sabará;Anchieta;50;0;24;18;0;50
4233;0;Jardim Sabará;Arquipélago;200;100;32;10;150;50
4234;0;Jardim Sabará;Auxiliadora;50;0;28;10;0;50
4235;0;Jardim Sabará;Azenha;187;0;64;20;87;100
4236;0;Jardim Sabará;Bela Vista;151;0;94;36;0;151
4237;0;Jardim Sabará;Belém Novo;48;0;0;0;48;0
4238;0;Jardim Sabará;Belém Velho;103;0;51;1;100;3
4239;0;Jardim Sabará;Boa Vista;101;50;35;7;50;51
4240;0;Jardim Sabará;Boa Vista do Sul;50;0;0;0;50;0
4241;0;Jardim Sabará;Bom Fim;50;0;19;9;0;50
4242;0;Jardim Sabará;Bom Jesus;2272;99;1104;338;318;1954
4243;0;Jardim Sabará;Camaquã;150;50;50;0;150;0
4244;0;Jardim Sabará;Campo Novo;0;0;0;0;0;0
4245;0;Jardim Sabará;Cascata;0;0;0;0;0;0
4246;0;Jardim Sabará;Cavalhada;156;48;31;15;98;58
4247;0;Jardim Sabará;Cel. Aparício Borges;158;50;64;21;50;108
4248;0;Jardim Sabará;Centro Histórico;286;47;80;35;133;153
4249;0;Jardim Sabará;Chapéu do Sol;0;0;0;0;0;0
4250;0;Jardim Sabará;Chácara das Pedras;900;0;489;220;0;900
4251;0;Jardim Sabará;Cidade Baixa;100;0;55;19;0;100
4252;0;Jardim Sabará;Costa e Silva;352;48;181;57;48;304
4253;0;Jardim Sabará;Cristal;57;0;31;14;0;57
4254;0;Jardim Sabará;Cristo Redentor;154;0;82;38;0;154
4255;0;Jardim Sabará;Espírito Santo;0;0;0;0;0;0
4256;0;Jardim Sabará;Extrema;150;50;24;19;100;50
4257;0;Jardim Sabará;Farrapos;886;249;155;40;686;200
4258;0;Jardim Sabará;Farroupilha;0;0;0;0;0;0
4259;0;Jardim Sabará;Floresta;50;0;0;0;50;0
4260;0;Jardim Sabará;Glória;151;0;94;40;0;151
4261;0;Jardim Sabará;Guarujá;0;0;0;0;0;0
4262;0;Jardim Sabará;Higienópolis;101;0;35;12;50;51
4263;0;Jardim Sabará;Humaitá;48;48;0;0;48;0
4264;0;Jardim Sabará;Hípica;0;0;0;0;0;0
4265;0;Jardim Sabará;Independência;50;0;30;8;0;50
4266;0;Jardim Sabará;Ipanema;53;50;3;0;50;3
4267;0;Jardim Sabará;Jardim Botânico;141;0;83;7;87;54
4268;0;Jardim Sabará;Jardim Carvalho;599;48;289;113;98;501
4269;0;Jardim Sabará;Jardim Europa;200;0;77;46;50;150
4270;0;Jardim Sabará;Jardim Floresta;100;0;47;33;0;100
4271;0;Jardim Sabará;Jardim Isabel;50;0;29;13;0;50
4272;0;Jardim Sabará;Jardim Itú;1677;642;380;144;1076;601
4273;0;Jardim Sabará;Jardim Leopoldina;501;48;252;104;48;453
4274;0;Jardim Sabará;Jardim Lindóia;0;0;0;0;0;0
4275;0;Jardim Sabará;Jardim Sabará;4103;1390;742;236;3103;1000
4276;0;Jardim Sabará;Jardim São Pedro;100;0;30;8;50;50
4277;0;Jardim Sabará;Jardim do Salso;400;50;203;80;50;350
4278;0;Jardim Sabará;Lageado;0;0;0;0;0;0
4279;0;Jardim Sabará;Lami;200;0;78;35;50;150
4280;0;Jardim Sabará;Lomba do Pinheiro;204;50;51;23;100;104
4281;0;Jardim Sabará;Medianeira;0;0;0;0;0;0
4282;0;Jardim Sabará;Menino Deus;8;0;1;4;0;8
4283;0;Jardim Sabará;Moinhos de Vento;248;99;46;39;148;100
4284;0;Jardim Sabará;Mont'Serrat;100;0;26;12;50;50
4285;0;Jardim Sabará;Morro Santana;985;144;397;144;331;654
4286;0;Jardim Sabará;Mário Quintana;854;149;413;70;196;658
4287;0;Jardim Sabará;Navegantes;100;0;80;13;50;50
4288;0;Jardim Sabará;Nonoai;98;48;30;15;48;50
4289;0;Jardim Sabará;Parque Santa Fé;187;0;91;35;37;150
4290;0;Jardim Sabará;Partenon;250;96;94;32;96;154
4291;0;Jardim Sabará;Passo D'Areia;57;0;3;2;50;7
4292;0;Jardim Sabará;Passo das Pedras;341;98;117;51;135;206
4293;0;Jardim Sabará;Pedra Redonda;0;0;0;0;0;0
4294;0;Jardim Sabará;Petrópolis;494;150;120;46;287;207
4295;0;Jardim Sabará;Pitinga;100;0;55;24;0;100
4296;0;Jardim Sabará;Ponta Grossa;0;0;0;0;0;0
4297;0;Jardim Sabará;Praia de Belas;100;0;50;23;0;100
4298;0;Jardim Sabará;Restinga;258;0;115;30;50;208
4299;0;Jardim Sabará;Rio Branco;239;149;89;0;236;3
4300;0;Jardim Sabará;Rubem Berta;550;150;158;86;248;302
4301;0;Jardim Sabará;Santa Cecília;150;0;57;21;50;100
4302;0;Jardim Sabará;Santa Maria Goretti;50;0;0;0;50;0
4303;0;Jardim Sabará;Santa Rosa de Lima;423;100;131;14;272;151
4304;0;Jardim Sabará;Santa Tereza;157;50;58;29;50;107
4305;0;Jardim Sabará;Santana;54;0;35;14;0;54
4306;0;Jardim Sabará;Santo Antônio;50;0;27;19;0;50
4307;0;Jardim Sabará;Sarandi;389;48;177;94;48;341
4308;0;Jardim Sabará;Serraria;0;0;0;0;0;0
4309;0;Jardim Sabará;São Caetano;50;0;17;16;0;50
4310;0;Jardim Sabará;São Geraldo;50;0;16;20;0;50
4311;0;Jardim Sabará;São José;254;0;130;26;50;204
4312;0;Jardim Sabará;São João;248;48;77;43;98;150
4313;0;Jardim Sabará;São Sebastião;100;50;32;13;50;50
4314;0;Jardim Sabará;Sétimo Céu;50;0;0;0;50;0
4315;0;Jardim Sabará;Teresópolis;50;0;30;13;0;50
4316;0;Jardim Sabará;Tristeza;4;0;2;1;0;4
4317;0;Jardim Sabará;Três Figueiras;78;0;24;11;28;50
4318;0;Jardim Sabará;Vila Assunção;50;0;20;16;0;50
4319;0;Jardim Sabará;Vila Conceição;0;0;0;0;0;0
4320;0;Jardim Sabará;Vila Ipiranga;831;293;308;99;380;451
4321;0;Jardim Sabará;Vila Jardim;3215;761;755;331;1962;1253
4322;0;Jardim Sabará;Vila João Pessoa;250;50;98;26;100;150
4323;0;Jardim Sabará;Vila Nova;109;50;5;4;100;9
4324;0;Jardim São Pedro;Aberta dos Morros;0;0;0;0;0;0
4325;0;Jardim São Pedro;Agronomia;0;0;0;0;0;0
4326;0;Jardim São Pedro;Anchieta;247;50;86;16;100;147
4327;0;Jardim São Pedro;Arquipélago;50;0;33;16;0;50
4328;0;Jardim São Pedro;Auxiliadora;90;0;47;24;0;90
4329;0;Jardim São Pedro;Azenha;105;0;34;10;50;55
4330;0;Jardim São Pedro;Bela Vista;185;50;24;9;150;35
4331;0;Jardim São Pedro;Belém Novo;0;0;0;0;0;0
4332;0;Jardim São Pedro;Belém Velho;169;50;49;11;100;69
4333;0;Jardim São Pedro;Boa Vista;311;0;97;41;150;161
4334;0;Jardim São Pedro;Boa Vista do Sul;0;0;0;0;0;0
4335;0;Jardim São Pedro;Bom Fim;119;0;30;24;50;69
4336;0;Jardim São Pedro;Bom Jesus;247;50;50;18;150;97
4337;0;Jardim São Pedro;Camaquã;131;50;22;7;100;31
4338;0;Jardim São Pedro;Campo Novo;50;50;0;0;50;0
4339;0;Jardim São Pedro;Cascata;0;0;0;0;0;0
4340;0;Jardim São Pedro;Cavalhada;207;0;116;48;0;207
4341;0;Jardim São Pedro;Cel. Aparício Borges;248;100;83;20;100;148
4342;0;Jardim São Pedro;Centro Histórico;74;0;43;19;0;74
4343;0;Jardim São Pedro;Chapéu do Sol;0;0;0;0;0;0
4344;0;Jardim São Pedro;Chácara das Pedras;125;100;14;8;100;25
4345;0;Jardim São Pedro;Cidade Baixa;54;0;26;12;0;54
4346;0;Jardim São Pedro;Costa e Silva;208;100;78;13;100;108
4347;0;Jardim São Pedro;Cristal;186;0;96;40;0;186
4348;0;Jardim São Pedro;Cristo Redentor;3445;1450;491;144;2800;645
4349;0;Jardim São Pedro;Espírito Santo;85;50;25;7;50;35
4350;0;Jardim São Pedro;Extrema;0;0;0;0;0;0
4351;0;Jardim São Pedro;Farrapos;3744;0;2041;856;50;3694
4352;0;Jardim São Pedro;Farroupilha;0;0;0;0;0;0
4353;0;Jardim São Pedro;Floresta;150;50;25;15;100;50
4354;0;Jardim São Pedro;Glória;24;0;12;4;0;24
4355;0;Jardim São Pedro;Guarujá;0;0;0;0;0;0
4356;0;Jardim São Pedro;Higienópolis;296;0;76;36;150;146
4357;0;Jardim São Pedro;Humaitá;99;50;29;6;50;49
4358;0;Jardim São Pedro;Hípica;0;0;0;0;0;0
4359;0;Jardim São Pedro;Independência;0;0;0;0;0;0
4360;0;Jardim São Pedro;Ipanema;61;0;37;16;0;61
4361;0;Jardim São Pedro;Jardim Botânico;126;0;64;32;0;126
4362;0;Jardim São Pedro;Jardim Carvalho;25;0;11;7;0;25
4363;0;Jardim São Pedro;Jardim Europa;150;0;52;27;50;100
4364;0;Jardim São Pedro;Jardim Floresta;361;100;103;62;150;211
4365;0;Jardim São Pedro;Jardim Isabel;0;0;0;0;0;0
4366;0;Jardim São Pedro;Jardim Itú;166;100;35;19;100;66
4367;0;Jardim São Pedro;Jardim Leopoldina;104;0;69;17;0;104
4368;0;Jardim São Pedro;Jardim Lindóia;451;100;112;53;250;201
4369;0;Jardim São Pedro;Jardim Sabará;69;0;10;2;50;19
4370;0;Jardim São Pedro;Jardim São Pedro;1271;900;166;16;1210;61
4371;0;Jardim São Pedro;Jardim do Salso;0;0;0;0;0;0
4372;0;Jardim São Pedro;Lageado;25;0;15;4;0;25
4373;0;Jardim São Pedro;Lami;50;0;28;20;0;50
4374;0;Jardim São Pedro;Lomba do Pinheiro;155;0;127;10;100;55
4375;0;Jardim São Pedro;Medianeira;25;0;14;7;0;25
4376;0;Jardim São Pedro;Menino Deus;211;0;102;35;50;161
4377;0;Jardim São Pedro;Moinhos de Vento;0;0;0;0;0;0
4378;0;Jardim São Pedro;Mont'Serrat;69;0;64;4;50;19
4379;0;Jardim São Pedro;Morro Santana;155;50;57;32;50;105
4380;0;Jardim São Pedro;Mário Quintana;396;0;230;36;100;296
4381;0;Jardim São Pedro;Navegantes;50;0;31;19;0;50
4382;0;Jardim São Pedro;Nonoai;79;0;44;23;0;79
4383;0;Jardim São Pedro;Parque Santa Fé;119;0;33;26;50;69
4384;0;Jardim São Pedro;Partenon;172;0;60;27;50;122
4385;0;Jardim São Pedro;Passo D'Areia;1105;450;232;192;550;555
4386;0;Jardim São Pedro;Passo das Pedras;193;0;104;38;0;193
4387;0;Jardim São Pedro;Pedra Redonda;0;0;0;0;0;0
4388;0;Jardim São Pedro;Petrópolis;252;0;135;44;100;152
4389;0;Jardim São Pedro;Pitinga;0;0;0;0;0;0
4390;0;Jardim São Pedro;Ponta Grossa;50;0;38;10;0;50
4391;0;Jardim São Pedro;Praia de Belas;0;0;0;0;0;0
4392;0;Jardim São Pedro;Restinga;190;0;101;25;0;190
4393;0;Jardim São Pedro;Rio Branco;111;50;32;18;50;61
4394;0;Jardim São Pedro;Rubem Berta;158;50;50;38;50;108
4395;0;Jardim São Pedro;Santa Cecília;0;0;0;0;0;0
4396;0;Jardim São Pedro;Santa Maria Goretti;1608;0;863;350;150;1458
4397;0;Jardim São Pedro;Santa Rosa de Lima;153;50;23;12;100;53
4398;0;Jardim São Pedro;Santa Tereza;172;0;96;27;0;172
4399;0;Jardim São Pedro;Santana;127;0;75;35;0;127
4400;0;Jardim São Pedro;Santo Antônio;45;0;23;9;0;45
4401;0;Jardim São Pedro;Sarandi;657;150;271;133;150;507
4402;0;Jardim São Pedro;Serraria;0;0;0;0;0;0
4403;0;Jardim São Pedro;São Caetano;1;0;1;0;0;1
4404;0;Jardim São Pedro;São Geraldo;50;50;0;0;50;0
4405;0;Jardim São Pedro;São José;63;0;41;10;0;63
4406;0;Jardim São Pedro;São João;150;0;30;13;100;50
4407;0;Jardim São Pedro;São Sebastião;101;50;1;0;100;1
4408;0;Jardim São Pedro;Sétimo Céu;0;0;0;0;0;0
4409;0;Jardim São Pedro;Teresópolis;0;0;0;0;0;0
4410;0;Jardim São Pedro;Tristeza;113;0;76;29;0;113
4411;0;Jardim São Pedro;Três Figueiras;0;0;0;0;0;0
4412;0;Jardim São Pedro;Vila Assunção;0;0;0;0;0;0
4413;0;Jardim São Pedro;Vila Conceição;50;0;28;11;0;50
4414;0;Jardim São Pedro;Vila Ipiranga;144;100;28;9;100;44
4415;0;Jardim São Pedro;Vila Jardim;73;0;43;16;0;73
4416;0;Jardim São Pedro;Vila João Pessoa;50;50;0;0;50;0
4417;0;Jardim São Pedro;Vila Nova;343;0;196;74;0;343
4418;0;Jardim do Salso;Aberta dos Morros;0;0;0;0;0;0
4419;0;Jardim do Salso;Agronomia;0;0;0;0;0;0
4420;0;Jardim do Salso;Anchieta;0;0;0;0;0;0
4421;0;Jardim do Salso;Arquipélago;0;0;0;0;0;0
4422;0;Jardim do Salso;Auxiliadora;100;48;25;19;48;52
4423;0;Jardim do Salso;Azenha;0;0;0;0;0;0
4424;0;Jardim do Salso;Bela Vista;51;0;24;12;0;51
4425;0;Jardim do Salso;Belém Novo;50;0;35;9;0;50
4426;0;Jardim do Salso;Belém Velho;2;0;1;1;0;2
4427;0;Jardim do Salso;Boa Vista;0;0;0;0;0;0
4428;0;Jardim do Salso;Boa Vista do Sul;0;0;0;0;0;0
4429;0;Jardim do Salso;Bom Fim;50;50;0;0;50;0
4430;0;Jardim do Salso;Bom Jesus;1763;298;767;168;611;1152
4431;0;Jardim do Salso;Camaquã;51;0;30;12;0;51
4432;0;Jardim do Salso;Campo Novo;0;0;0;0;0;0
4433;0;Jardim do Salso;Cascata;136;0;64;14;36;100
4434;0;Jardim do Salso;Cavalhada;56;0;4;2;50;6
4435;0;Jardim do Salso;Cel. Aparício Borges;654;98;334;78;98;556
4436;0;Jardim do Salso;Centro Histórico;200;50;52;20;98;102
4437;0;Jardim do Salso;Chapéu do Sol;0;0;0;0;0;0
4438;0;Jardim do Salso;Chácara das Pedras;198;48;82;39;48;150
4439;0;Jardim do Salso;Cidade Baixa;101;0;58;28;0;101
4440;0;Jardim do Salso;Costa e Silva;3;0;3;0;0;3
4441;0;Jardim do Salso;Cristal;105;0;62;18;0;105
4442;0;Jardim do Salso;Cristo Redentor;52;0;28;9;0;52
4443;0;Jardim do Salso;Espírito Santo;100;50;24;12;50;50
4444;0;Jardim do Salso;Extrema;0;0;0;0;0;0
4445;0;Jardim do Salso;Farrapos;408;51;38;5;358;50
4446;0;Jardim do Salso;Farroupilha;0;0;0;0;0;0
4447;0;Jardim do Salso;Floresta;0;0;0;0;0;0
4448;0;Jardim do Salso;Glória;248;0;120;45;48;200
4449;0;Jardim do Salso;Guarujá;0;0;0;0;0;0
4450;0;Jardim do Salso;Higienópolis;51;0;1;0;50;1
4451;0;Jardim do Salso;Humaitá;50;50;0;0;50;0
4452;0;Jardim do Salso;Hípica;136;0;76;15;36;100
4453;0;Jardim do Salso;Independência;36;0;0;0;36;0
4454;0;Jardim do Salso;Ipanema;52;0;1;0;50;2
4455;0;Jardim do Salso;Jardim Botânico;631;195;106;27;529;102
4456;0;Jardim do Salso;Jardim Carvalho;1355;245;545;193;403;952
4457;0;Jardim do Salso;Jardim Europa;100;50;28;11;50;50
4458;0;Jardim do Salso;Jardim Floresta;50;0;32;10;0;50
4459;0;Jardim do Salso;Jardim Isabel;0;0;0;0;0;0
4460;0;Jardim do Salso;Jardim Itú;98;48;34;10;48;50
4461;0;Jardim do Salso;Jardim Leopoldina;145;144;1;0;144;1
4462;0;Jardim do Salso;Jardim Lindóia;50;0;25;17;0;50
4463;0;Jardim do Salso;Jardim Sabará;398;48;203;80;48;350
4464;0;Jardim do Salso;Jardim São Pedro;0;0;0;0;0;0
4465;0;Jardim do Salso;Jardim do Salso;3070;198;1570;554;470;2600
4466;0;Jardim do Salso;Lageado;0;0;0;0;0;0
4467;0;Jardim do Salso;Lami;0;0;0;0;0;0
4468;0;Jardim do Salso;Lomba do Pinheiro;499;100;205;37;148;351
4469;0;Jardim do Salso;Medianeira;100;0;31;8;50;50
4470;0;Jardim do Salso;Menino Deus;153;0;65;24;48;105
4471;0;Jardim do Salso;Moinhos de Vento;0;0;0;0;0;0
4472;0;Jardim do Salso;Mont'Serrat;150;100;23;11;100;50
4473;0;Jardim do Salso;Morro Santana;152;0;56;18;50;102
4474;0;Jardim do Salso;Mário Quintana;153;0;37;5;98;55
4475;0;Jardim do Salso;Navegantes;100;0;25;11;50;50
4476;0;Jardim do Salso;Nonoai;201;50;83;9;150;51
4477;0;Jardim do Salso;Parque Santa Fé;0;0;0;0;0;0
4478;0;Jardim do Salso;Partenon;938;150;278;65;636;302
4479;0;Jardim do Salso;Passo D'Areia;202;50;57;69;50;152
4480;0;Jardim do Salso;Passo das Pedras;52;50;1;0;50;2
4481;0;Jardim do Salso;Pedra Redonda;50;50;0;0;50;0
4482;0;Jardim do Salso;Petrópolis;1437;489;216;105;1082;355
4483;0;Jardim do Salso;Pitinga;0;0;0;0;0;0
4484;0;Jardim do Salso;Ponta Grossa;100;0;64;17;0;100
4485;0;Jardim do Salso;Praia de Belas;0;0;0;0;0;0
4486;0;Jardim do Salso;Restinga;204;48;87;31;48;156
4487;0;Jardim do Salso;Rio Branco;252;0;125;51;50;202
4488;0;Jardim do Salso;Rubem Berta;101;0;59;30;0;101
4489;0;Jardim do Salso;Santa Cecília;50;0;27;14;0;50
4490;0;Jardim do Salso;Santa Maria Goretti;0;0;0;0;0;0
4491;0;Jardim do Salso;Santa Rosa de Lima;148;0;55;10;48;100
4492;0;Jardim do Salso;Santa Tereza;105;0;35;12;50;55
4493;0;Jardim do Salso;Santana;336;99;80;37;184;152
4494;0;Jardim do Salso;Santo Antônio;100;50;28;10;50;50
4495;0;Jardim do Salso;Sarandi;106;0;57;31;0;106
4496;0;Jardim do Salso;Serraria;0;0;0;0;0;0
4497;0;Jardim do Salso;São Caetano;50;0;37;7;0;50
4498;0;Jardim do Salso;São Geraldo;98;48;29;8;48;50
4499;0;Jardim do Salso;São José;351;0;197;58;0;351
4500;0;Jardim do Salso;São João;100;0;28;9;50;50
4501;0;Jardim do Salso;São Sebastião;50;0;21;12;0;50
4502;0;Jardim do Salso;Sétimo Céu;0;0;0;0;0;0
4503;0;Jardim do Salso;Teresópolis;150;0;108;30;50;100
4504;0;Jardim do Salso;Tristeza;3;0;2;0;0;3
4505;0;Jardim do Salso;Três Figueiras;150;0;51;24;50;100
4506;0;Jardim do Salso;Vila Assunção;0;0;0;0;0;0
4507;0;Jardim do Salso;Vila Conceição;0;0;0;0;0;0
4508;0;Jardim do Salso;Vila Ipiranga;0;0;0;0;0;0
4509;0;Jardim do Salso;Vila Jardim;286;0;128;34;84;202
4510;0;Jardim do Salso;Vila João Pessoa;1431;245;694;211;381;1050
4511;0;Jardim do Salso;Vila Nova;242;50;74;34;86;156
4512;0;Lageado;Aberta dos Morros;196;0;111;14;46;150
4513;0;Lageado;Agronomia;50;0;27;9;0;50
4514;0;Lageado;Anchieta;0;0;0;0;0;0
4515;0;Lageado;Arquipélago;46;46;0;0;46;0
4516;0;Lageado;Auxiliadora;0;0;0;0;0;0
4517;0;Lageado;Azenha;196;95;49;21;95;101
4518;0;Lageado;Bela Vista;3;0;3;0;0;3
4519;0;Lageado;Belém Novo;396;46;198;75;46;350
4520;0;Lageado;Belém Velho;58;0;43;11;0;58
4521;0;Lageado;Boa Vista;137;137;0;0;137;0
4522;0;Lageado;Boa Vista do Sul;100;0;53;17;0;100
4523;0;Lageado;Bom Fim;50;0;26;14;0;50
4524;0;Lageado;Bom Jesus;109;0;68;21;0;109
4525;0;Lageado;Camaquã;52;0;26;8;0;52
4526;0;Lageado;Campo Novo;0;0;0;0;0;0
4527;0;Lageado;Cascata;118;0;61;18;18;100
4528;0;Lageado;Cavalhada;63;0;8;2;50;13
4529;0;Lageado;Cel. Aparício Borges;60;50;6;1;50;10
4530;0;Lageado;Centro Histórico;320;145;58;24;212;108
4531;0;Lageado;Chapéu do Sol;99;49;33;14;49;50
4532;0;Lageado;Chácara das Pedras;50;0;31;11;0;50
4533;0;Lageado;Cidade Baixa;53;0;31;15;0;53
4534;0;Lageado;Costa e Silva;154;46;67;20;46;108
4535;0;Lageado;Cristal;159;0;112;17;46;113
4536;0;Lageado;Cristo Redentor;111;0;64;29;0;111
4537;0;Lageado;Espírito Santo;50;0;33;8;0;50
4538;0;Lageado;Extrema;596;0;376;72;96;500
4539;0;Lageado;Farrapos;3012;1473;877;219;949;1001
4540;0;Lageado;Farroupilha;0;0;0;0;0;0
4541;0;Lageado;Floresta;49;49;0;0;49;0
4542;0;Lageado;Glória;52;0;29;10;0;52
4543;0;Lageado;Guarujá;50;0;28;12;0;50
4544;0;Lageado;Higienópolis;0;0;0;0;0;0
4545;0;Lageado;Humaitá;100;0;30;8;50;50
4546;0;Lageado;Hípica;346;95;161;31;95;251
4547;0;Lageado;Independência;50;0;19;12;0;50
4548;0;Lageado;Ipanema;8;0;6;2;0;8
4549;0;Lageado;Jardim Botânico;8;0;4;2;0;8
4550;0;Lageado;Jardim Carvalho;102;0;68;15;0;102
4551;0;Lageado;Jardim Europa;0;0;0;0;0;0
4552;0;Lageado;Jardim Floresta;0;0;0;0;0;0
4553;0;Lageado;Jardim Isabel;0;0;0;0;0;0
4554;0;Lageado;Jardim Itú;52;0;32;10;0;52
4555;0;Lageado;Jardim Leopoldina;6;0;4;0;0;6
4556;0;Lageado;Jardim Lindóia;0;0;0;0;0;0
4557;0;Lageado;Jardim Sabará;0;0;0;0;0;0
4558;0;Lageado;Jardim São Pedro;50;0;30;9;0;50
4559;0;Lageado;Jardim do Salso;0;0;0;0;0;0
4560;0;Lageado;Lageado;887;0;402;100;287;600
4561;0;Lageado;Lami;299;0;159;34;49;250
4562;0;Lageado;Lomba do Pinheiro;350;46;123;20;145;205
4563;0;Lageado;Medianeira;150;0;90;31;0;150
4564;0;Lageado;Menino Deus;159;46;62;40;46;113
4565;0;Lageado;Moinhos de Vento;50;0;29;19;0;50
4566;0;Lageado;Mont'Serrat;0;0;0;0;0;0
4567;0;Lageado;Morro Santana;11;0;5;1;0;11
4568;0;Lageado;Mário Quintana;75;49;19;3;49;26
4569;0;Lageado;Navegantes;0;0;0;0;0;0
4570;0;Lageado;Nonoai;46;46;0;0;46;0
4571;0;Lageado;Parque Santa Fé;0;0;0;0;0;0
4572;0;Lageado;Partenon;305;96;86;32;145;160
4573;0;Lageado;Passo D'Areia;10;0;4;5;0;10
4574;0;Lageado;Passo das Pedras;8;0;5;0;0;8
4575;0;Lageado;Pedra Redonda;0;0;0;0;0;0
4576;0;Lageado;Petrópolis;355;0;184;87;92;263
4577;0;Lageado;Pitinga;296;96;123;25;96;200
4578;0;Lageado;Ponta Grossa;0;0;0;0;0;0
4579;0;Lageado;Praia de Belas;0;0;0;0;0;0
4580;0;Lageado;Restinga;849;368;216;62;534;315
4581;0;Lageado;Rio Branco;57;0;32;15;0;57
4582;0;Lageado;Rubem Berta;0;0;0;0;0;0
4583;0;Lageado;Santa Cecília;46;0;0;0;46;0
4584;0;Lageado;Santa Maria Goretti;0;0;0;0;0;0
4585;0;Lageado;Santa Rosa de Lima;0;0;0;0;0;0
4586;0;Lageado;Santa Tereza;259;99;92;31;99;160
4587;0;Lageado;Santana;249;48;64;33;141;108
4588;0;Lageado;Santo Antônio;49;49;0;0;49;0
4589;0;Lageado;Sarandi;70;0;11;6;46;24
4590;0;Lageado;Serraria;50;0;31;13;0;50
4591;0;Lageado;São Caetano;1749;449;486;124;949;800
4592;0;Lageado;São Geraldo;50;0;31;10;0;50
4593;0;Lageado;São José;6;0;4;1;0;6
4594;0;Lageado;São João;0;0;0;0;0;0
4595;0;Lageado;São Sebastião;100;0;64;23;0;100
4596;0;Lageado;Sétimo Céu;0;0;0;0;0;0
4597;0;Lageado;Teresópolis;99;0;35;12;49;50
4598;0;Lageado;Tristeza;59;0;40;18;0;59
4599;0;Lageado;Três Figueiras;0;0;0;0;0;0
4600;0;Lageado;Vila Assunção;0;0;0;0;0;0
4601;0;Lageado;Vila Conceição;0;0;0;0;0;0
4602;0;Lageado;Vila Ipiranga;0;0;0;0;0;0
4603;0;Lageado;Vila Jardim;8;0;4;2;0;8
4604;0;Lageado;Vila João Pessoa;51;0;24;12;0;51
4605;0;Lageado;Vila Nova;125;50;42;12;50;75
4606;0;Lami;Aberta dos Morros;0;0;0;0;0;0
4607;0;Lami;Agronomia;0;0;0;0;0;0
4608;0;Lami;Anchieta;0;0;0;0;0;0
4609;0;Lami;Arquipélago;0;0;0;0;0;0
4610;0;Lami;Auxiliadora;0;0;0;0;0;0
4611;0;Lami;Azenha;0;0;0;0;0;0
4612;0;Lami;Bela Vista;2;0;2;0;0;2
4613;0;Lami;Belém Novo;0;0;0;0;0;0
4614;0;Lami;Belém Velho;54;0;36;11;0;54
4615;0;Lami;Boa Vista;100;0;31;9;50;50
4616;0;Lami;Boa Vista do Sul;100;50;32;6;50;50
4617;0;Lami;Bom Fim;0;0;0;0;0;0
4618;0;Lami;Bom Jesus;9;0;3;1;0;9
4619;0;Lami;Camaquã;102;50;1;0;100;2
4620;0;Lami;Campo Novo;0;0;0;0;0;0
4621;0;Lami;Cascata;0;0;0;0;0;0
4622;0;Lami;Cavalhada;169;50;37;17;100;69
4623;0;Lami;Cel. Aparício Borges;163;0;89;13;100;63
4624;0;Lami;Centro Histórico;56;0;28;13;0;56
4625;0;Lami;Chapéu do Sol;0;0;0;0;0;0
4626;0;Lami;Chácara das Pedras;150;50;53;34;50;100
4627;0;Lami;Cidade Baixa;4;0;1;0;0;4
4628;0;Lami;Costa e Silva;8;0;5;1;0;8
4629;0;Lami;Cristal;77;0;46;13;0;77
4630;0;Lami;Cristo Redentor;64;0;37;12;0;64
4631;0;Lami;Espírito Santo;0;0;0;0;0;0
4632;0;Lami;Extrema;200;0;107;37;0;200
4633;0;Lami;Farrapos;0;0;0;0;0;0
4634;0;Lami;Farroupilha;0;0;0;0;0;0
4635;0;Lami;Floresta;0;0;0;0;0;0
4636;0;Lami;Glória;100;0;24;10;50;50
4637;0;Lami;Guarujá;0;0;0;0;0;0
4638;0;Lami;Higienópolis;0;0;0;0;0;0
4639;0;Lami;Humaitá;50;0;41;3;0;50
4640;0;Lami;Hípica;100;0;33;5;50;50
4641;0;Lami;Independência;0;0;0;0;0;0
4642;0;Lami;Ipanema;4;0;3;1;0;4
4643;0;Lami;Jardim Botânico;6;0;4;1;0;6
4644;0;Lami;Jardim Carvalho;100;0;55;18;0;100
4645;0;Lami;Jardim Europa;0;0;0;0;0;0
4646;0;Lami;Jardim Floresta;0;0;0;0;0;0
4647;0;Lami;Jardim Isabel;0;0;0;0;0;0
4648;0;Lami;Jardim Itú;50;0;29;5;0;50
4649;0;Lami;Jardim Leopoldina;105;0;33;6;50;55
4650;0;Lami;Jardim Lindóia;100;0;74;17;50;50
4651;0;Lami;Jardim Sabará;200;0;78;35;50;150
4652;0;Lami;Jardim São Pedro;50;0;28;20;0;50
4653;0;Lami;Jardim do Salso;0;0;0;0;0;0
4654;0;Lami;Lageado;300;0;159;34;50;250
4655;0;Lami;Lami;3500;100;1946;478;300;3200
4656;0;Lami;Lomba do Pinheiro;202;0;64;12;100;102
4657;0;Lami;Medianeira;100;0;0;0;100;0
4658;0;Lami;Menino Deus;165;50;40;15;100;65
4659;0;Lami;Moinhos de Vento;100;0;54;23;0;100
4660;0;Lami;Mont'Serrat;50;0;29;13;0;50
4661;0;Lami;Morro Santana;17;0;9;4;0;17
4662;0;Lami;Mário Quintana;139;50;23;4;100;39
4663;0;Lami;Navegantes;0;0;0;0;0;0
4664;0;Lami;Nonoai;54;50;4;0;50;4
4665;0;Lami;Parque Santa Fé;50;0;0;0;50;0
4666;0;Lami;Partenon;210;50;80;39;50;160
4667;0;Lami;Passo D'Areia;263;0;55;63;100;163
4668;0;Lami;Passo das Pedras;10;0;4;4;0;10
4669;0;Lami;Pedra Redonda;0;0;0;0;0;0
4670;0;Lami;Petrópolis;463;50;237;125;50;413
4671;0;Lami;Pitinga;150;0;96;21;0;150
4672;0;Lami;Ponta Grossa;100;50;29;8;50;50
4673;0;Lami;Praia de Belas;0;0;0;0;0;0
4674;0;Lami;Restinga;228;50;103;24;50;178
4675;0;Lami;Rio Branco;6;0;3;1;0;6
4676;0;Lami;Rubem Berta;150;50;20;26;100;50
4677;0;Lami;Santa Cecília;50;0;33;13;0;50
4678;0;Lami;Santa Maria Goretti;0;0;0;0;0;0
4679;0;Lami;Santa Rosa de Lima;50;0;0;0;50;0
4680;0;Lami;Santa Tereza;167;0;67;19;50;117
4681;0;Lami;Santana;106;0;43;33;0;106
4682;0;Lami;Santo Antônio;0;0;0;0;0;0
4683;0;Lami;Sarandi;188;0;105;17;100;88
4684;0;Lami;Serraria;0;0;0;0;0;0
4685;0;Lami;São Caetano;600;150;245;64;200;400
4686;0;Lami;São Geraldo;0;0;0;0;0;0
4687;0;Lami;São José;105;50;29;12;50;55
4688;0;Lami;São João;100;0;49;33;0;100
4689;0;Lami;São Sebastião;0;0;0;0;0;0
4690;0;Lami;Sétimo Céu;0;0;0;0;0;0
4691;0;Lami;Teresópolis;150;0;57;25;50;100
4692;0;Lami;Tristeza;58;0;6;2;50;8
4693;0;Lami;Três Figueiras;0;0;0;0;0;0
4694;0;Lami;Vila Assunção;0;0;0;0;0;0
4695;0;Lami;Vila Conceição;0;0;0;0;0;0
4696;0;Lami;Vila Ipiranga;100;0;58;24;0;100
4697;0;Lami;Vila Jardim;56;0;26;15;0;56
4698;0;Lami;Vila João Pessoa;0;0;0;0;0;0
4699;0;Lami;Vila Nova;290;0;156;52;0;290
4700;0;Lomba do Pinheiro;Aberta dos Morros;50;0;25;2;0;50
4701;0;Lomba do Pinheiro;Agronomia;6000;650;2895;613;1250;4750
4702;0;Lomba do Pinheiro;Anchieta;250;0;137;43;0;250
4703;0;Lomba do Pinheiro;Arquipélago;650;0;343;89;50;600
4704;0;Lomba do Pinheiro;Auxiliadora;3;0;0;0;0;3
4705;0;Lomba do Pinheiro;Azenha;0;0;0;0;0;0
4706;0;Lomba do Pinheiro;Bela Vista;156;50;69;13;50;106
4707;0;Lomba do Pinheiro;Belém Novo;100;50;31;8;50;50
4708;0;Lomba do Pinheiro;Belém Velho;1561;300;713;158;450;1111
4709;0;Lomba do Pinheiro;Boa Vista;251;100;75;11;200;51
4710;0;Lomba do Pinheiro;Boa Vista do Sul;350;0;214;43;0;350
4711;0;Lomba do Pinheiro;Bom Fim;50;50;0;0;50;0
4712;0;Lomba do Pinheiro;Bom Jesus;411;0;157;31;150;261
4713;0;Lomba do Pinheiro;Camaquã;102;0;34;10;50;52
4714;0;Lomba do Pinheiro;Campo Novo;250;100;58;10;150;100
4715;0;Lomba do Pinheiro;Cascata;1050;150;454;109;300;750
4716;0;Lomba do Pinheiro;Cavalhada;168;0;100;22;0;168
4717;0;Lomba do Pinheiro;Cel. Aparício Borges;767;100;299;76;250;517
4718;0;Lomba do Pinheiro;Centro Histórico;110;50;38;9;50;60
4719;0;Lomba do Pinheiro;Chapéu do Sol;300;0;82;21;150;150
4720;0;Lomba do Pinheiro;Chácara das Pedras;200;50;30;4;150;50
4721;0;Lomba do Pinheiro;Cidade Baixa;55;0;38;7;0;55
4722;0;Lomba do Pinheiro;Costa e Silva;161;0;89;25;0;161
4723;0;Lomba do Pinheiro;Cristal;70;0;36;8;0;70
4724;0;Lomba do Pinheiro;Cristo Redentor;115;0;61;22;0;115
4725;0;Lomba do Pinheiro;Espírito Santo;200;0;25;8;150;50
4726;0;Lomba do Pinheiro;Extrema;200;50;63;12;100;100
4727;0;Lomba do Pinheiro;Farrapos;300;0;170;53;0;300
4728;0;Lomba do Pinheiro;Farroupilha;100;50;0;0;100;0
4729;0;Lomba do Pinheiro;Floresta;100;50;26;7;50;50
4730;0;Lomba do Pinheiro;Glória;1102;50;594;111;200;902
4731;0;Lomba do Pinheiro;Guarujá;50;0;34;5;0;50
4732;0;Lomba do Pinheiro;Higienópolis;102;50;24;8;50;52
4733;0;Lomba do Pinheiro;Humaitá;200;0;121;33;0;200
4734;0;Lomba do Pinheiro;Hípica;100;0;35;9;50;50
4735;0;Lomba do Pinheiro;Independência;150;0;61;14;50;100
4736;0;Lomba do Pinheiro;Ipanema;59;0;36;8;0;59
4737;0;Lomba do Pinheiro;Jardim Botânico;961;100;487;116;150;811
4738;0;Lomba do Pinheiro;Jardim Carvalho;1153;350;436;132;400;753
4739;0;Lomba do Pinheiro;Jardim Europa;50;0;29;5;0;50
4740;0;Lomba do Pinheiro;Jardim Floresta;200;150;29;7;150;50
4741;0;Lomba do Pinheiro;Jardim Isabel;100;0;27;4;50;50
4742;0;Lomba do Pinheiro;Jardim Itú;150;0;89;28;0;150
4743;0;Lomba do Pinheiro;Jardim Leopoldina;209;50;65;16;100;109
4744;0;Lomba do Pinheiro;Jardim Lindóia;100;0;60;18;0;100
4745;0;Lomba do Pinheiro;Jardim Sabará;200;50;47;23;100;100
4746;0;Lomba do Pinheiro;Jardim São Pedro;150;0;128;6;100;50
4747;0;Lomba do Pinheiro;Jardim do Salso;500;100;205;37;150;350
4748;0;Lomba do Pinheiro;Lageado;350;50;121;20;150;200
4749;0;Lomba do Pinheiro;Lami;200;0;62;12;100;100
4750;0;Lomba do Pinheiro;Lomba do Pinheiro;18209;2400;8727;1882;4100;14109
4751;0;Lomba do Pinheiro;Medianeira;400;0;202;47;50;350
4752;0;Lomba do Pinheiro;Menino Deus;119;0;35;22;50;69
4753;0;Lomba do Pinheiro;Moinhos de Vento;50;0;28;3;0;50
4754;0;Lomba do Pinheiro;Mont'Serrat;51;0;24;16;0;51
4755;0;Lomba do Pinheiro;Morro Santana;1167;150;614;112;150;1017
4756;0;Lomba do Pinheiro;Mário Quintana;593;50;264;47;200;393
4757;0;Lomba do Pinheiro;Navegantes;100;0;59;7;0;100
4758;0;Lomba do Pinheiro;Nonoai;256;0;110;37;50;206
4759;0;Lomba do Pinheiro;Parque Santa Fé;50;0;29;6;0;50
4760;0;Lomba do Pinheiro;Partenon;564;100;231;54;200;364
4761;0;Lomba do Pinheiro;Passo D'Areia;168;50;84;15;100;68
4762;0;Lomba do Pinheiro;Passo das Pedras;414;50;215;40;50;364
4763;0;Lomba do Pinheiro;Pedra Redonda;300;50;85;19;150;150
4764;0;Lomba do Pinheiro;Petrópolis;518;100;243;108;100;418
4765;0;Lomba do Pinheiro;Pitinga;1450;0;810;184;100;1350
4766;0;Lomba do Pinheiro;Ponta Grossa;100;0;55;17;0;100
4767;0;Lomba do Pinheiro;Praia de Belas;50;0;28;11;0;50
4768;0;Lomba do Pinheiro;Restinga;818;150;360;81;200;618
4769;0;Lomba do Pinheiro;Rio Branco;109;0;34;9;50;59
4770;0;Lomba do Pinheiro;Rubem Berta;652;100;228;66;250;402
4771;0;Lomba do Pinheiro;Santa Cecília;100;50;25;11;50;50
4772;0;Lomba do Pinheiro;Santa Maria Goretti;50;50;0;0;50;0
4773;0;Lomba do Pinheiro;Santa Rosa de Lima;201;50;90;20;50;151
4774;0;Lomba do Pinheiro;Santa Tereza;267;50;122;36;50;217
4775;0;Lomba do Pinheiro;Santana;162;0;42;9;100;62
4776;0;Lomba do Pinheiro;Santo Antônio;151;0;83;31;0;151
4777;0;Lomba do Pinheiro;Sarandi;341;50;75;32;200;141
4778;0;Lomba do Pinheiro;Serraria;50;0;30;9;0;50
4779;0;Lomba do Pinheiro;São Caetano;50;0;24;8;0;50
4780;0;Lomba do Pinheiro;São Geraldo;200;0;115;25;0;200
4781;0;Lomba do Pinheiro;São José;1510;300;612;155;500;1010
4782;0;Lomba do Pinheiro;São João;50;0;50;0;50;0
4783;0;Lomba do Pinheiro;São Sebastião;200;50;82;29;50;150
4784;0;Lomba do Pinheiro;Sétimo Céu;50;0;35;3;0;50
4785;0;Lomba do Pinheiro;Teresópolis;100;100;0;0;100;0
4786;0;Lomba do Pinheiro;Tristeza;12;0;7;3;0;12
4787;0;Lomba do Pinheiro;Três Figueiras;100;50;30;7;50;50
4788;0;Lomba do Pinheiro;Vila Assunção;50;0;29;13;0;50
4789;0;Lomba do Pinheiro;Vila Conceição;0;0;0;0;0;0
4790;0;Lomba do Pinheiro;Vila Ipiranga;301;0;134;41;50;251
4791;0;Lomba do Pinheiro;Vila Jardim;210;50;92;20;50;160
4792;0;Lomba do Pinheiro;Vila João Pessoa;900;100;419;124;200;700
4793;0;Lomba do Pinheiro;Vila Nova;341;100;130;25;200;141
4794;0;Medianeira;Aberta dos Morros;147;97;29;15;97;50
4795;0;Medianeira;Agronomia;0;0;0;0;0;0
4796;0;Medianeira;Anchieta;0;0;0;0;0;0
4797;0;Medianeira;Arquipélago;0;0;0;0;0;0
4798;0;Medianeira;Auxiliadora;145;0;23;12;95;50
4799;0;Medianeira;Azenha;1949;100;891;418;399;1550
4800;0;Medianeira;Bela Vista;101;0;58;28;0;101
4801;0;Medianeira;Belém Novo;50;0;30;7;0;50
4802;0;Medianeira;Belém Velho;53;0;35;7;0;53
4803;0;Medianeira;Boa Vista;50;50;0;0;50;0
4804;0;Medianeira;Boa Vista do Sul;50;0;27;12;0;50
4805;0;Medianeira;Bom Fim;292;96;58;34;192;100
4806;0;Medianeira;Bom Jesus;251;97;96;21;97;154
4807;0;Medianeira;Camaquã;150;0;25;10;99;51
4808;0;Medianeira;Campo Novo;150;0;73;19;50;100
4809;0;Medianeira;Cascata;50;0;25;9;0;50
4810;0;Medianeira;Cavalhada;205;0;58;31;98;107
4811;0;Medianeira;Cel. Aparício Borges;454;0;214;52;147;307
4812;0;Medianeira;Centro Histórico;527;144;117;61;273;254
4813;0;Medianeira;Chapéu do Sol;0;0;0;0;0;0
4814;0;Medianeira;Chácara das Pedras;50;0;26;15;0;50
4815;0;Medianeira;Cidade Baixa;543;97;230;81;192;351
4816;0;Medianeira;Costa e Silva;55;50;3;2;50;5
4817;0;Medianeira;Cristal;432;244;57;16;326;106
4818;0;Medianeira;Cristo Redentor;105;0;33;13;48;57
4819;0;Medianeira;Espírito Santo;182;0;83;26;82;100
4820;0;Medianeira;Extrema;50;0;32;17;0;50
4821;0;Medianeira;Farrapos;872;185;89;12;822;50
4822;0;Medianeira;Farroupilha;150;50;0;0;150;0
4823;0;Medianeira;Floresta;0;0;0;0;0;0
4824;0;Medianeira;Glória;482;50;84;34;332;150
4825;0;Medianeira;Guarujá;0;0;0;0;0;0
4826;0;Medianeira;Higienópolis;150;50;51;28;50;100
4827;0;Medianeira;Humaitá;0;0;0;0;0;0
4828;0;Medianeira;Hípica;100;0;36;11;50;50
4829;0;Medianeira;Independência;150;50;52;28;50;100
4830;0;Medianeira;Ipanema;103;100;3;0;100;3
4831;0;Medianeira;Jardim Botânico;351;50;110;43;147;204
4832;0;Medianeira;Jardim Carvalho;148;48;62;21;48;100
4833;0;Medianeira;Jardim Europa;0;0;0;0;0;0
4834;0;Medianeira;Jardim Floresta;50;0;28;13;0;50
4835;0;Medianeira;Jardim Isabel;0;0;0;0;0;0
4836;0;Medianeira;Jardim Itú;48;48;0;0;48;0
4837;0;Medianeira;Jardim Leopoldina;53;0;38;11;0;53
4838;0;Medianeira;Jardim Lindóia;48;48;0;0;48;0
4839;0;Medianeira;Jardim Sabará;0;0;0;0;0;0
4840;0;Medianeira;Jardim São Pedro;50;0;28;13;0;50
4841;0;Medianeira;Jardim do Salso;100;0;31;8;50;50
4842;0;Medianeira;Lageado;150;0;90;31;0;150
4843;0;Medianeira;Lami;100;0;0;0;100;0
4844;0;Medianeira;Lomba do Pinheiro;403;0;203;48;50;353
4845;0;Medianeira;Medianeira;10136;2271;3656;1762;3736;6400
4846;0;Medianeira;Menino Deus;823;293;193;107;467;356
4847;0;Medianeira;Moinhos de Vento;150;50;44;32;50;100
4848;0;Medianeira;Mont'Serrat;50;0;29;11;0;50
4849;0;Medianeira;Morro Santana;56;50;3;1;50;6
4850;0;Medianeira;Mário Quintana;56;0;25;8;0;56
4851;0;Medianeira;Navegantes;150;50;52;24;50;100
4852;0;Medianeira;Nonoai;847;50;391;133;246;601
4853;0;Medianeira;Parque Santa Fé;50;0;29;16;0;50
4854;0;Medianeira;Partenon;4281;534;1917;777;927;3354
4855;0;Medianeira;Passo D'Areia;205;98;42;38;98;107
4856;0;Medianeira;Passo das Pedras;102;0;39;10;48;54
4857;0;Medianeira;Pedra Redonda;0;0;0;0;0;0
4858;0;Medianeira;Petrópolis;455;50;187;115;98;357
4859;0;Medianeira;Pitinga;0;0;0;0;0;0
4860;0;Medianeira;Ponta Grossa;50;0;31;7;0;50
4861;0;Medianeira;Praia de Belas;197;47;83;17;147;50
4862;0;Medianeira;Restinga;108;0;67;11;0;108
4863;0;Medianeira;Rio Branco;351;97;98;62;147;204
4864;0;Medianeira;Rubem Berta;100;50;29;18;50;50
4865;0;Medianeira;Santa Cecília;450;50;190;91;100;350
4866;0;Medianeira;Santa Maria Goretti;0;0;0;0;0;0
4867;0;Medianeira;Santa Rosa de Lima;100;0;62;20;0;100
4868;0;Medianeira;Santa Tereza;4902;2180;783;200;3844;1058
4869;0;Medianeira;Santana;654;150;190;101;300;354
4870;0;Medianeira;Santo Antônio;1968;789;489;213;1118;850
4871;0;Medianeira;Sarandi;202;47;32;17;144;58
4872;0;Medianeira;Serraria;150;0;93;31;0;150
4873;0;Medianeira;São Caetano;100;0;42;29;0;100
4874;0;Medianeira;São Geraldo;50;50;0;0;50;0
4875;0;Medianeira;São José;53;0;29;7;0;53
4876;0;Medianeira;São João;148;48;56;18;48;100
4877;0;Medianeira;São Sebastião;50;50;0;0;50;0
4878;0;Medianeira;Sétimo Céu;0;0;0;0;0;0
4879;0;Medianeira;Teresópolis;647;197;278;108;197;450
4880;0;Medianeira;Tristeza;154;0;90;46;0;154
4881;0;Medianeira;Três Figueiras;0;0;0;0;0;0
4882;0;Medianeira;Vila Assunção;100;0;37;10;50;50
4883;0;Medianeira;Vila Conceição;0;0;0;0;0;0
4884;0;Medianeira;Vila Ipiranga;248;48;124;41;48;200
4885;0;Medianeira;Vila Jardim;4;0;2;1;0;4
4886;0;Medianeira;Vila João Pessoa;497;197;152;67;247;250
4887;0;Medianeira;Vila Nova;157;50;38;14;100;57
4888;0;Menino Deus;Aberta dos Morros;76;0;18;3;50;26
4889;0;Menino Deus;Agronomia;100;0;53;28;0;100
4890;0;Menino Deus;Anchieta;50;0;0;0;50;0
4891;0;Menino Deus;Arquipélago;264;50;87;53;100;164
4892;0;Menino Deus;Auxiliadora;652;100;171;86;400;252
4893;0;Menino Deus;Azenha;957;50;423;191;200;757
4894;0;Menino Deus;Bela Vista;303;150;67;31;200;103
4895;0;Menino Deus;Belém Novo;150;0;52;40;50;100
4896;0;Menino Deus;Belém Velho;88;0;47;31;0;88
4897;0;Menino Deus;Boa Vista;217;50;98;46;50;167
4898;0;Menino Deus;Boa Vista do Sul;50;50;0;0;50;0
4899;0;Menino Deus;Bom Fim;791;100;262;128;300;491
4900;0;Menino Deus;Bom Jesus;90;0;55;18;0;90
4901;0;Menino Deus;Camaquã;257;0;111;52;50;207
4902;0;Menino Deus;Campo Novo;50;0;26;21;0;50
4903;0;Menino Deus;Cascata;226;0;88;33;50;176
4904;0;Menino Deus;Cavalhada;88;50;26;7;50;38
4905;0;Menino Deus;Cel. Aparício Borges;42;0;29;2;0;42
4906;0;Menino Deus;Centro Histórico;1727;550;405;134;1250;477
4907;0;Menino Deus;Chapéu do Sol;0;0;0;0;0;0
4908;0;Menino Deus;Chácara das Pedras;226;0;112;46;50;176
4909;0;Menino Deus;Cidade Baixa;11617;900;5383;2784;2100;9517
4910;0;Menino Deus;Costa e Silva;60;0;28;19;0;60
4911;0;Menino Deus;Cristal;286;50;49;25;200;86
4912;0;Menino Deus;Cristo Redentor;59;0;36;10;0;59
4913;0;Menino Deus;Espírito Santo;100;50;0;0;100;0
4914;0;Menino Deus;Extrema;50;0;30;18;0;50
4915;0;Menino Deus;Farrapos;4500;0;2490;1013;0;4500
4916;0;Menino Deus;Farroupilha;3350;350;1301;741;950;2400
4917;0;Menino Deus;Floresta;350;150;52;34;250;100
4918;0;Menino Deus;Glória;394;50;135;58;150;244
4919;0;Menino Deus;Guarujá;50;0;0;0;50;0
4920;0;Menino Deus;Higienópolis;52;0;23;9;0;52
4921;0;Menino Deus;Humaitá;170;0;109;44;0;170
4922;0;Menino Deus;Hípica;153;0;32;9;100;53
4923;0;Menino Deus;Independência;803;100;254;149;300;503
4924;0;Menino Deus;Ipanema;109;50;4;4;100;9
4925;0;Menino Deus;Jardim Botânico;64;50;7;4;50;14
4926;0;Menino Deus;Jardim Carvalho;84;0;49;21;0;84
4927;0;Menino Deus;Jardim Europa;103;0;56;43;0;103
4928;0;Menino Deus;Jardim Floresta;100;50;25;14;50;50
4929;0;Menino Deus;Jardim Isabel;100;100;0;0;100;0
4930;0;Menino Deus;Jardim Itú;100;50;0;0;100;0
4931;0;Menino Deus;Jardim Leopoldina;33;0;21;9;0;33
4932;0;Menino Deus;Jardim Lindóia;126;0;42;12;50;76
4933;0;Menino Deus;Jardim Sabará;0;0;0;0;0;0
4934;0;Menino Deus;Jardim São Pedro;50;0;0;0;50;0
4935;0;Menino Deus;Jardim do Salso;150;0;62;22;50;100
4936;0;Menino Deus;Lageado;150;50;57;35;50;100
4937;0;Menino Deus;Lami;150;50;34;8;100;50
4938;0;Menino Deus;Lomba do Pinheiro;105;0;26;17;50;55
4939;0;Menino Deus;Medianeira;771;300;139;89;500;271
4940;0;Menino Deus;Menino Deus;5528;1800;421;118;5100;428
4941;0;Menino Deus;Moinhos de Vento;550;100;171;78;300;250
4942;0;Menino Deus;Mont'Serrat;115;0;42;16;50;65
4943;0;Menino Deus;Morro Santana;184;50;50;13;100;84
4944;0;Menino Deus;Mário Quintana;186;50;57;21;100;86
4945;0;Menino Deus;Navegantes;150;0;52;35;50;100
4946;0;Menino Deus;Nonoai;322;0;100;32;150;172
4947;0;Menino Deus;Parque Santa Fé;176;50;49;24;100;76
4948;0;Menino Deus;Partenon;283;0;131;56;50;233
4949;0;Menino Deus;Passo D'Areia;268;50;105;64;50;218
4950;0;Menino Deus;Passo das Pedras;163;0;64;15;50;113
4951;0;Menino Deus;Pedra Redonda;200;0;114;57;0;200
4952;0;Menino Deus;Petrópolis;667;150;216;92;300;367
4953;0;Menino Deus;Pitinga;50;0;0;0;50;0
4954;0;Menino Deus;Ponta Grossa;150;50;51;28;50;100
4955;0;Menino Deus;Praia de Belas;3428;750;1170;708;1200;2228
4956;0;Menino Deus;Restinga;81;0;37;22;0;81
4957;0;Menino Deus;Rio Branco;867;150;274;95;550;317
4958;0;Menino Deus;Rubem Berta;52;50;1;1;50;2
4959;0;Menino Deus;Santa Cecília;513;150;167;34;400;113
4960;0;Menino Deus;Santa Maria Goretti;270;0;167;81;0;270
4961;0;Menino Deus;Santa Rosa de Lima;128;0;21;1;100;28
4962;0;Menino Deus;Santa Tereza;1495;200;548;199;700;795
4963;0;Menino Deus;Santana;1014;150;467;199;330;684
4964;0;Menino Deus;Santo Antônio;605;100;161;85;300;305
4965;0;Menino Deus;Sarandi;190;0;104;48;0;190
4966;0;Menino Deus;Serraria;100;0;31;8;50;50
4967;0;Menino Deus;São Caetano;0;0;0;0;0;0
4968;0;Menino Deus;São Geraldo;200;50;54;22;100;100
4969;0;Menino Deus;São José;211;0;35;14;150;61
4970;0;Menino Deus;São João;200;0;88;48;50;150
4971;0;Menino Deus;São Sebastião;100;0;62;28;0;100
4972;0;Menino Deus;Sétimo Céu;50;0;27;9;0;50
4973;0;Menino Deus;Teresópolis;273;0;133;63;50;223
4974;0;Menino Deus;Tristeza;151;0;24;16;100;51
4975;0;Menino Deus;Três Figueiras;250;150;67;23;150;100
4976;0;Menino Deus;Vila Assunção;226;50;85;51;50;176
4977;0;Menino Deus;Vila Conceição;100;0;32;16;50;50
4978;0;Menino Deus;Vila Ipiranga;153;0;85;47;0;153
4979;0;Menino Deus;Vila Jardim;155;0;32;20;100;55
4980;0;Menino Deus;Vila João Pessoa;200;0;86;35;50;150
4981;0;Menino Deus;Vila Nova;182;50;46;27;100;82
4982;0;Moinhos de Vento;Aberta dos Morros;50;0;27;19;0;50
4983;0;Moinhos de Vento;Agronomia;0;0;0;0;0;0
4984;0;Moinhos de Vento;Anchieta;50;0;25;21;0;50
4985;0;Moinhos de Vento;Arquipélago;200;0;104;42;0;200
4986;0;Moinhos de Vento;Auxiliadora;955;350;205;90;650;305
4987;0;Moinhos de Vento;Azenha;252;0;106;51;50;202
4988;0;Moinhos de Vento;Bela Vista;359;100;48;48;250;109
4989;0;Moinhos de Vento;Belém Novo;0;0;0;0;0;0
4990;0;Moinhos de Vento;Belém Velho;112;0;43;50;0;112
4991;0;Moinhos de Vento;Boa Vista;353;100;104;62;150;203
4992;0;Moinhos de Vento;Boa Vista do Sul;0;0;0;0;0;0
4993;0;Moinhos de Vento;Bom Fim;1100;100;351;140;600;500
4994;0;Moinhos de Vento;Bom Jesus;170;50;73;20;50;120
4995;0;Moinhos de Vento;Camaquã;156;50;60;32;50;106
4996;0;Moinhos de Vento;Campo Novo;100;0;23;24;50;50
4997;0;Moinhos de Vento;Cascata;50;0;23;6;0;50
4998;0;Moinhos de Vento;Cavalhada;190;50;97;13;100;90
4999;0;Moinhos de Vento;Cel. Aparício Borges;231;0;142;43;50;181
5000;0;Moinhos de Vento;Centro Histórico;1912;150;880;442;300;1612
5001;0;Moinhos de Vento;Chapéu do Sol;100;50;29;12;50;50
5002;0;Moinhos de Vento;Chácara das Pedras;100;0;0;0;100;0
5003;0;Moinhos de Vento;Cidade Baixa;310;0;100;54;100;210
5004;0;Moinhos de Vento;Costa e Silva;115;0;35;19;50;65
5005;0;Moinhos de Vento;Cristal;89;0;52;19;0;89
5006;0;Moinhos de Vento;Cristo Redentor;128;50;50;15;50;78
5007;0;Moinhos de Vento;Espírito Santo;50;0;19;24;0;50
5008;0;Moinhos de Vento;Extrema;0;0;0;0;0;0
5009;0;Moinhos de Vento;Farrapos;250;50;135;42;50;200
5010;0;Moinhos de Vento;Farroupilha;200;0;73;54;50;150
5011;0;Moinhos de Vento;Floresta;1450;250;572;321;350;1100
5012;0;Moinhos de Vento;Glória;0;0;0;0;0;0
5013;0;Moinhos de Vento;Guarujá;150;50;41;38;50;100
5014;0;Moinhos de Vento;Higienópolis;105;0;80;11;50;55
5015;0;Moinhos de Vento;Humaitá;100;50;25;12;50;50
5016;0;Moinhos de Vento;Hípica;53;0;39;5;0;53
5017;0;Moinhos de Vento;Independência;1200;150;398;332;300;900
5018;0;Moinhos de Vento;Ipanema;111;0;59;43;0;111
5019;0;Moinhos de Vento;Jardim Botânico;166;50;41;11;100;66
5020;0;Moinhos de Vento;Jardim Carvalho;405;100;133;64;150;255
5021;0;Moinhos de Vento;Jardim Europa;50;0;23;18;0;50
5022;0;Moinhos de Vento;Jardim Floresta;0;0;0;0;0;0
5023;0;Moinhos de Vento;Jardim Isabel;0;0;0;0;0;0
5024;0;Moinhos de Vento;Jardim Itú;100;50;21;23;50;50
5025;0;Moinhos de Vento;Jardim Leopoldina;162;50;57;3;150;12
5026;0;Moinhos de Vento;Jardim Lindóia;100;0;23;19;50;50
5027;0;Moinhos de Vento;Jardim Sabará;250;100;46;39;150;100
5028;0;Moinhos de Vento;Jardim São Pedro;0;0;0;0;0;0
5029;0;Moinhos de Vento;Jardim do Salso;0;0;0;0;0;0
5030;0;Moinhos de Vento;Lageado;50;0;29;19;0;50
5031;0;Moinhos de Vento;Lami;100;0;54;23;0;100
5032;0;Moinhos de Vento;Lomba do Pinheiro;61;0;36;5;0;61
5033;0;Moinhos de Vento;Medianeira;150;50;44;32;50;100
5034;0;Moinhos de Vento;Menino Deus;579;100;183;89;300;279
5035;0;Moinhos de Vento;Moinhos de Vento;3400;300;1190;978;1000;2400
5036;0;Moinhos de Vento;Mont'Serrat;853;100;314;212;250;603
5037;0;Moinhos de Vento;Morro Santana;78;0;43;22;0;78
5038;0;Moinhos de Vento;Mário Quintana;42;0;27;6;0;42
5039;0;Moinhos de Vento;Navegantes;150;0;80;52;0;150
5040;0;Moinhos de Vento;Nonoai;60;0;8;0;50;10
5041;0;Moinhos de Vento;Parque Santa Fé;0;0;0;0;0;0
5042;0;Moinhos de Vento;Partenon;318;0;149;58;50;268
5043;0;Moinhos de Vento;Passo D'Areia;328;50;118;102;50;278
5044;0;Moinhos de Vento;Passo das Pedras;68;0;37;25;0;68
5045;0;Moinhos de Vento;Pedra Redonda;0;0;0;0;0;0
5046;0;Moinhos de Vento;Petrópolis;429;100;170;71;200;229
5047;0;Moinhos de Vento;Pitinga;100;0;58;32;0;100
5048;0;Moinhos de Vento;Ponta Grossa;100;0;47;33;0;100
5049;0;Moinhos de Vento;Praia de Belas;100;50;23;16;50;50
5050;0;Moinhos de Vento;Restinga;44;0;24;8;0;44
5051;0;Moinhos de Vento;Rio Branco;2410;350;843;617;750;1660
5052;0;Moinhos de Vento;Rubem Berta;55;50;2;2;50;5
5053;0;Moinhos de Vento;Santa Cecília;500;50;186;150;100;400
5054;0;Moinhos de Vento;Santa Maria Goretti;100;0;46;27;0;100
5055;0;Moinhos de Vento;Santa Rosa de Lima;100;0;49;39;0;100
5056;0;Moinhos de Vento;Santa Tereza;284;0;125;70;50;234
5057;0;Moinhos de Vento;Santana;415;50;150;70;150;265
5058;0;Moinhos de Vento;Santo Antônio;105;50;30;22;50;55
5059;0;Moinhos de Vento;Sarandi;90;0;55;23;0;90
5060;0;Moinhos de Vento;Serraria;50;50;0;0;50;0
5061;0;Moinhos de Vento;São Caetano;50;0;0;0;50;0
5062;0;Moinhos de Vento;São Geraldo;450;100;175;49;300;150
5063;0;Moinhos de Vento;São José;61;0;38;9;0;61
5064;0;Moinhos de Vento;São João;850;200;242;175;350;500
5065;0;Moinhos de Vento;São Sebastião;100;0;56;20;0;100
5066;0;Moinhos de Vento;Sétimo Céu;50;50;0;0;50;0
5067;0;Moinhos de Vento;Teresópolis;50;0;30;13;0;50
5068;0;Moinhos de Vento;Tristeza;118;0;65;37;0;118
5069;0;Moinhos de Vento;Três Figueiras;150;0;77;52;0;150
5070;0;Moinhos de Vento;Vila Assunção;50;0;29;19;0;50
5071;0;Moinhos de Vento;Vila Conceição;0;0;0;0;0;0
5072;0;Moinhos de Vento;Vila Ipiranga;100;50;25;23;50;50
5073;0;Moinhos de Vento;Vila Jardim;263;50;98;67;50;213
5074;0;Moinhos de Vento;Vila João Pessoa;100;100;0;0;100;0
5075;0;Moinhos de Vento;Vila Nova;190;0;80;46;0;190
5076;0;Mont'Serrat;Aberta dos Morros;50;0;32;14;0;50
5077;0;Mont'Serrat;Agronomia;0;0;0;0;0;0
5078;0;Mont'Serrat;Anchieta;50;0;34;14;0;50
5079;0;Mont'Serrat;Arquipélago;0;0;0;0;0;0
5080;0;Mont'Serrat;Auxiliadora;1990;150;1014;447;300;1690
5081;0;Mont'Serrat;Azenha;197;0;75;37;50;147
5082;0;Mont'Serrat;Bela Vista;1121;100;546;263;150;971
5083;0;Mont'Serrat;Belém Novo;100;0;83;14;50;50
5084;0;Mont'Serrat;Belém Velho;23;0;17;4;0;23
5085;0;Mont'Serrat;Boa Vista;598;0;350;141;0;598
5086;0;Mont'Serrat;Boa Vista do Sul;0;0;0;0;0;0
5087;0;Mont'Serrat;Bom Fim;50;0;26;11;0;50
5088;0;Mont'Serrat;Bom Jesus;253;50;79;15;150;103
5089;0;Mont'Serrat;Camaquã;160;0;63;28;50;110
5090;0;Mont'Serrat;Campo Novo;19;0;13;0;0;19
5091;0;Mont'Serrat;Cascata;111;50;39;11;50;61
5092;0;Mont'Serrat;Cavalhada;142;0;28;8;100;42
5093;0;Mont'Serrat;Cel. Aparício Borges;83;0;19;4;50;33
5094;0;Mont'Serrat;Centro Histórico;485;0;142;45;300;185
5095;0;Mont'Serrat;Chapéu do Sol;50;0;23;20;0;50
5096;0;Mont'Serrat;Chácara das Pedras;225;50;9;8;200;25
5097;0;Mont'Serrat;Cidade Baixa;246;0;99;39;50;196
5098;0;Mont'Serrat;Costa e Silva;73;0;46;13;0;73
5099;0;Mont'Serrat;Cristal;101;0;51;26;0;101
5100;0;Mont'Serrat;Cristo Redentor;177;50;72;26;50;127
5101;0;Mont'Serrat;Espírito Santo;0;0;0;0;0;0
5102;0;Mont'Serrat;Extrema;50;0;25;14;0;50
5103;0;Mont'Serrat;Farrapos;5443;0;3003;1367;150;5293
5104;0;Mont'Serrat;Farroupilha;100;100;0;0;100;0
5105;0;Mont'Serrat;Floresta;219;50;8;9;200;19
5106;0;Mont'Serrat;Glória;53;50;1;1;50;3
5107;0;Mont'Serrat;Guarujá;0;0;0;0;0;0
5108;0;Mont'Serrat;Higienópolis;939;200;285;79;550;389
5109;0;Mont'Serrat;Humaitá;150;50;31;13;100;50
5110;0;Mont'Serrat;Hípica;3;0;2;1;0;3
5111;0;Mont'Serrat;Independência;250;100;87;31;100;150
5112;0;Mont'Serrat;Ipanema;40;0;26;7;0;40
5113;0;Mont'Serrat;Jardim Botânico;275;200;14;8;250;25
5114;0;Mont'Serrat;Jardim Carvalho;132;50;44;20;50;82
5115;0;Mont'Serrat;Jardim Europa;100;0;0;0;100;0
5116;0;Mont'Serrat;Jardim Floresta;51;0;1;0;50;1
5117;0;Mont'Serrat;Jardim Isabel;50;0;30;11;0;50
5118;0;Mont'Serrat;Jardim Itú;202;50;100;35;50;152
5119;0;Mont'Serrat;Jardim Leopoldina;81;0;49;17;0;81
5120;0;Mont'Serrat;Jardim Lindóia;100;0;62;23;0;100
5121;0;Mont'Serrat;Jardim Sabará;61;0;7;2;50;11
5122;0;Mont'Serrat;Jardim São Pedro;50;0;50;0;50;0
5123;0;Mont'Serrat;Jardim do Salso;150;100;23;11;100;50
5124;0;Mont'Serrat;Lageado;0;0;0;0;0;0
5125;0;Mont'Serrat;Lami;50;0;29;13;0;50
5126;0;Mont'Serrat;Lomba do Pinheiro;61;0;30;18;0;61
5127;0;Mont'Serrat;Medianeira;50;0;29;11;0;50
5128;0;Mont'Serrat;Menino Deus;145;0;53;27;50;95
5129;0;Mont'Serrat;Moinhos de Vento;577;100;185;95;250;327
5130;0;Mont'Serrat;Mont'Serrat;4315;1200;1015;339;2900;1415
5131;0;Mont'Serrat;Morro Santana;129;50;51;6;50;79
5132;0;Mont'Serrat;Mário Quintana;243;50;85;20;100;143
5133;0;Mont'Serrat;Navegantes;0;0;0;0;0;0
5134;0;Mont'Serrat;Nonoai;70;0;52;16;0;70
5135;0;Mont'Serrat;Parque Santa Fé;0;0;0;0;0;0
5136;0;Mont'Serrat;Partenon;189;0;80;32;50;139
5137;0;Mont'Serrat;Passo D'Areia;443;0;130;95;150;293
5138;0;Mont'Serrat;Passo das Pedras;281;0;183;27;150;131
5139;0;Mont'Serrat;Pedra Redonda;0;0;0;0;0;0
5140;0;Mont'Serrat;Petrópolis;1722;650;187;69;1450;272
5141;0;Mont'Serrat;Pitinga;150;0;88;31;0;150
5142;0;Mont'Serrat;Ponta Grossa;0;0;0;0;0;0
5143;0;Mont'Serrat;Praia de Belas;100;0;61;22;0;100
5144;0;Mont'Serrat;Restinga;170;50;44;9;100;70
5145;0;Mont'Serrat;Rio Branco;392;150;135;33;250;142
5146;0;Mont'Serrat;Rubem Berta;61;0;32;17;0;61
5147;0;Mont'Serrat;Santa Cecília;150;0;63;24;50;100
5148;0;Mont'Serrat;Santa Maria Goretti;50;0;24;15;0;50
5149;0;Mont'Serrat;Santa Rosa de Lima;103;0;38;10;50;53
5150;0;Mont'Serrat;Santa Tereza;106;50;33;11;50;56
5151;0;Mont'Serrat;Santana;634;200;83;38;500;134
5152;0;Mont'Serrat;Santo Antônio;155;50;23;17;100;55
5153;0;Mont'Serrat;Sarandi;211;100;30;21;150;61
5154;0;Mont'Serrat;Serraria;0;0;0;0;0;0
5155;0;Mont'Serrat;São Caetano;50;0;29;10;0;50
5156;0;Mont'Serrat;São Geraldo;175;0;33;23;100;75
5157;0;Mont'Serrat;São José;199;0;77;24;50;149
5158;0;Mont'Serrat;São João;393;150;99;59;200;193
5159;0;Mont'Serrat;São Sebastião;50;0;0;0;50;0
5160;0;Mont'Serrat;Sétimo Céu;0;0;0;0;0;0
5161;0;Mont'Serrat;Teresópolis;75;0;49;17;0;75
5162;0;Mont'Serrat;Tristeza;77;0;41;22;0;77
5163;0;Mont'Serrat;Três Figueiras;1500;250;717;329;250;1250
5164;0;Mont'Serrat;Vila Assunção;50;0;29;15;0;50
5165;0;Mont'Serrat;Vila Conceição;50;0;23;10;0;50
5166;0;Mont'Serrat;Vila Ipiranga;216;50;71;35;100;116
5167;0;Mont'Serrat;Vila Jardim;218;50;70;26;100;118
5168;0;Mont'Serrat;Vila João Pessoa;227;100;53;16;150;77
5169;0;Mont'Serrat;Vila Nova;160;0;35;8;100;60
5170;0;Morro Santana;Aberta dos Morros;50;0;25;11;0;50
5171;0;Morro Santana;Agronomia;650;50;311;102;50;600
5172;0;Morro Santana;Anchieta;50;0;37;8;0;50
5173;0;Morro Santana;Arquipélago;50;0;0;0;50;0
5174;0;Morro Santana;Auxiliadora;100;0;0;0;100;0
5175;0;Morro Santana;Azenha;0;0;0;0;0;0
5176;0;Morro Santana;Bela Vista;156;100;35;11;100;56
5177;0;Morro Santana;Belém Novo;100;50;0;0;100;0
5178;0;Morro Santana;Belém Velho;209;0;95;33;50;159
5179;0;Morro Santana;Boa Vista;50;0;31;12;0;50
5180;0;Morro Santana;Boa Vista do Sul;100;0;54;18;0;100
5181;0;Morro Santana;Bom Fim;0;0;0;0;0;0
5182;0;Morro Santana;Bom Jesus;962;50;446;154;150;812
5183;0;Morro Santana;Camaquã;54;0;28;11;0;54
5184;0;Morro Santana;Campo Novo;0;0;0;0;0;0
5185;0;Morro Santana;Cascata;350;150;61;12;250;100
5186;0;Morro Santana;Cavalhada;169;0;76;17;50;119
5187;0;Morro Santana;Cel. Aparício Borges;117;50;40;11;50;67
5188;0;Morro Santana;Centro Histórico;458;50;180;47;200;258
5189;0;Morro Santana;Chapéu do Sol;100;50;27;9;50;50
5190;0;Morro Santana;Chácara das Pedras;250;0;131;54;0;250
5191;0;Morro Santana;Cidade Baixa;106;0;36;12;50;56
5192;0;Morro Santana;Costa e Silva;212;50;93;36;50;162
5193;0;Morro Santana;Cristal;169;50;64;30;50;119
5194;0;Morro Santana;Cristo Redentor;214;0;68;24;100;114
5195;0;Morro Santana;Espírito Santo;0;0;0;0;0;0
5196;0;Morro Santana;Extrema;100;50;25;14;50;50
5197;0;Morro Santana;Farrapos;11372;5152;3914;1182;2969;3805
5198;0;Morro Santana;Farroupilha;0;0;0;0;0;0
5199;0;Morro Santana;Floresta;50;50;0;0;50;0
5200;0;Morro Santana;Glória;353;50;140;67;100;253
5201;0;Morro Santana;Guarujá;100;0;26;12;50;50
5202;0;Morro Santana;Higienópolis;202;0;117;47;0;202
5203;0;Morro Santana;Humaitá;0;0;0;0;0;0
5204;0;Morro Santana;Hípica;151;50;67;14;50;101
5205;0;Morro Santana;Independência;0;0;0;0;0;0
5206;0;Morro Santana;Ipanema;109;50;38;10;50;59
5207;0;Morro Santana;Jardim Botânico;109;0;56;2;100;9
5208;0;Morro Santana;Jardim Carvalho;552;150;185;50;250;302
5209;0;Morro Santana;Jardim Europa;196;0;88;29;46;150
5210;0;Morro Santana;Jardim Floresta;50;0;33;10;0;50
5211;0;Morro Santana;Jardim Isabel;100;0;80;7;50;50
5212;0;Morro Santana;Jardim Itú;702;100;232;67;350;352
5213;0;Morro Santana;Jardim Leopoldina;657;0;350;115;50;607
5214;0;Morro Santana;Jardim Lindóia;50;0;37;7;0;50
5215;0;Morro Santana;Jardim Sabará;1000;150;394;144;350;650
5216;0;Morro Santana;Jardim São Pedro;50;50;0;0;50;0
5217;0;Morro Santana;Jardim do Salso;150;0;56;18;50;100
5218;0;Morro Santana;Lageado;0;0;0;0;0;0
5219;0;Morro Santana;Lami;0;0;0;0;0;0
5220;0;Morro Santana;Lomba do Pinheiro;1156;150;606;108;150;1006
5221;0;Morro Santana;Medianeira;50;50;0;0;50;0
5222;0;Morro Santana;Menino Deus;267;50;98;27;100;167
5223;0;Morro Santana;Moinhos de Vento;50;0;27;15;0;50
5224;0;Morro Santana;Mont'Serrat;150;50;61;20;50;100
5225;0;Morro Santana;Morro Santana;10214;1900;3709;1060;4500;5714
5226;0;Morro Santana;Mário Quintana;2178;850;449;116;1450;728
5227;0;Morro Santana;Navegantes;50;0;50;0;50;0
5228;0;Morro Santana;Nonoai;6;0;5;1;0;6
5229;0;Morro Santana;Parque Santa Fé;550;0;314;98;0;550
5230;0;Morro Santana;Partenon;413;150;119;50;200;213
5231;0;Morro Santana;Passo D'Areia;63;0;29;23;0;63
5232;0;Morro Santana;Passo das Pedras;2661;150;1392;436;300;2361
5233;0;Morro Santana;Pedra Redonda;0;0;0;0;0;0
5234;0;Morro Santana;Petrópolis;466;100;169;90;150;316
5235;0;Morro Santana;Pitinga;100;0;34;2;50;50
5236;0;Morro Santana;Ponta Grossa;50;0;31;10;0;50
5237;0;Morro Santana;Praia de Belas;50;50;0;0;50;0
5238;0;Morro Santana;Restinga;169;50;63;27;50;119
5239;0;Morro Santana;Rio Branco;260;50;106;57;50;210
5240;0;Morro Santana;Rubem Berta;1505;350;543;353;500;1005
5241;0;Morro Santana;Santa Cecília;50;0;31;12;0;50
5242;0;Morro Santana;Santa Maria Goretti;200;50;97;14;50;150
5243;0;Morro Santana;Santa Rosa de Lima;252;100;94;23;100;152
5244;0;Morro Santana;Santa Tereza;367;100;103;29;200;167
5245;0;Morro Santana;Santana;159;0;34;11;100;59
5246;0;Morro Santana;Santo Antônio;103;0;59;21;0;103
5247;0;Morro Santana;Sarandi;231;0;125;36;100;131
5248;0;Morro Santana;Serraria;0;0;0;0;0;0
5249;0;Morro Santana;São Caetano;50;0;27;9;0;50
5250;0;Morro Santana;São Geraldo;0;0;0;0;0;0
5251;0;Morro Santana;São José;211;50;70;18;100;111
5252;0;Morro Santana;São João;150;50;57;22;50;100
5253;0;Morro Santana;São Sebastião;150;0;90;24;0;150
5254;0;Morro Santana;Sétimo Céu;0;0;0;0;0;0
5255;0;Morro Santana;Teresópolis;200;0;125;39;0;200
5256;0;Morro Santana;Tristeza;60;0;5;4;50;10
5257;0;Morro Santana;Três Figueiras;50;0;28;7;0;50
5258;0;Morro Santana;Vila Assunção;100;0;58;20;0;100
5259;0;Morro Santana;Vila Conceição;0;0;0;0;0;0
5260;0;Morro Santana;Vila Ipiranga;202;50;85;26;50;152
5261;0;Morro Santana;Vila Jardim;258;0;133;32;50;208
5262;0;Morro Santana;Vila João Pessoa;0;0;0;0;0;0
5263;0;Morro Santana;Vila Nova;81;0;41;15;0;81
5264;0;Mário Quintana;Aberta dos Morros;0;0;0;0;0;0
5265;0;Mário Quintana;Agronomia;100;0;60;12;0;100
5266;0;Mário Quintana;Anchieta;50;50;0;0;50;0
5267;0;Mário Quintana;Arquipélago;250;0;108;28;50;200
5268;0;Mário Quintana;Auxiliadora;199;47;58;8;97;102
5269;0;Mário Quintana;Azenha;150;0;93;19;0;150
5270;0;Mário Quintana;Bela Vista;143;0;54;14;48;95
5271;0;Mário Quintana;Belém Novo;0;0;0;0;0;0
5272;0;Mário Quintana;Belém Velho;171;0;99;24;0;171
5273;0;Mário Quintana;Boa Vista;200;0;102;12;50;150
5274;0;Mário Quintana;Boa Vista do Sul;100;0;53;13;0;100
5275;0;Mário Quintana;Bom Fim;174;49;33;20;99;75
5276;0;Mário Quintana;Bom Jesus;466;0;181;35;150;316
5277;0;Mário Quintana;Camaquã;51;50;0;1;50;1
5278;0;Mário Quintana;Campo Novo;150;0;88;19;0;150
5279;0;Mário Quintana;Cascata;150;0;34;5;100;50
5280;0;Mário Quintana;Cavalhada;105;50;42;8;50;55
5281;0;Mário Quintana;Cel. Aparício Borges;205;0;83;24;50;155
5282;0;Mário Quintana;Centro Histórico;86;0;30;9;32;54
5283;0;Mário Quintana;Chapéu do Sol;150;50;29;7;100;50
5284;0;Mário Quintana;Chácara das Pedras;112;0;65;18;0;112
5285;0;Mário Quintana;Cidade Baixa;172;49;86;20;95;77
5286;0;Mário Quintana;Costa e Silva;603;100;226;48;200;403
5287;0;Mário Quintana;Cristal;152;50;5;0;147;5
5288;0;Mário Quintana;Cristo Redentor;107;0;66;7;0;107
5289;0;Mário Quintana;Espírito Santo;100;100;0;0;100;0
5290;0;Mário Quintana;Extrema;0;0;0;0;0;0
5291;0;Mário Quintana;Farrapos;27761;11201;9893;2350;5329;15461
5292;0;Mário Quintana;Farroupilha;150;50;59;15;50;100
5293;0;Mário Quintana;Floresta;2;0;2;0;0;2
5294;0;Mário Quintana;Glória;152;0;95;22;0;152
5295;0;Mário Quintana;Guarujá;50;0;0;0;50;0
5296;0;Mário Quintana;Higienópolis;2;0;2;0;0;2
5297;0;Mário Quintana;Humaitá;64;0;0;0;64;0
5298;0;Mário Quintana;Hípica;50;0;0;0;50;0
5299;0;Mário Quintana;Independência;150;0;80;7;100;50
5300;0;Mário Quintana;Ipanema;51;0;0;1;50;1
5301;0;Mário Quintana;Jardim Botânico;52;0;1;0;50;2
5302;0;Mário Quintana;Jardim Carvalho;222;100;72;17;100;122
5303;0;Mário Quintana;Jardim Europa;200;0;55;14;100;100
5304;0;Mário Quintana;Jardim Floresta;50;0;34;9;0;50
5305;0;Mário Quintana;Jardim Isabel;0;0;0;0;0;0
5306;0;Mário Quintana;Jardim Itú;547;97;183;45;247;300
5307;0;Mário Quintana;Jardim Leopoldina;1198;197;430;121;495;703
5308;0;Mário Quintana;Jardim Lindóia;100;0;68;7;0;100
5309;0;Mário Quintana;Jardim Sabará;825;150;397;66;200;625
5310;0;Mário Quintana;Jardim São Pedro;200;0;107;12;100;100
5311;0;Mário Quintana;Jardim do Salso;150;0;34;5;100;50
5312;0;Mário Quintana;Lageado;50;50;0;0;50;0
5313;0;Mário Quintana;Lami;100;50;0;0;100;0
5314;0;Mário Quintana;Lomba do Pinheiro;411;49;164;27;197;214
5315;0;Mário Quintana;Medianeira;50;0;20;8;0;50
5316;0;Mário Quintana;Menino Deus;205;50;62;10;98;107
5317;0;Mário Quintana;Moinhos de Vento;0;0;0;0;0;0
5318;0;Mário Quintana;Mont'Serrat;332;50;151;25;82;250
5319;0;Mário Quintana;Morro Santana;1777;828;242;60;1382;395
5320;0;Mário Quintana;Mário Quintana;19440;4629;7042;1248;8204;11236
5321;0;Mário Quintana;Navegantes;50;0;29;5;0;50
5322;0;Mário Quintana;Nonoai;222;50;71;15;100;122
5323;0;Mário Quintana;Parque Santa Fé;1220;50;639;124;150;1070
5324;0;Mário Quintana;Partenon;353;50;151;44;100;253
5325;0;Mário Quintana;Passo D'Areia;55;50;4;0;50;5
5326;0;Mário Quintana;Passo das Pedras;668;250;206;30;350;318
5327;0;Mário Quintana;Pedra Redonda;100;0;58;13;0;100
5328;0;Mário Quintana;Petrópolis;105;50;29;14;50;55
5329;0;Mário Quintana;Pitinga;50;50;0;0;50;0
5330;0;Mário Quintana;Ponta Grossa;350;50;153;25;100;250
5331;0;Mário Quintana;Praia de Belas;0;0;0;0;0;0
5332;0;Mário Quintana;Restinga;294;147;97;14;147;147
5333;0;Mário Quintana;Rio Branco;101;50;34;8;50;51
5334;0;Mário Quintana;Rubem Berta;4277;677;1908;642;1022;3255
5335;0;Mário Quintana;Santa Cecília;50;0;23;6;0;50
5336;0;Mário Quintana;Santa Maria Goretti;350;100;89;19;200;150
5337;0;Mário Quintana;Santa Rosa de Lima;320;48;105;25;148;172
5338;0;Mário Quintana;Santa Tereza;155;50;71;11;98;57
5339;0;Mário Quintana;Santana;202;50;62;29;100;102
5340;0;Mário Quintana;Santo Antônio;51;0;37;6;0;51
5341;0;Mário Quintana;Sarandi;221;50;64;20;97;124
5342;0;Mário Quintana;Serraria;50;0;28;9;0;50
5343;0;Mário Quintana;São Caetano;50;0;28;8;0;50
5344;0;Mário Quintana;São Geraldo;100;50;35;13;50;50
5345;0;Mário Quintana;São José;171;100;6;5;150;21
5346;0;Mário Quintana;São João;0;0;0;0;0;0
5347;0;Mário Quintana;São Sebastião;300;100;78;18;150;150
5348;0;Mário Quintana;Sétimo Céu;0;0;0;0;0;0
5349;0;Mário Quintana;Teresópolis;50;0;0;0;50;0
5350;0;Mário Quintana;Tristeza;114;0;34;23;48;66
5351;0;Mário Quintana;Três Figueiras;398;50;161;31;198;200
5352;0;Mário Quintana;Vila Assunção;70;0;42;9;0;70
5353;0;Mário Quintana;Vila Conceição;150;50;29;5;100;50
5354;0;Mário Quintana;Vila Ipiranga;102;0;59;14;0;102
5355;0;Mário Quintana;Vila Jardim;177;50;45;6;100;77
5356;0;Mário Quintana;Vila João Pessoa;250;0;129;23;50;200
5357;0;Mário Quintana;Vila Nova;263;50;72;25;132;131
5358;0;Navegantes;Aberta dos Morros;50;0;0;0;50;0
5359;0;Navegantes;Agronomia;0;0;0;0;0;0
5360;0;Navegantes;Anchieta;100;50;0;0;100;0
5361;0;Navegantes;Arquipélago;50;0;23;17;0;50
5362;0;Navegantes;Auxiliadora;206;0;90;45;50;156
5363;0;Navegantes;Azenha;313;0;105;61;100;213
5364;0;Navegantes;Bela Vista;238;0;142;65;0;238
5365;0;Navegantes;Belém Novo;0;0;0;0;0;0
5366;0;Navegantes;Belém Velho;198;0;126;44;0;198
5367;0;Navegantes;Boa Vista;111;0;66;22;0;111
5368;0;Navegantes;Boa Vista do Sul;0;0;0;0;0;0
5369;0;Navegantes;Bom Fim;150;50;30;11;100;50
5370;0;Navegantes;Bom Jesus;323;0;178;56;0;323
5371;0;Navegantes;Camaquã;211;50;68;23;100;111
5372;0;Navegantes;Campo Novo;50;0;28;9;0;50
5373;0;Navegantes;Cascata;0;0;0;0;0;0
5374;0;Navegantes;Cavalhada;816;0;402;164;150;666
5375;0;Navegantes;Cel. Aparício Borges;393;0;236;49;0;393
5376;0;Navegantes;Centro Histórico;554;50;263;127;50;504
5377;0;Navegantes;Chapéu do Sol;0;0;0;0;0;0
5378;0;Navegantes;Chácara das Pedras;50;50;0;0;50;0
5379;0;Navegantes;Cidade Baixa;379;50;147;72;100;279
5380;0;Navegantes;Costa e Silva;309;0;217;42;50;259
5381;0;Navegantes;Cristal;598;0;338;123;0;598
5382;0;Navegantes;Cristo Redentor;474;50;232;85;100;374
5383;0;Navegantes;Espírito Santo;0;0;0;0;0;0
5384;0;Navegantes;Extrema;50;0;21;18;0;50
5385;0;Navegantes;Farrapos;2852;400;1276;355;700;2152
5386;0;Navegantes;Farroupilha;50;50;0;0;50;0
5387;0;Navegantes;Floresta;300;50;114;51;100;200
5388;0;Navegantes;Glória;158;0;62;26;50;108
5389;0;Navegantes;Guarujá;0;0;0;0;0;0
5390;0;Navegantes;Higienópolis;238;50;80;29;100;138
5391;0;Navegantes;Humaitá;1150;400;211;58;800;350
5392;0;Navegantes;Hípica;69;0;48;12;0;69
5393;0;Navegantes;Independência;250;0;79;11;200;50
5394;0;Navegantes;Ipanema;203;0;121;46;0;203
5395;0;Navegantes;Jardim Botânico;290;0;130;59;50;240
5396;0;Navegantes;Jardim Carvalho;196;50;82;31;50;146
5397;0;Navegantes;Jardim Europa;0;0;0;0;0;0
5398;0;Navegantes;Jardim Floresta;100;0;50;25;0;100
5399;0;Navegantes;Jardim Isabel;0;0;0;0;0;0
5400;0;Navegantes;Jardim Itú;51;0;34;8;0;51
5401;0;Navegantes;Jardim Leopoldina;172;0;109;32;0;172
5402;0;Navegantes;Jardim Lindóia;50;0;32;16;0;50
5403;0;Navegantes;Jardim Sabará;100;0;80;13;50;50
5404;0;Navegantes;Jardim São Pedro;50;0;31;19;0;50
5405;0;Navegantes;Jardim do Salso;100;0;25;11;50;50
5406;0;Navegantes;Lageado;0;0;0;0;0;0
5407;0;Navegantes;Lami;0;0;0;0;0;0
5408;0;Navegantes;Lomba do Pinheiro;282;0;167;29;0;282
5409;0;Navegantes;Medianeira;150;50;52;24;50;100
5410;0;Navegantes;Menino Deus;586;0;293;154;50;536
5411;0;Navegantes;Moinhos de Vento;150;0;80;52;0;150
5412;0;Navegantes;Mont'Serrat;63;0;39;10;0;63
5413;0;Navegantes;Morro Santana;379;0;257;71;50;329
5414;0;Navegantes;Mário Quintana;767;0;446;78;0;767
5415;0;Navegantes;Navegantes;3600;100;1802;834;300;3300
5416;0;Navegantes;Nonoai;225;0;136;38;0;225
5417;0;Navegantes;Parque Santa Fé;0;0;0;0;0;0
5418;0;Navegantes;Partenon;403;50;204;78;50;353
5419;0;Navegantes;Passo D'Areia;458;0;180;130;100;358
5420;0;Navegantes;Passo das Pedras;309;0;188;57;0;309
5421;0;Navegantes;Pedra Redonda;50;0;0;0;50;0
5422;0;Navegantes;Petrópolis;658;100;334;132;100;558
5423;0;Navegantes;Pitinga;0;0;0;0;0;0
5424;0;Navegantes;Ponta Grossa;0;0;0;0;0;0
5425;0;Navegantes;Praia de Belas;100;50;33;11;50;50
5426;0;Navegantes;Restinga;639;0;331;98;50;589
5427;0;Navegantes;Rio Branco;351;50;132;77;100;251
5428;0;Navegantes;Rubem Berta;209;100;47;39;100;109
5429;0;Navegantes;Santa Cecília;50;50;0;0;50;0
5430;0;Navegantes;Santa Maria Goretti;100;0;50;0;100;0
5431;0;Navegantes;Santa Rosa de Lima;262;50;92;30;100;162
5432;0;Navegantes;Santa Tereza;462;0;244;76;0;462
5433;0;Navegantes;Santana;430;100;139;78;150;280
5434;0;Navegantes;Santo Antônio;135;0;102;19;50;85
5435;0;Navegantes;Sarandi;857;50;438;221;50;807
5436;0;Navegantes;Serraria;100;0;50;17;0;100
5437;0;Navegantes;São Caetano;0;0;0;0;0;0
5438;0;Navegantes;São Geraldo;1350;150;604;244;350;1000
5439;0;Navegantes;São José;223;0;138;34;0;223
5440;0;Navegantes;São João;250;0;138;39;100;150
5441;0;Navegantes;São Sebastião;0;0;0;0;0;0
5442;0;Navegantes;Sétimo Céu;0;0;0;0;0;0
5443;0;Navegantes;Teresópolis;0;0;0;0;0;0
5444;0;Navegantes;Tristeza;275;0;167;90;0;275
5445;0;Navegantes;Três Figueiras;0;0;0;0;0;0
5446;0;Navegantes;Vila Assunção;0;0;0;0;0;0
5447;0;Navegantes;Vila Conceição;50;0;27;10;0;50
5448;0;Navegantes;Vila Ipiranga;79;0;52;14;0;79
5449;0;Navegantes;Vila Jardim;199;0;100;59;0;199
5450;0;Navegantes;Vila João Pessoa;50;0;22;13;0;50
5451;0;Navegantes;Vila Nova;782;0;426;160;50;732
5452;0;Nonoai;Aberta dos Morros;50;0;29;11;0;50
5453;0;Nonoai;Agronomia;0;0;0;0;0;0
5454;0;Nonoai;Anchieta;100;100;0;0;100;0
5455;0;Nonoai;Arquipélago;300;0;174;65;0;300
5456;0;Nonoai;Auxiliadora;204;0;92;28;50;154
5457;0;Nonoai;Azenha;250;0;55;28;150;100
5458;0;Nonoai;Bela Vista;104;0;72;20;0;104
5459;0;Nonoai;Belém Novo;100;50;33;10;50;50
5460;0;Nonoai;Belém Velho;257;0;151;44;0;257
5461;0;Nonoai;Boa Vista;50;50;0;0;50;0
5462;0;Nonoai;Boa Vista do Sul;50;0;27;5;0;50
5463;0;Nonoai;Bom Fim;200;0;49;32;100;100
5464;0;Nonoai;Bom Jesus;209;0;80;36;50;159
5465;0;Nonoai;Camaquã;1854;300;731;260;600;1254
5466;0;Nonoai;Campo Novo;200;50;88;35;50;150
5467;0;Nonoai;Cascata;400;100;130;31;200;200
5468;0;Nonoai;Cavalhada;2171;450;889;322;650;1521
5469;0;Nonoai;Cel. Aparício Borges;214;0;118;23;0;214
5470;0;Nonoai;Centro Histórico;256;50;84;41;100;156
5471;0;Nonoai;Chapéu do Sol;100;0;49;21;0;100
5472;0;Nonoai;Chácara das Pedras;150;50;60;20;50;100
5473;0;Nonoai;Cidade Baixa;104;0;1;1;100;4
5474;0;Nonoai;Costa e Silva;107;0;67;22;0;107
5475;0;Nonoai;Cristal;2327;750;455;146;1550;777
5476;0;Nonoai;Cristo Redentor;163;0;92;36;0;163
5477;0;Nonoai;Espírito Santo;100;50;24;15;50;50
5478;0;Nonoai;Extrema;0;0;0;0;0;0
5479;0;Nonoai;Farrapos;150;100;39;6;100;50
5480;0;Nonoai;Farroupilha;200;0;50;21;100;100
5481;0;Nonoai;Floresta;200;0;41;35;100;100
5482;0;Nonoai;Glória;651;200;182;74;300;351
5483;0;Nonoai;Guarujá;150;150;0;0;150;0
5484;0;Nonoai;Higienópolis;154;50;31;11;100;54
5485;0;Nonoai;Humaitá;150;100;36;7;100;50
5486;0;Nonoai;Hípica;250;50;141;28;50;200
5487;0;Nonoai;Independência;150;50;29;14;100;50
5488;0;Nonoai;Ipanema;306;0;97;39;150;156
5489;0;Nonoai;Jardim Botânico;106;0;32;17;50;56
5490;0;Nonoai;Jardim Carvalho;104;50;33;7;50;54
5491;0;Nonoai;Jardim Europa;50;0;27;11;0;50
5492;0;Nonoai;Jardim Floresta;0;0;0;0;0;0
5493;0;Nonoai;Jardim Isabel;250;100;27;11;200;50
5494;0;Nonoai;Jardim Itú;50;0;0;0;50;0
5495;0;Nonoai;Jardim Leopoldina;55;0;27;8;0;55
5496;0;Nonoai;Jardim Lindóia;100;50;27;8;50;50
5497;0;Nonoai;Jardim Sabará;100;50;30;15;50;50
5498;0;Nonoai;Jardim São Pedro;50;0;31;16;0;50
5499;0;Nonoai;Jardim do Salso;200;50;82;9;150;50
5500;0;Nonoai;Lageado;50;50;0;0;50;0
5501;0;Nonoai;Lami;50;50;0;0;50;0
5502;0;Nonoai;Lomba do Pinheiro;254;0;110;36;50;204
5503;0;Nonoai;Medianeira;900;50;391;132;300;600
5504;0;Nonoai;Menino Deus;564;0;245;82;150;414
5505;0;Nonoai;Moinhos de Vento;50;0;0;0;50;0
5506;0;Nonoai;Mont'Serrat;101;0;73;22;0;101
5507;0;Nonoai;Morro Santana;13;0;7;3;0;13
5508;0;Nonoai;Mário Quintana;279;50;100;23;100;179
5509;0;Nonoai;Navegantes;100;0;62;19;0;100
5510;0;Nonoai;Nonoai;11504;4600;1880;583;8800;2704
5511;0;Nonoai;Parque Santa Fé;250;0;79;27;100;150
5512;0;Nonoai;Partenon;1460;100;757;262;200;1260
5513;0;Nonoai;Passo D'Areia;311;0;63;58;150;161
5514;0;Nonoai;Passo das Pedras;109;50;31;11;50;59
5515;0;Nonoai;Pedra Redonda;200;0;74;18;100;100
5516;0;Nonoai;Petrópolis;514;50;256;100;100;414
5517;0;Nonoai;Pitinga;0;0;0;0;0;0
5518;0;Nonoai;Ponta Grossa;100;0;60;19;0;100
5519;0;Nonoai;Praia de Belas;200;50;88;24;50;150
5520;0;Nonoai;Restinga;275;50;123;42;50;225
5521;0;Nonoai;Rio Branco;156;50;54;35;50;106
5522;0;Nonoai;Rubem Berta;204;0;51;28;100;104
5523;0;Nonoai;Santa Cecília;150;0;91;32;0;150
5524;0;Nonoai;Santa Maria Goretti;0;0;0;0;0;0
5525;0;Nonoai;Santa Rosa de Lima;50;0;29;11;0;50
5526;0;Nonoai;Santa Tereza;6117;500;3205;1054;600;5517
5527;0;Nonoai;Santana;307;100;109;24;200;107
5528;0;Nonoai;Santo Antônio;554;100;284;89;150;404
5529;0;Nonoai;Sarandi;626;50;229;132;200;426
5530;0;Nonoai;Serraria;50;50;0;0;50;0
5531;0;Nonoai;São Caetano;200;0;111;51;0;200
5532;0;Nonoai;São Geraldo;0;0;0;0;0;0
5533;0;Nonoai;São José;306;100;96;30;150;156
5534;0;Nonoai;São João;100;0;62;11;0;100
5535;0;Nonoai;São Sebastião;50;0;26;13;0;50
5536;0;Nonoai;Sétimo Céu;586;100;212;63;236;350
5537;0;Nonoai;Teresópolis;7950;800;3908;1457;1400;6550
5538;0;Nonoai;Tristeza;760;300;192;80;450;310
5539;0;Nonoai;Três Figueiras;0;0;0;0;0;0
5540;0;Nonoai;Vila Assunção;300;0;174;35;100;200
5541;0;Nonoai;Vila Conceição;150;50;55;21;50;100
5542;0;Nonoai;Vila Ipiranga;454;150;128;42;250;204
5543;0;Nonoai;Vila Jardim;156;0;57;26;50;106
5544;0;Nonoai;Vila João Pessoa;200;0;82;25;50;150
5545;0;Nonoai;Vila Nova;1477;150;773;231;200;1277
5546;0;Parque Santa Fé;Aberta dos Morros;0;0;0;0;0;0
5547;0;Parque Santa Fé;Agronomia;0;0;0;0;0;0
5548;0;Parque Santa Fé;Anchieta;0;0;0;0;0;0
5549;0;Parque Santa Fé;Arquipélago;100;0;55;16;0;100
5550;0;Parque Santa Fé;Auxiliadora;0;0;0;0;0;0
5551;0;Parque Santa Fé;Azenha;0;0;0;0;0;0
5552;0;Parque Santa Fé;Bela Vista;53;0;29;13;0;53
5553;0;Parque Santa Fé;Belém Novo;100;0;49;32;0;100
5554;0;Parque Santa Fé;Belém Velho;55;0;31;15;0;55
5555;0;Parque Santa Fé;Boa Vista;150;100;0;0;150;0
5556;0;Parque Santa Fé;Boa Vista do Sul;0;0;0;0;0;0
5557;0;Parque Santa Fé;Bom Fim;50;0;31;10;0;50
5558;0;Parque Santa Fé;Bom Jesus;156;0;95;25;0;156
5559;0;Parque Santa Fé;Camaquã;53;0;27;15;0;53
5560;0;Parque Santa Fé;Campo Novo;100;0;32;8;50;50
5561;0;Parque Santa Fé;Cascata;150;50;27;11;100;50
5562;0;Parque Santa Fé;Cavalhada;408;100;94;34;250;158
5563;0;Parque Santa Fé;Cel. Aparício Borges;108;50;30;12;50;58
5564;0;Parque Santa Fé;Centro Histórico;204;100;28;11;150;54
5565;0;Parque Santa Fé;Chapéu do Sol;100;50;37;5;50;50
5566;0;Parque Santa Fé;Chácara das Pedras;100;0;67;18;0;100
5567;0;Parque Santa Fé;Cidade Baixa;202;0;27;10;150;52
5568;0;Parque Santa Fé;Costa e Silva;3123;1100;780;174;1967;1156
5569;0;Parque Santa Fé;Cristal;158;0;57;22;50;108
5570;0;Parque Santa Fé;Cristo Redentor;107;0;59;29;0;107
5571;0;Parque Santa Fé;Espírito Santo;0;0;0;0;0;0
5572;0;Parque Santa Fé;Extrema;0;0;0;0;0;0
5573;0;Parque Santa Fé;Farrapos;0;0;0;0;0;0
5574;0;Parque Santa Fé;Farroupilha;50;0;41;5;0;50
5575;0;Parque Santa Fé;Floresta;0;0;0;0;0;0
5576;0;Parque Santa Fé;Glória;0;0;0;0;0;0
5577;0;Parque Santa Fé;Guarujá;50;0;37;9;0;50
5578;0;Parque Santa Fé;Higienópolis;0;0;0;0;0;0
5579;0;Parque Santa Fé;Humaitá;0;0;0;0;0;0
5580;0;Parque Santa Fé;Hípica;0;0;0;0;0;0
5581;0;Parque Santa Fé;Independência;0;0;0;0;0;0
5582;0;Parque Santa Fé;Ipanema;5;0;3;2;0;5
5583;0;Parque Santa Fé;Jardim Botânico;6;0;2;1;0;6
5584;0;Parque Santa Fé;Jardim Carvalho;100;0;0;0;100;0
5585;0;Parque Santa Fé;Jardim Europa;0;0;0;0;0;0
5586;0;Parque Santa Fé;Jardim Floresta;0;0;0;0;0;0
5587;0;Parque Santa Fé;Jardim Isabel;0;0;0;0;0;0
5588;0;Parque Santa Fé;Jardim Itú;352;100;63;23;251;101
5589;0;Parque Santa Fé;Jardim Leopoldina;1904;650;509;142;1100;804
5590;0;Parque Santa Fé;Jardim Lindóia;100;0;28;15;50;50
5591;0;Parque Santa Fé;Jardim Sabará;200;0;91;35;50;150
5592;0;Parque Santa Fé;Jardim São Pedro;150;0;50;32;50;100
5593;0;Parque Santa Fé;Jardim do Salso;0;0;0;0;0;0
5594;0;Parque Santa Fé;Lageado;0;0;0;0;0;0
5595;0;Parque Santa Fé;Lami;50;0;0;0;50;0
5596;0;Parque Santa Fé;Lomba do Pinheiro;53;0;30;8;0;53
5597;0;Parque Santa Fé;Medianeira;50;0;29;16;0;50
5598;0;Parque Santa Fé;Menino Deus;207;50;70;29;100;107
5599;0;Parque Santa Fé;Moinhos de Vento;0;0;0;0;0;0
5600;0;Parque Santa Fé;Mont'Serrat;0;0;0;0;0;0
5601;0;Parque Santa Fé;Morro Santana;558;0;317;102;0;558
5602;0;Parque Santa Fé;Mário Quintana;1258;50;658;134;150;1108
5603;0;Parque Santa Fé;Navegantes;0;0;0;0;0;0
5604;0;Parque Santa Fé;Nonoai;252;0;81;27;100;152
5605;0;Parque Santa Fé;Parque Santa Fé;1300;300;496;148;500;800
5606;0;Parque Santa Fé;Partenon;257;0;146;47;0;257
5607;0;Parque Santa Fé;Passo D'Areia;208;0;80;73;0;208
5608;0;Parque Santa Fé;Passo das Pedras;1057;50;490;158;250;807
5609;0;Parque Santa Fé;Pedra Redonda;0;0;0;0;0;0
5610;0;Parque Santa Fé;Petrópolis;107;0;67;30;0;107
5611;0;Parque Santa Fé;Pitinga;0;0;0;0;0;0
5612;0;Parque Santa Fé;Ponta Grossa;0;0;0;0;0;0
5613;0;Parque Santa Fé;Praia de Belas;0;0;0;0;0;0
5614;0;Parque Santa Fé;Restinga;107;0;50;21;0;107
5615;0;Parque Santa Fé;Rio Branco;5;0;3;2;0;5
5616;0;Parque Santa Fé;Rubem Berta;2151;550;843;516;650;1501
5617;0;Parque Santa Fé;Santa Cecília;50;0;34;6;0;50
5618;0;Parque Santa Fé;Santa Maria Goretti;50;50;0;0;50;0
5619;0;Parque Santa Fé;Santa Rosa de Lima;7701;200;4251;1185;500;7201
5620;0;Parque Santa Fé;Santa Tereza;107;0;58;20;0;107
5621;0;Parque Santa Fé;Santana;155;0;51;29;50;105
5622;0;Parque Santa Fé;Santo Antônio;51;0;34;9;0;51
5623;0;Parque Santa Fé;Sarandi;1308;200;549;272;300;1008
5624;0;Parque Santa Fé;Serraria;0;0;0;0;0;0
5625;0;Parque Santa Fé;São Caetano;0;0;0;0;0;0
5626;0;Parque Santa Fé;São Geraldo;100;0;63;28;0;100
5627;0;Parque Santa Fé;São José;106;0;84;9;50;56
5628;0;Parque Santa Fé;São João;50;0;27;16;0;50
5629;0;Parque Santa Fé;São Sebastião;250;50;94;24;100;150
5630;0;Parque Santa Fé;Sétimo Céu;50;0;29;9;0;50
5631;0;Parque Santa Fé;Teresópolis;100;0;30;16;50;50
5632;0;Parque Santa Fé;Tristeza;5;0;3;1;0;5
5633;0;Parque Santa Fé;Três Figueiras;0;0;0;0;0;0
5634;0;Parque Santa Fé;Vila Assunção;0;0;0;0;0;0
5635;0;Parque Santa Fé;Vila Conceição;50;0;27;16;0;50
5636;0;Parque Santa Fé;Vila Ipiranga;0;0;0;0;0;0
5637;0;Parque Santa Fé;Vila Jardim;54;50;2;2;50;4
5638;0;Parque Santa Fé;Vila João Pessoa;100;0;61;24;0;100
5639;0;Parque Santa Fé;Vila Nova;158;50;33;11;100;58
5640;0;Partenon;Aberta dos Morros;150;0;90;27;0;150
5641;0;Partenon;Agronomia;197;47;84;10;147;50
5642;0;Partenon;Anchieta;250;0;128;47;0;250
5643;0;Partenon;Arquipélago;350;50;121;39;150;200
5644;0;Partenon;Auxiliadora;251;50;88;50;100;151
5645;0;Partenon;Azenha;1650;300;511;210;750;900
5646;0;Partenon;Bela Vista;351;50;145;61;100;251
5647;0;Partenon;Belém Novo;200;0;98;29;50;150
5648;0;Partenon;Belém Velho;254;0;118;44;50;204
5649;0;Partenon;Boa Vista;102;50;36;9;50;52
5650;0;Partenon;Boa Vista do Sul;50;0;30;13;0;50
5651;0;Partenon;Bom Fim;547;147;176;65;247;300
5652;0;Partenon;Bom Jesus;925;436;131;22;770;155
5653;0;Partenon;Camaquã;51;0;32;12;0;51
5654;0;Partenon;Campo Novo;100;0;69;16;0;100
5655;0;Partenon;Cascata;600;0;352;100;0;600
5656;0;Partenon;Cavalhada;214;0;110;50;0;214
5657;0;Partenon;Cel. Aparício Borges;1507;99;773;256;149;1358
5658;0;Partenon;Centro Histórico;448;0;183;89;97;351
5659;0;Partenon;Chapéu do Sol;150;100;28;8;100;50
5660;0;Partenon;Chácara das Pedras;297;50;67;17;197;100
5661;0;Partenon;Cidade Baixa;701;100;273;110;200;501
5662;0;Partenon;Costa e Silva;105;0;64;20;0;105
5663;0;Partenon;Cristal;263;0;166;41;50;213
5664;0;Partenon;Cristo Redentor;108;0;63;28;0;108
5665;0;Partenon;Espírito Santo;200;0;132;35;50;150
5666;0;Partenon;Extrema;200;100;29;13;150;50
5667;0;Partenon;Farrapos;801;137;222;62;501;300
5668;0;Partenon;Farroupilha;350;0;160;77;50;300
5669;0;Partenon;Floresta;200;0;90;36;50;150
5670;0;Partenon;Glória;14301;4700;2667;977;9950;4351
5671;0;Partenon;Guarujá;197;47;86;33;47;150
5672;0;Partenon;Higienópolis;151;50;18;14;100;51
5673;0;Partenon;Humaitá;100;50;43;6;50;50
5674;0;Partenon;Hípica;50;0;0;0;50;0
5675;0;Partenon;Independência;200;0;97;56;0;200
5676;0;Partenon;Ipanema;104;0;53;21;0;104
5677;0;Partenon;Jardim Botânico;854;0;496;165;50;804
5678;0;Partenon;Jardim Carvalho;2641;1479;322;86;2240;401
5679;0;Partenon;Jardim Europa;197;47;0;0;197;0
5680;0;Partenon;Jardim Floresta;300;0;161;51;50;250
5681;0;Partenon;Jardim Isabel;200;50;62;19;100;100
5682;0;Partenon;Jardim Itú;200;0;93;27;50;150
5683;0;Partenon;Jardim Leopoldina;251;50;112;20;150;101
5684;0;Partenon;Jardim Lindóia;350;100;141;59;100;250
5685;0;Partenon;Jardim Sabará;250;100;91;31;100;150
5686;0;Partenon;Jardim São Pedro;97;0;27;7;47;50
5687;0;Partenon;Jardim do Salso;894;146;257;64;594;300
5688;0;Partenon;Lageado;300;100;79;31;150;150
5689;0;Partenon;Lami;200;50;77;36;50;150
5690;0;Partenon;Lomba do Pinheiro;550;100;223;51;199;351
5691;0;Partenon;Medianeira;4300;550;1914;776;950;3350
5692;0;Partenon;Menino Deus;458;0;228;100;50;408
5693;0;Partenon;Moinhos de Vento;300;0;141;53;50;250
5694;0;Partenon;Mont'Serrat;302;0;142;58;50;252
5695;0;Partenon;Morro Santana;405;147;117;49;197;208
5696;0;Partenon;Mário Quintana;377;49;165;46;97;280
5697;0;Partenon;Navegantes;100;50;29;10;50;50
5698;0;Partenon;Nonoai;1448;97;751;262;197;1251
5699;0;Partenon;Parque Santa Fé;250;0;140;46;0;250
5700;0;Partenon;Partenon;6603;97;3652;1349;197;6406
5701;0;Partenon;Passo D'Areia;349;95;156;20;241;108
5702;0;Partenon;Passo das Pedras;528;142;187;63;270;258
5703;0;Partenon;Pedra Redonda;200;0;106;46;0;200
5704;0;Partenon;Petrópolis;855;50;410;154;147;708
5705;0;Partenon;Pitinga;100;0;28;7;50;50
5706;0;Partenon;Ponta Grossa;0;0;0;0;0;0
5707;0;Partenon;Praia de Belas;200;0;109;50;0;200
5708;0;Partenon;Restinga;644;100;251;63;230;414
5709;0;Partenon;Rio Branco;454;50;197;54;150;304
5710;0;Partenon;Rubem Berta;551;100;93;31;400;151
5711;0;Partenon;Santa Cecília;900;0;474;206;50;850
5712;0;Partenon;Santa Maria Goretti;50;0;0;0;50;0
5713;0;Partenon;Santa Rosa de Lima;661;100;287;103;160;501
5714;0;Partenon;Santa Tereza;508;50;213;61;150;358
5715;0;Partenon;Santana;1949;300;712;288;694;1255
5716;0;Partenon;Santo Antônio;4401;300;2220;903;450;3951
5717;0;Partenon;Sarandi;432;50;164;76;150;282
5718;0;Partenon;Serraria;350;50;97;39;150;200
5719;0;Partenon;São Caetano;500;50;134;64;250;250
5720;0;Partenon;São Geraldo;100;50;34;7;50;50
5721;0;Partenon;São José;1051;97;591;176;97;954
5722;0;Partenon;São João;500;50;191;91;150;350
5723;0;Partenon;São Sebastião;250;50;113;48;50;200
5724;0;Partenon;Sétimo Céu;50;0;19;11;0;50
5725;0;Partenon;Teresópolis;800;200;187;90;450;350
5726;0;Partenon;Tristeza;156;50;64;29;50;106
5727;0;Partenon;Três Figueiras;100;0;25;13;50;50
5728;0;Partenon;Vila Assunção;150;50;31;14;100;50
5729;0;Partenon;Vila Conceição;150;0;92;29;0;150
5730;0;Partenon;Vila Ipiranga;151;50;57;13;50;101
5731;0;Partenon;Vila Jardim;198;47;30;8;147;51
5732;0;Partenon;Vila João Pessoa;2294;194;957;344;694;1600
5733;0;Partenon;Vila Nova;266;0;96;38;100;166
5734;0;Passo D'Areia;Aberta dos Morros;50;50;0;0;50;0
5735;0;Passo D'Areia;Agronomia;150;50;38;35;50;100
5736;0;Passo D'Areia;Anchieta;400;50;119;107;100;300
5737;0;Passo D'Areia;Arquipélago;100;0;19;17;50;50
5738;0;Passo D'Areia;Auxiliadora;463;50;102;103;200;263
5739;0;Passo D'Areia;Azenha;226;100;29;34;150;76
5740;0;Passo D'Areia;Bela Vista;753;200;201;161;350;403
5741;0;Passo D'Areia;Belém Novo;200;100;27;36;100;100
5742;0;Passo D'Areia;Belém Velho;84;0;43;23;0;84
5743;0;Passo D'Areia;Boa Vista;2001;250;715;523;400;1601
5744;0;Passo D'Areia;Boa Vista do Sul;150;0;52;59;0;150
5745;0;Passo D'Areia;Bom Fim;225;150;25;32;150;75
5746;0;Passo D'Areia;Bom Jesus;265;50;24;15;200;65
5747;0;Passo D'Areia;Camaquã;6;0;3;2;0;6
5748;0;Passo D'Areia;Campo Novo;100;50;0;0;100;0
5749;0;Passo D'Areia;Cascata;100;0;20;17;50;50
5750;0;Passo D'Areia;Cavalhada;71;0;32;19;0;71
5751;0;Passo D'Areia;Cel. Aparício Borges;188;50;40;25;100;88
5752;0;Passo D'Areia;Centro Histórico;313;0;93;39;150;163
5753;0;Passo D'Areia;Chapéu do Sol;50;0;18;19;0;50
5754;0;Passo D'Areia;Chácara das Pedras;300;150;15;17;250;50
5755;0;Passo D'Areia;Cidade Baixa;53;0;21;13;0;53
5756;0;Passo D'Areia;Costa e Silva;138;50;58;12;50;88
5757;0;Passo D'Areia;Cristal;247;100;47;27;150;97
5758;0;Passo D'Areia;Cristo Redentor;657;100;137;62;400;257
5759;0;Passo D'Areia;Espírito Santo;100;0;25;18;50;50
5760;0;Passo D'Areia;Extrema;50;0;20;25;0;50
5761;0;Passo D'Areia;Farrapos;7531;0;3840;2119;50;7481
5762;0;Passo D'Areia;Farroupilha;119;50;29;27;50;69
5763;0;Passo D'Areia;Floresta;350;50;133;98;100;250
5764;0;Passo D'Areia;Glória;131;100;17;6;100;31
5765;0;Passo D'Areia;Guarujá;100;50;15;17;50;50
5766;0;Passo D'Areia;Higienópolis;4269;550;1211;1164;1100;3169
5767;0;Passo D'Areia;Humaitá;313;100;97;65;100;213
5768;0;Passo D'Areia;Hípica;50;0;19;19;0;50
5769;0;Passo D'Areia;Independência;54;50;3;1;50;4
5770;0;Passo D'Areia;Ipanema;114;0;22;25;50;64
5771;0;Passo D'Areia;Jardim Botânico;331;50;87;17;250;81
5772;0;Passo D'Areia;Jardim Carvalho;8;0;6;1;0;8
5773;0;Passo D'Areia;Jardim Europa;671;150;142;107;350;321
5774;0;Passo D'Areia;Jardim Floresta;600;200;97;58;450;150
5775;0;Passo D'Areia;Jardim Isabel;0;0;0;0;0;0
5776;0;Passo D'Areia;Jardim Itú;335;100;153;39;100;235
5777;0;Passo D'Areia;Jardim Leopoldina;27;0;17;4;0;27
5778;0;Passo D'Areia;Jardim Lindóia;500;0;152;116;150;350
5779;0;Passo D'Areia;Jardim Sabará;50;0;0;0;50;0
5780;0;Passo D'Areia;Jardim São Pedro;1588;450;370;396;550;1038
5781;0;Passo D'Areia;Jardim do Salso;200;50;56;69;50;150
5782;0;Passo D'Areia;Lageado;0;0;0;0;0;0
5783;0;Passo D'Areia;Lami;250;0;51;57;100;150
5784;0;Passo D'Areia;Lomba do Pinheiro;138;50;76;4;100;38
5785;0;Passo D'Areia;Medianeira;169;100;25;26;100;69
5786;0;Passo D'Areia;Menino Deus;213;50;64;56;50;163
5787;0;Passo D'Areia;Moinhos de Vento;213;50;64;59;50;163
5788;0;Passo D'Areia;Mont'Serrat;400;0;101;92;150;250
5789;0;Passo D'Areia;Morro Santana;64;0;30;23;0;64
5790;0;Passo D'Areia;Mário Quintana;70;50;11;4;50;20
5791;0;Passo D'Areia;Navegantes;100;0;50;0;100;0
5792;0;Passo D'Areia;Nonoai;308;0;65;53;150;158
5793;0;Passo D'Areia;Parque Santa Fé;200;0;77;70;0;200
5794;0;Passo D'Areia;Partenon;316;100;141;13;250;66
5795;0;Passo D'Areia;Passo D'Areia;6335;800;1845;1790;1600;4735
5796;0;Passo D'Areia;Passo das Pedras;160;50;60;25;50;110
5797;0;Passo D'Areia;Pedra Redonda;100;0;30;41;0;100
5798;0;Passo D'Areia;Petrópolis;291;50;61;24;200;91
5799;0;Passo D'Areia;Pitinga;50;0;12;19;0;50
5800;0;Passo D'Areia;Ponta Grossa;100;0;33;39;0;100
5801;0;Passo D'Areia;Praia de Belas;100;0;34;40;0;100
5802;0;Passo D'Areia;Restinga;139;0;45;26;50;89
5803;0;Passo D'Areia;Rio Branco;365;50;92;95;100;265
5804;0;Passo D'Areia;Rubem Berta;186;50;71;49;50;136
5805;0;Passo D'Areia;Santa Cecília;150;0;0;0;150;0
5806;0;Passo D'Areia;Santa Maria Goretti;1862;450;397;326;950;912
5807;0;Passo D'Areia;Santa Rosa de Lima;146;0;99;18;0;146
5808;0;Passo D'Areia;Santa Tereza;166;100;6;3;150;16
5809;0;Passo D'Areia;Santana;90;0;20;14;50;40
5810;0;Passo D'Areia;Santo Antônio;58;0;5;2;50;8
5811;0;Passo D'Areia;Sarandi;361;0;111;86;100;261
5812;0;Passo D'Areia;Serraria;50;0;13;22;0;50
5813;0;Passo D'Areia;São Caetano;0;0;0;0;0;0
5814;0;Passo D'Areia;São Geraldo;162;0;39;37;50;112
5815;0;Passo D'Areia;São José;114;0;59;22;0;114
5816;0;Passo D'Areia;São João;419;150;82;48;250;169
5817;0;Passo D'Areia;São Sebastião;250;50;58;56;100;150
5818;0;Passo D'Areia;Sétimo Céu;0;0;0;0;0;0
5819;0;Passo D'Areia;Teresópolis;0;0;0;0;0;0
5820;0;Passo D'Areia;Tristeza;16;0;8;7;0;16
5821;0;Passo D'Areia;Três Figueiras;313;100;70;54;150;163
5822;0;Passo D'Areia;Vila Assunção;0;0;0;0;0;0
5823;0;Passo D'Areia;Vila Conceição;200;50;45;35;100;100
5824;0;Passo D'Areia;Vila Ipiranga;567;400;48;48;450;117
5825;0;Passo D'Areia;Vila Jardim;365;0;151;134;0;365
5826;0;Passo D'Areia;Vila João Pessoa;191;50;61;47;50;141
5827;0;Passo D'Areia;Vila Nova;120;100;11;4;100;20
5828;0;Passo das Pedras;Aberta dos Morros;0;0;0;0;0;0
5829;0;Passo das Pedras;Agronomia;200;0;109;36;0;200
5830;0;Passo das Pedras;Anchieta;150;50;59;14;50;100
5831;0;Passo das Pedras;Arquipélago;0;0;0;0;0;0
5832;0;Passo das Pedras;Auxiliadora;77;0;47;15;0;77
5833;0;Passo das Pedras;Azenha;325;50;85;16;200;125
5834;0;Passo das Pedras;Bela Vista;103;0;59;16;0;103
5835;0;Passo das Pedras;Belém Novo;125;0;39;19;50;75
5836;0;Passo das Pedras;Belém Velho;56;50;3;2;50;6
5837;0;Passo das Pedras;Boa Vista;100;50;30;8;50;50
5838;0;Passo das Pedras;Boa Vista do Sul;0;0;0;0;0;0
5839;0;Passo das Pedras;Bom Fim;100;50;34;2;50;50
5840;0;Passo das Pedras;Bom Jesus;220;50;75;28;100;120
5841;0;Passo das Pedras;Camaquã;88;50;27;2;50;38
5842;0;Passo das Pedras;Campo Novo;50;50;0;0;50;0
5843;0;Passo das Pedras;Cascata;50;0;24;11;0;50
5844;0;Passo das Pedras;Cavalhada;114;0;37;8;50;64
5845;0;Passo das Pedras;Cel. Aparício Borges;7;0;5;0;0;7
5846;0;Passo das Pedras;Centro Histórico;170;100;12;7;150;20
5847;0;Passo das Pedras;Chapéu do Sol;0;0;0;0;0;0
5848;0;Passo das Pedras;Chácara das Pedras;50;0;25;14;0;50
5849;0;Passo das Pedras;Cidade Baixa;103;0;52;25;0;103
5850;0;Passo das Pedras;Costa e Silva;1844;250;768;237;500;1344
5851;0;Passo das Pedras;Cristal;264;50;97;35;100;164
5852;0;Passo das Pedras;Cristo Redentor;59;0;37;14;0;59
5853;0;Passo das Pedras;Espírito Santo;0;0;0;0;0;0
5854;0;Passo das Pedras;Extrema;0;0;0;0;0;0
5855;0;Passo das Pedras;Farrapos;16707;4861;7063;2399;2362;10574
5856;0;Passo das Pedras;Farroupilha;50;0;30;7;0;50
5857;0;Passo das Pedras;Floresta;63;0;37;16;0;63
5858;0;Passo das Pedras;Glória;50;50;0;0;50;0
5859;0;Passo das Pedras;Guarujá;0;0;0;0;0;0
5860;0;Passo das Pedras;Higienópolis;152;50;29;9;100;52
5861;0;Passo das Pedras;Humaitá;0;0;0;0;0;0
5862;0;Passo das Pedras;Hípica;81;50;23;5;50;31
5863;0;Passo das Pedras;Independência;50;50;0;0;50;0
5864;0;Passo das Pedras;Ipanema;6;0;5;1;0;6
5865;0;Passo das Pedras;Jardim Botânico;200;50;58;17;100;100
5866;0;Passo das Pedras;Jardim Carvalho;229;50;67;6;200;29
5867;0;Passo das Pedras;Jardim Europa;50;0;31;11;0;50
5868;0;Passo das Pedras;Jardim Floresta;0;0;0;0;0;0
5869;0;Passo das Pedras;Jardim Isabel;50;0;0;0;50;0
5870;0;Passo das Pedras;Jardim Itú;2482;350;890;300;964;1518
5871;0;Passo das Pedras;Jardim Leopoldina;1388;450;460;153;550;838
5872;0;Passo das Pedras;Jardim Lindóia;250;150;0;0;250;0
5873;0;Passo das Pedras;Jardim Sabará;269;100;68;27;150;119
5874;0;Passo das Pedras;Jardim São Pedro;175;0;99;33;0;175
5875;0;Passo das Pedras;Jardim do Salso;50;50;0;0;50;0
5876;0;Passo das Pedras;Lageado;0;0;0;0;0;0
5877;0;Passo das Pedras;Lami;0;0;0;0;0;0
5878;0;Passo das Pedras;Lomba do Pinheiro;307;50;148;29;50;257
5879;0;Passo das Pedras;Medianeira;100;0;36;9;50;50
5880;0;Passo das Pedras;Menino Deus;109;0;36;10;50;59
5881;0;Passo das Pedras;Moinhos de Vento;20;0;11;8;0;20
5882;0;Passo das Pedras;Mont'Serrat;190;0;125;11;150;40
5883;0;Passo das Pedras;Morro Santana;1423;150;651;193;300;1123
5884;0;Passo das Pedras;Mário Quintana;652;250;170;43;350;302
5885;0;Passo das Pedras;Navegantes;0;0;0;0;0;0
5886;0;Passo das Pedras;Nonoai;103;50;28;8;50;53
5887;0;Passo das Pedras;Parque Santa Fé;682;50;264;81;250;432
5888;0;Passo das Pedras;Partenon;387;150;96;19;300;87
5889;0;Passo das Pedras;Passo D'Areia;183;50;72;33;50;133
5890;0;Passo das Pedras;Passo das Pedras;6587;600;3294;996;900;5687
5891;0;Passo das Pedras;Pedra Redonda;0;0;0;0;0;0
5892;0;Passo das Pedras;Petrópolis;114;50;41;18;50;64
5893;0;Passo das Pedras;Pitinga;50;0;30;9;0;50
5894;0;Passo das Pedras;Ponta Grossa;150;0;32;7;100;50
5895;0;Passo das Pedras;Praia de Belas;50;0;0;0;50;0
5896;0;Passo das Pedras;Restinga;116;0;67;20;0;116
5897;0;Passo das Pedras;Rio Branco;31;0;18;4;0;31
5898;0;Passo das Pedras;Rubem Berta;1324;400;301;225;700;624
5899;0;Passo das Pedras;Santa Cecília;0;0;0;0;0;0
5900;0;Passo das Pedras;Santa Maria Goretti;100;0;69;14;0;100
5901;0;Passo das Pedras;Santa Rosa de Lima;1216;250;473;115;500;716
5902;0;Passo das Pedras;Santa Tereza;21;0;12;3;0;21
5903;0;Passo das Pedras;Santana;106;50;33;9;50;56
5904;0;Passo das Pedras;Santo Antônio;1;0;1;0;0;1
5905;0;Passo das Pedras;Sarandi;499;100;84;36;350;149
5906;0;Passo das Pedras;Serraria;25;0;16;5;0;25
5907;0;Passo das Pedras;São Caetano;0;0;0;0;0;0
5908;0;Passo das Pedras;São Geraldo;0;0;0;0;0;0
5909;0;Passo das Pedras;São José;109;0;6;2;100;9
5910;0;Passo das Pedras;São João;50;0;21;10;0;50
5911;0;Passo das Pedras;São Sebastião;638;150;185;66;300;338
5912;0;Passo das Pedras;Sétimo Céu;0;0;0;0;0;0
5913;0;Passo das Pedras;Teresópolis;0;0;0;0;0;0
5914;0;Passo das Pedras;Tristeza;8;0;4;1;0;8
5915;0;Passo das Pedras;Três Figueiras;52;0;30;4;0;52
5916;0;Passo das Pedras;Vila Assunção;0;0;0;0;0;0
5917;0;Passo das Pedras;Vila Conceição;50;0;29;15;0;50
5918;0;Passo das Pedras;Vila Ipiranga;414;300;25;17;350;64
5919;0;Passo das Pedras;Vila Jardim;369;200;111;33;250;119
5920;0;Passo das Pedras;Vila João Pessoa;25;0;13;3;0;25
5921;0;Passo das Pedras;Vila Nova;124;50;62;3;100;24
5922;0;Pedra Redonda;Aberta dos Morros;0;0;0;0;0;0
5923;0;Pedra Redonda;Agronomia;0;0;0;0;0;0
5924;0;Pedra Redonda;Anchieta;0;0;0;0;0;0
5925;0;Pedra Redonda;Arquipélago;50;0;0;0;50;0
5926;0;Pedra Redonda;Auxiliadora;55;0;24;19;0;55
5927;0;Pedra Redonda;Azenha;100;0;52;18;0;100
5928;0;Pedra Redonda;Bela Vista;53;50;2;0;50;3
5929;0;Pedra Redonda;Belém Novo;150;0;57;20;50;100
5930;0;Pedra Redonda;Belém Velho;55;0;26;10;0;55
5931;0;Pedra Redonda;Boa Vista;53;0;31;12;0;53
5932;0;Pedra Redonda;Boa Vista do Sul;0;0;0;0;0;0
5933;0;Pedra Redonda;Bom Fim;0;0;0;0;0;0
5934;0;Pedra Redonda;Bom Jesus;61;0;34;11;0;61
5935;0;Pedra Redonda;Camaquã;553;150;180;64;250;303
5936;0;Pedra Redonda;Campo Novo;50;0;0;0;50;0
5937;0;Pedra Redonda;Cascata;50;0;28;5;0;50
5938;0;Pedra Redonda;Cavalhada;2318;450;690;251;1150;1168
5939;0;Pedra Redonda;Cel. Aparício Borges;19;0;11;3;0;19
5940;0;Pedra Redonda;Centro Histórico;107;50;2;3;100;7
5941;0;Pedra Redonda;Chapéu do Sol;0;0;0;0;0;0
5942;0;Pedra Redonda;Chácara das Pedras;0;0;0;0;0;0
5943;0;Pedra Redonda;Cidade Baixa;5;0;3;1;0;5
5944;0;Pedra Redonda;Costa e Silva;59;0;34;10;0;59
5945;0;Pedra Redonda;Cristal;384;100;165;54;100;284
5946;0;Pedra Redonda;Cristo Redentor;15;0;10;1;0;15
5947;0;Pedra Redonda;Espírito Santo;250;0;122;45;50;200
5948;0;Pedra Redonda;Extrema;0;0;0;0;0;0
5949;0;Pedra Redonda;Farrapos;0;0;0;0;0;0
5950;0;Pedra Redonda;Farroupilha;0;0;0;0;0;0
5951;0;Pedra Redonda;Floresta;0;0;0;0;0;0
5952;0;Pedra Redonda;Glória;50;0;0;0;50;0
5953;0;Pedra Redonda;Guarujá;0;0;0;0;0;0
5954;0;Pedra Redonda;Higienópolis;53;0;35;15;0;53
5955;0;Pedra Redonda;Humaitá;100;0;34;5;50;50
5956;0;Pedra Redonda;Hípica;102;0;29;10;50;52
5957;0;Pedra Redonda;Independência;0;0;0;0;0;0
5958;0;Pedra Redonda;Ipanema;555;200;172;71;250;305
5959;0;Pedra Redonda;Jardim Botânico;7;0;4;1;0;7
5960;0;Pedra Redonda;Jardim Carvalho;0;0;0;0;0;0
5961;0;Pedra Redonda;Jardim Europa;0;0;0;0;0;0
5962;0;Pedra Redonda;Jardim Floresta;0;0;0;0;0;0
5963;0;Pedra Redonda;Jardim Isabel;350;50;204;62;50;300
5964;0;Pedra Redonda;Jardim Itú;0;0;0;0;0;0
5965;0;Pedra Redonda;Jardim Leopoldina;53;0;32;11;0;53
5966;0;Pedra Redonda;Jardim Lindóia;50;0;29;12;0;50
5967;0;Pedra Redonda;Jardim Sabará;0;0;0;0;0;0
5968;0;Pedra Redonda;Jardim São Pedro;0;0;0;0;0;0
5969;0;Pedra Redonda;Jardim do Salso;50;50;0;0;50;0
5970;0;Pedra Redonda;Lageado;0;0;0;0;0;0
5971;0;Pedra Redonda;Lami;0;0;0;0;0;0
5972;0;Pedra Redonda;Lomba do Pinheiro;303;50;87;19;150;153
5973;0;Pedra Redonda;Medianeira;0;0;0;0;0;0
5974;0;Pedra Redonda;Menino Deus;220;0;128;63;0;220
5975;0;Pedra Redonda;Moinhos de Vento;0;0;0;0;0;0
5976;0;Pedra Redonda;Mont'Serrat;0;0;0;0;0;0
5977;0;Pedra Redonda;Morro Santana;14;0;8;3;0;14
5978;0;Pedra Redonda;Mário Quintana;145;0;89;18;0;145
5979;0;Pedra Redonda;Navegantes;50;0;0;0;50;0
5980;0;Pedra Redonda;Nonoai;204;0;77;18;100;104
5981;0;Pedra Redonda;Parque Santa Fé;0;0;0;0;0;0
5982;0;Pedra Redonda;Partenon;212;0;113;47;0;212
5983;0;Pedra Redonda;Passo D'Areia;115;0;36;49;0;115
5984;0;Pedra Redonda;Passo das Pedras;11;0;7;1;0;11
5985;0;Pedra Redonda;Pedra Redonda;0;0;0;0;0;0
5986;0;Pedra Redonda;Petrópolis;121;50;39;17;50;71
5987;0;Pedra Redonda;Pitinga;0;0;0;0;0;0
5988;0;Pedra Redonda;Ponta Grossa;50;0;27;13;0;50
5989;0;Pedra Redonda;Praia de Belas;50;50;0;0;50;0
5990;0;Pedra Redonda;Restinga;185;50;81;19;50;135
5991;0;Pedra Redonda;Rio Branco;55;0;30;16;0;55
5992;0;Pedra Redonda;Rubem Berta;53;50;1;0;50;3
5993;0;Pedra Redonda;Santa Cecília;50;0;36;11;0;50
5994;0;Pedra Redonda;Santa Maria Goretti;0;0;0;0;0;0
5995;0;Pedra Redonda;Santa Rosa de Lima;53;0;30;9;0;53
5996;0;Pedra Redonda;Santa Tereza;121;0;46;10;50;71
5997;0;Pedra Redonda;Santana;107;0;6;0;100;7
5998;0;Pedra Redonda;Santo Antônio;0;0;0;0;0;0
5999;0;Pedra Redonda;Sarandi;93;0;51;25;0;93
6000;0;Pedra Redonda;Serraria;100;0;58;21;0;100
6001;0;Pedra Redonda;São Caetano;0;0;0;0;0;0
6002;0;Pedra Redonda;São Geraldo;50;0;36;12;0;50
6003;0;Pedra Redonda;São José;55;50;5;0;50;5
6004;0;Pedra Redonda;São João;0;0;0;0;0;0
6005;0;Pedra Redonda;São Sebastião;0;0;0;0;0;0
6006;0;Pedra Redonda;Sétimo Céu;150;0;32;3;100;50
6007;0;Pedra Redonda;Teresópolis;150;50;54;34;50;100
6008;0;Pedra Redonda;Tristeza;701;250;247;119;341;360
6009;0;Pedra Redonda;Três Figueiras;0;0;0;0;0;0
6010;0;Pedra Redonda;Vila Assunção;0;0;0;0;0;0
6011;0;Pedra Redonda;Vila Conceição;300;50;173;39;100;200
6012;0;Pedra Redonda;Vila Ipiranga;0;0;0;0;0;0
6013;0;Pedra Redonda;Vila Jardim;57;0;36;16;0;57
6014;0;Pedra Redonda;Vila João Pessoa;100;0;58;15;0;100
6015;0;Pedra Redonda;Vila Nova;195;0;87;26;50;145
6016;0;Petrópolis;Aberta dos Morros;320;50;108;44;200;120
6017;0;Petrópolis;Agronomia;100;0;60;26;0;100
6018;0;Petrópolis;Anchieta;150;0;94;39;0;150
6019;0;Petrópolis;Arquipélago;297;50;91;20;150;147
6020;0;Petrópolis;Auxiliadora;589;150;253;89;150;439
6021;0;Petrópolis;Azenha;727;100;289;146;200;527
6022;0;Petrópolis;Bela Vista;1224;150;588;206;450;774
6023;0;Petrópolis;Belém Novo;220;0;121;57;0;220
6024;0;Petrópolis;Belém Velho;249;100;82;6;200;49
6025;0;Petrópolis;Boa Vista;554;50;239;77;250;304
6026;0;Petrópolis;Boa Vista do Sul;50;0;0;0;50;0
6027;0;Petrópolis;Bom Fim;392;100;142;61;150;242
6028;0;Petrópolis;Bom Jesus;443;100;194;56;200;243
6029;0;Petrópolis;Camaquã;284;150;66;35;150;134
6030;0;Petrópolis;Campo Novo;38;0;27;4;0;38
6031;0;Petrópolis;Cascata;278;0;115;47;50;228
6032;0;Petrópolis;Cavalhada;270;150;94;15;200;70
6033;0;Petrópolis;Cel. Aparício Borges;435;150;147;53;200;235
6034;0;Petrópolis;Centro Histórico;473;0;103;36;300;173
6035;0;Petrópolis;Chapéu do Sol;200;0;131;41;0;200
6036;0;Petrópolis;Chácara das Pedras;800;50;278;109;400;400
6037;0;Petrópolis;Cidade Baixa;470;50;244;73;200;270
6038;0;Petrópolis;Costa e Silva;116;50;37;22;50;66
6039;0;Petrópolis;Cristal;498;50;242;140;50;448
6040;0;Petrópolis;Cristo Redentor;217;50;82;27;100;117
6041;0;Petrópolis;Espírito Santo;200;50;96;37;50;150
6042;0;Petrópolis;Extrema;50;0;30;16;0;50
6043;0;Petrópolis;Farrapos;5986;0;3286;1517;0;5986
6044;0;Petrópolis;Farroupilha;200;0;95;36;50;150
6045;0;Petrópolis;Floresta;300;150;109;34;200;100
6046;0;Petrópolis;Glória;297;50;115;56;100;197
6047;0;Petrópolis;Guarujá;150;50;46;35;50;100
6048;0;Petrópolis;Higienópolis;506;0;224;78;150;356
6049;0;Petrópolis;Humaitá;150;50;24;15;100;50
6050;0;Petrópolis;Hípica;0;0;0;0;0;0
6051;0;Petrópolis;Independência;418;100;114;86;200;218
6052;0;Petrópolis;Ipanema;109;0;62;32;0;109
6053;0;Petrópolis;Jardim Botânico;1963;450;356;60;1700;263
6054;0;Petrópolis;Jardim Carvalho;367;150;75;25;250;117
6055;0;Petrópolis;Jardim Europa;500;50;138;79;250;250
6056;0;Petrópolis;Jardim Floresta;300;0;77;41;150;150
6057;0;Petrópolis;Jardim Isabel;20;0;17;2;0;20
6058;0;Petrópolis;Jardim Itú;453;0;226;106;50;403
6059;0;Petrópolis;Jardim Leopoldina;179;0;108;43;0;179
6060;0;Petrópolis;Jardim Lindóia;476;50;183;75;150;326
6061;0;Petrópolis;Jardim Sabará;462;150;95;33;300;162
6062;0;Petrópolis;Jardim São Pedro;100;0;50;0;100;0
6063;0;Petrópolis;Jardim do Salso;1500;500;212;104;1150;350
6064;0;Petrópolis;Lageado;350;0;186;82;100;250
6065;0;Petrópolis;Lami;450;50;226;123;50;400
6066;0;Petrópolis;Lomba do Pinheiro;446;100;205;100;100;346
6067;0;Petrópolis;Medianeira;403;50;161;101;100;303
6068;0;Petrópolis;Menino Deus;478;150;112;37;300;178
6069;0;Petrópolis;Moinhos de Vento;298;100;99;32;200;98
6070;0;Petrópolis;Mont'Serrat;1799;650;242;86;1450;349
6071;0;Petrópolis;Morro Santana;450;100;159;89;150;300
6072;0;Petrópolis;Mário Quintana;210;50;87;36;50;160
6073;0;Petrópolis;Navegantes;250;100;94;38;100;150
6074;0;Petrópolis;Nonoai;508;50;252;99;100;408
6075;0;Petrópolis;Parque Santa Fé;100;0;64;27;0;100
6076;0;Petrópolis;Partenon;595;50;260;96;150;445
6077;0;Petrópolis;Passo D'Areia;423;50;129;68;200;223
6078;0;Petrópolis;Passo das Pedras;218;50;106;48;50;168
6079;0;Petrópolis;Pedra Redonda;100;50;26;11;50;50
6080;0;Petrópolis;Petrópolis;6341;1800;799;142;5800;541
6081;0;Petrópolis;Pitinga;350;0;149;78;50;300
6082;0;Petrópolis;Ponta Grossa;370;50;143;41;200;170
6083;0;Petrópolis;Praia de Belas;50;0;27;13;0;50
6084;0;Petrópolis;Restinga;345;200;53;25;250;95
6085;0;Petrópolis;Rio Branco;1190;0;565;289;150;1040
6086;0;Petrópolis;Rubem Berta;106;100;2;1;100;6
6087;0;Petrópolis;Santa Cecília;673;50;328;124;200;473
6088;0;Petrópolis;Santa Maria Goretti;300;0;111;50;100;200
6089;0;Petrópolis;Santa Rosa de Lima;107;50;36;19;50;57
6090;0;Petrópolis;Santa Tereza;400;0;165;81;100;300
6091;0;Petrópolis;Santana;763;200;242;103;400;363
6092;0;Petrópolis;Santo Antônio;260;0;143;78;0;260
6093;0;Petrópolis;Sarandi;406;100;30;18;350;56
6094;0;Petrópolis;Serraria;150;100;31;19;100;50
6095;0;Petrópolis;São Caetano;0;0;0;0;0;0
6096;0;Petrópolis;São Geraldo;100;0;23;13;50;50
6097;0;Petrópolis;São José;324;0;158;66;50;274
6098;0;Petrópolis;São João;274;0;125;49;50;224
6099;0;Petrópolis;São Sebastião;303;0;153;70;50;253
6100;0;Petrópolis;Sétimo Céu;50;0;23;12;0;50
6101;0;Petrópolis;Teresópolis;150;50;0;0;150;0
6102;0;Petrópolis;Tristeza;142;0;85;34;0;142
6103;0;Petrópolis;Três Figueiras;11200;1250;4471;2077;3600;7600
6104;0;Petrópolis;Vila Assunção;100;50;0;0;100;0
6105;0;Petrópolis;Vila Conceição;150;0;30;18;100;50
6106;0;Petrópolis;Vila Ipiranga;306;100;85;52;150;156
6107;0;Petrópolis;Vila Jardim;446;200;76;39;300;146
6108;0;Petrópolis;Vila João Pessoa;350;50;140;64;100;250
6109;0;Petrópolis;Vila Nova;285;50;110;46;100;185
6110;0;Pitinga;Aberta dos Morros;0;0;0;0;0;0
6111;0;Pitinga;Agronomia;0;0;0;0;0;0
6112;0;Pitinga;Anchieta;0;0;0;0;0;0
6113;0;Pitinga;Arquipélago;0;0;0;0;0;0
6114;0;Pitinga;Auxiliadora;5;0;2;3;0;5
6115;0;Pitinga;Azenha;50;0;25;12;0;50
6116;0;Pitinga;Bela Vista;6;0;3;2;0;6
6117;0;Pitinga;Belém Novo;100;0;65;10;0;100
6118;0;Pitinga;Belém Velho;158;0;74;10;50;108
6119;0;Pitinga;Boa Vista;103;0;66;11;0;103
6120;0;Pitinga;Boa Vista do Sul;50;0;29;13;0;50
6121;0;Pitinga;Bom Fim;100;0;21;17;50;50
6122;0;Pitinga;Bom Jesus;257;0;145;51;0;257
6123;0;Pitinga;Camaquã;7;0;6;1;0;7
6124;0;Pitinga;Campo Novo;0;0;0;0;0;0
6125;0;Pitinga;Cascata;150;50;57;13;50;100
6126;0;Pitinga;Cavalhada;9;0;7;1;0;9
6127;0;Pitinga;Cel. Aparício Borges;6;0;4;1;0;6
6128;0;Pitinga;Centro Histórico;55;0;3;2;47;8
6129;0;Pitinga;Chapéu do Sol;200;50;78;27;50;150
6130;0;Pitinga;Chácara das Pedras;0;0;0;0;0;0
6131;0;Pitinga;Cidade Baixa;59;50;1;4;50;9
6132;0;Pitinga;Costa e Silva;160;0;93;23;0;160
6133;0;Pitinga;Cristal;105;50;5;1;97;8
6134;0;Pitinga;Cristo Redentor;59;50;6;1;50;9
6135;0;Pitinga;Espírito Santo;50;50;0;0;50;0
6136;0;Pitinga;Extrema;147;47;60;14;47;100
6137;0;Pitinga;Farrapos;3064;1543;945;204;825;1207
6138;0;Pitinga;Farroupilha;0;0;0;0;0;0
6139;0;Pitinga;Floresta;50;0;25;13;0;50
6140;0;Pitinga;Glória;0;0;0;0;0;0
6141;0;Pitinga;Guarujá;100;0;34;2;50;50
6142;0;Pitinga;Higienópolis;104;0;70;18;0;104
6143;0;Pitinga;Humaitá;50;0;40;9;0;50
6144;0;Pitinga;Hípica;251;0;153;34;0;251
6145;0;Pitinga;Independência;47;47;0;0;47;0
6146;0;Pitinga;Ipanema;59;0;27;12;0;59
6147;0;Pitinga;Jardim Botânico;6;0;3;2;0;6
6148;0;Pitinga;Jardim Carvalho;105;0;61;29;0;105
6149;0;Pitinga;Jardim Europa;50;0;35;4;0;50
6150;0;Pitinga;Jardim Floresta;0;0;0;0;0;0
6151;0;Pitinga;Jardim Isabel;0;0;0;0;0;0
6152;0;Pitinga;Jardim Itú;0;0;0;0;0;0
6153;0;Pitinga;Jardim Leopoldina;58;0;36;12;0;58
6154;0;Pitinga;Jardim Lindóia;0;0;0;0;0;0
6155;0;Pitinga;Jardim Sabará;100;0;55;24;0;100
6156;0;Pitinga;Jardim São Pedro;0;0;0;0;0;0
6157;0;Pitinga;Jardim do Salso;0;0;0;0;0;0
6158;0;Pitinga;Lageado;300;100;123;25;100;200
6159;0;Pitinga;Lami;150;0;96;21;0;150
6160;0;Pitinga;Lomba do Pinheiro;1433;0;792;187;76;1357
6161;0;Pitinga;Medianeira;0;0;0;0;0;0
6162;0;Pitinga;Menino Deus;54;0;5;1;47;7
6163;0;Pitinga;Moinhos de Vento;100;0;58;32;0;100
6164;0;Pitinga;Mont'Serrat;153;0;90;32;0;153
6165;0;Pitinga;Morro Santana;106;0;41;3;47;59
6166;0;Pitinga;Mário Quintana;55;47;5;0;47;8
6167;0;Pitinga;Navegantes;0;0;0;0;0;0
6168;0;Pitinga;Nonoai;9;0;5;1;0;9
6169;0;Pitinga;Parque Santa Fé;0;0;0;0;0;0
6170;0;Pitinga;Partenon;108;0;32;10;50;58
6171;0;Pitinga;Passo D'Areia;56;0;13;23;0;56
6172;0;Pitinga;Passo das Pedras;57;0;33;12;0;57
6173;0;Pitinga;Pedra Redonda;0;0;0;0;0;0
6174;0;Pitinga;Petrópolis;353;0;151;79;47;306
6175;0;Pitinga;Pitinga;1158;100;520;116;258;900
6176;0;Pitinga;Ponta Grossa;100;0;53;20;0;100
6177;0;Pitinga;Praia de Belas;0;0;0;0;0;0
6178;0;Pitinga;Restinga;1703;149;816;187;343;1360
6179;0;Pitinga;Rio Branco;10;0;6;1;0;10
6180;0;Pitinga;Rubem Berta;55;50;1;3;50;5
6181;0;Pitinga;Santa Cecília;50;0;30;16;0;50
6182;0;Pitinga;Santa Maria Goretti;0;0;0;0;0;0
6183;0;Pitinga;Santa Rosa de Lima;102;0;63;19;0;102
6184;0;Pitinga;Santa Tereza;139;0;68;19;29;110
6185;0;Pitinga;Santana;58;0;30;9;0;58
6186;0;Pitinga;Santo Antônio;3;0;1;2;0;3
6187;0;Pitinga;Sarandi;60;0;32;13;0;60
6188;0;Pitinga;Serraria;0;0;0;0;0;0
6189;0;Pitinga;São Caetano;50;0;0;0;50;0
6190;0;Pitinga;São Geraldo;50;0;26;8;0;50
6191;0;Pitinga;São José;108;0;71;23;0;108
6192;0;Pitinga;São João;50;0;31;15;0;50
6193;0;Pitinga;São Sebastião;0;0;0;0;0;0
6194;0;Pitinga;Sétimo Céu;0;0;0;0;0;0
6195;0;Pitinga;Teresópolis;145;47;34;7;95;50
6196;0;Pitinga;Tristeza;108;50;4;2;100;8
6197;0;Pitinga;Três Figueiras;0;0;0;0;0;0
6198;0;Pitinga;Vila Assunção;0;0;0;0;0;0
6199;0;Pitinga;Vila Conceição;0;0;0;0;0;0
6200;0;Pitinga;Vila Ipiranga;103;0;61;25;0;103
6201;0;Pitinga;Vila Jardim;60;0;37;21;0;60
6202;0;Pitinga;Vila João Pessoa;0;0;0;0;0;0
6203;0;Pitinga;Vila Nova;10;0;8;2;0;10
6204;0;Ponta Grossa;Aberta dos Morros;350;50;185;50;50;300
6205;0;Ponta Grossa;Agronomia;0;0;0;0;0;0
6206;0;Ponta Grossa;Anchieta;50;0;28;7;0;50
6207;0;Ponta Grossa;Arquipélago;50;0;34;11;0;50
6208;0;Ponta Grossa;Auxiliadora;0;0;0;0;0;0
6209;0;Ponta Grossa;Azenha;51;0;20;14;0;51
6210;0;Ponta Grossa;Bela Vista;104;0;3;0;100;4
6211;0;Ponta Grossa;Belém Novo;800;50;455;111;50;750
6212;0;Ponta Grossa;Belém Velho;54;0;35;11;0;54
6213;0;Ponta Grossa;Boa Vista;53;0;27;19;0;53
6214;0;Ponta Grossa;Boa Vista do Sul;50;0;31;7;0;50
6215;0;Ponta Grossa;Bom Fim;50;50;0;0;50;0
6216;0;Ponta Grossa;Bom Jesus;110;0;36;18;50;60
6217;0;Ponta Grossa;Camaquã;104;0;60;26;0;104
6218;0;Ponta Grossa;Campo Novo;150;0;63;16;50;100
6219;0;Ponta Grossa;Cascata;0;0;0;0;0;0
6220;0;Ponta Grossa;Cavalhada;425;0;205;68;100;325
6221;0;Ponta Grossa;Cel. Aparício Borges;71;0;47;15;0;71
6222;0;Ponta Grossa;Centro Histórico;153;0;33;9;100;53
6223;0;Ponta Grossa;Chapéu do Sol;100;0;36;5;50;50
6224;0;Ponta Grossa;Chácara das Pedras;50;0;33;14;0;50
6225;0;Ponta Grossa;Cidade Baixa;3;0;3;0;0;3
6226;0;Ponta Grossa;Costa e Silva;110;0;67;15;0;110
6227;0;Ponta Grossa;Cristal;181;50;83;17;50;131
6228;0;Ponta Grossa;Cristo Redentor;61;0;4;4;50;11
6229;0;Ponta Grossa;Espírito Santo;500;100;276;50;150;350
6230;0;Ponta Grossa;Extrema;0;0;0;0;0;0
6231;0;Ponta Grossa;Farrapos;150;100;27;9;100;50
6232;0;Ponta Grossa;Farroupilha;0;0;0;0;0;0
6233;0;Ponta Grossa;Floresta;100;0;54;23;0;100
6234;0;Ponta Grossa;Glória;100;50;29;11;50;50
6235;0;Ponta Grossa;Guarujá;850;100;393;93;300;550
6236;0;Ponta Grossa;Higienópolis;100;0;34;4;50;50
6237;0;Ponta Grossa;Humaitá;100;0;27;11;50;50
6238;0;Ponta Grossa;Hípica;1104;250;433;102;400;704
6239;0;Ponta Grossa;Independência;0;0;0;0;0;0
6240;0;Ponta Grossa;Ipanema;253;100;97;24;100;153
6241;0;Ponta Grossa;Jardim Botânico;207;50;56;17;100;107
6242;0;Ponta Grossa;Jardim Carvalho;102;0;58;26;0;102
6243;0;Ponta Grossa;Jardim Europa;0;0;0;0;0;0
6244;0;Ponta Grossa;Jardim Floresta;150;0;82;31;0;150
6245;0;Ponta Grossa;Jardim Isabel;50;0;0;0;50;0
6246;0;Ponta Grossa;Jardim Itú;0;0;0;0;0;0
6247;0;Ponta Grossa;Jardim Leopoldina;4;0;1;1;0;4
6248;0;Ponta Grossa;Jardim Lindóia;50;0;25;17;0;50
6249;0;Ponta Grossa;Jardim Sabará;0;0;0;0;0;0
6250;0;Ponta Grossa;Jardim São Pedro;50;0;38;10;0;50
6251;0;Ponta Grossa;Jardim do Salso;100;0;64;17;0;100
6252;0;Ponta Grossa;Lageado;0;0;0;0;0;0
6253;0;Ponta Grossa;Lami;100;50;29;8;50;50
6254;0;Ponta Grossa;Lomba do Pinheiro;104;0;59;17;0;104
6255;0;Ponta Grossa;Medianeira;50;0;31;7;0;50
6256;0;Ponta Grossa;Menino Deus;174;50;65;35;50;124
6257;0;Ponta Grossa;Moinhos de Vento;100;0;47;33;0;100
6258;0;Ponta Grossa;Mont'Serrat;0;0;0;0;0;0
6259;0;Ponta Grossa;Morro Santana;62;0;39;12;0;62
6260;0;Ponta Grossa;Mário Quintana;382;50;170;29;100;282
6261;0;Ponta Grossa;Navegantes;0;0;0;0;0;0
6262;0;Ponta Grossa;Nonoai;104;0;61;20;0;104
6263;0;Ponta Grossa;Parque Santa Fé;0;0;0;0;0;0
6264;0;Ponta Grossa;Partenon;10;0;4;6;0;10
6265;0;Ponta Grossa;Passo D'Areia;115;0;40;42;0;115
6266;0;Ponta Grossa;Passo das Pedras;160;0;36;12;100;60
6267;0;Ponta Grossa;Pedra Redonda;50;0;27;13;0;50
6268;0;Ponta Grossa;Petrópolis;425;50;176;50;200;225
6269;0;Ponta Grossa;Pitinga;100;0;53;20;0;100
6270;0;Ponta Grossa;Ponta Grossa;1600;300;736;160;400;1200
6271;0;Ponta Grossa;Praia de Belas;50;0;28;9;0;50
6272;0;Ponta Grossa;Restinga;482;50;227;50;100;382
6273;0;Ponta Grossa;Rio Branco;104;50;2;1;100;4
6274;0;Ponta Grossa;Rubem Berta;252;50;96;81;50;202
6275;0;Ponta Grossa;Santa Cecília;100;0;52;24;0;100
6276;0;Ponta Grossa;Santa Maria Goretti;0;0;0;0;0;0
6277;0;Ponta Grossa;Santa Rosa de Lima;100;50;0;0;100;0
6278;0;Ponta Grossa;Santa Tereza;271;0;163;41;0;271
6279;0;Ponta Grossa;Santana;105;0;29;19;50;55
6280;0;Ponta Grossa;Santo Antônio;100;50;0;0;100;0
6281;0;Ponta Grossa;Sarandi;84;0;20;7;50;34
6282;0;Ponta Grossa;Serraria;1100;200;438;100;400;700
6283;0;Ponta Grossa;São Caetano;50;0;27;9;0;50
6284;0;Ponta Grossa;São Geraldo;0;0;0;0;0;0
6285;0;Ponta Grossa;São José;54;50;3;1;50;4
6286;0;Ponta Grossa;São João;50;0;19;19;0;50
6287;0;Ponta Grossa;São Sebastião;50;0;39;7;0;50
6288;0;Ponta Grossa;Sétimo Céu;100;0;66;13;0;100
6289;0;Ponta Grossa;Teresópolis;0;0;0;0;0;0
6290;0;Ponta Grossa;Tristeza;9;0;6;0;0;9
6291;0;Ponta Grossa;Três Figueiras;50;0;26;13;0;50
6292;0;Ponta Grossa;Vila Assunção;100;0;58;17;0;100
6293;0;Ponta Grossa;Vila Conceição;50;0;0;0;50;0
6294;0;Ponta Grossa;Vila Ipiranga;0;0;0;0;0;0
6295;0;Ponta Grossa;Vila Jardim;103;0;58;21;0;103
6296;0;Ponta Grossa;Vila João Pessoa;100;0;65;26;0;100
6297;0;Ponta Grossa;Vila Nova;182;0;97;45;0;182
6298;0;Praia de Belas;Aberta dos Morros;0;0;0;0;0;0
6299;0;Praia de Belas;Agronomia;0;0;0;0;0;0
6300;0;Praia de Belas;Anchieta;0;0;0;0;0;0
6301;0;Praia de Belas;Arquipélago;1109;292;314;61;609;500
6302;0;Praia de Belas;Auxiliadora;4;0;2;2;0;4
6303;0;Praia de Belas;Azenha;437;148;135;63;187;250
6304;0;Praia de Belas;Bela Vista;161;0;103;36;0;161
6305;0;Praia de Belas;Belém Novo;0;0;0;0;0;0
6306;0;Praia de Belas;Belém Velho;15;0;12;2;0;15
6307;0;Praia de Belas;Boa Vista;3;0;2;1;0;3
6308;0;Praia de Belas;Boa Vista do Sul;0;0;0;0;0;0
6309;0;Praia de Belas;Bom Fim;239;0;88;56;39;200
6310;0;Praia de Belas;Bom Jesus;214;50;102;21;50;164
6311;0;Praia de Belas;Camaquã;108;0;32;15;50;58
6312;0;Praia de Belas;Campo Novo;50;50;0;0;50;0
6313;0;Praia de Belas;Cascata;50;0;27;10;0;50
6314;0;Praia de Belas;Cavalhada;125;0;46;11;50;75
6315;0;Praia de Belas;Cel. Aparício Borges;70;0;43;8;0;70
6316;0;Praia de Belas;Centro Histórico;944;149;294;146;377;567
6317;0;Praia de Belas;Chapéu do Sol;0;0;0;0;0;0
6318;0;Praia de Belas;Chácara das Pedras;89;0;24;14;39;50
6319;0;Praia de Belas;Cidade Baixa;1062;146;399;144;402;660
6320;0;Praia de Belas;Costa e Silva;15;0;6;2;0;15
6321;0;Praia de Belas;Cristal;476;98;123;38;248;228
6322;0;Praia de Belas;Cristo Redentor;74;0;45;19;0;74
6323;0;Praia de Belas;Espírito Santo;0;0;0;0;0;0
6324;0;Praia de Belas;Extrema;0;0;0;0;0;0
6325;0;Praia de Belas;Farrapos;382;64;71;15;282;100
6326;0;Praia de Belas;Farroupilha;0;0;0;0;0;0
6327;0;Praia de Belas;Floresta;150;0;42;33;50;100
6328;0;Praia de Belas;Glória;200;49;83;30;49;151
6329;0;Praia de Belas;Guarujá;0;0;0;0;0;0
6330;0;Praia de Belas;Higienópolis;52;49;2;0;49;3
6331;0;Praia de Belas;Humaitá;100;0;67;22;0;100
6332;0;Praia de Belas;Hípica;0;0;0;0;0;0
6333;0;Praia de Belas;Independência;50;0;27;16;0;50
6334;0;Praia de Belas;Ipanema;14;0;9;3;0;14
6335;0;Praia de Belas;Jardim Botânico;66;0;40;11;0;66
6336;0;Praia de Belas;Jardim Carvalho;152;0;86;46;0;152
6337;0;Praia de Belas;Jardim Europa;0;0;0;0;0;0
6338;0;Praia de Belas;Jardim Floresta;0;0;0;0;0;0
6339;0;Praia de Belas;Jardim Isabel;50;0;35;11;0;50
6340;0;Praia de Belas;Jardim Itú;102;0;64;23;0;102
6341;0;Praia de Belas;Jardim Leopoldina;12;0;8;1;0;12
6342;0;Praia de Belas;Jardim Lindóia;0;0;0;0;0;0
6343;0;Praia de Belas;Jardim Sabará;100;0;50;23;0;100
6344;0;Praia de Belas;Jardim São Pedro;0;0;0;0;0;0
6345;0;Praia de Belas;Jardim do Salso;0;0;0;0;0;0
6346;0;Praia de Belas;Lageado;0;0;0;0;0;0
6347;0;Praia de Belas;Lami;0;0;0;0;0;0
6348;0;Praia de Belas;Lomba do Pinheiro;66;0;36;15;0;66
6349;0;Praia de Belas;Medianeira;239;50;102;20;139;100
6350;0;Praia de Belas;Menino Deus;3436;712;1220;727;1112;2324
6351;0;Praia de Belas;Moinhos de Vento;99;49;23;16;49;50
6352;0;Praia de Belas;Mont'Serrat;103;0;64;22;0;103
6353;0;Praia de Belas;Morro Santana;73;49;9;8;49;24
6354;0;Praia de Belas;Mário Quintana;31;0;23;2;0;31
6355;0;Praia de Belas;Navegantes;100;50;33;11;50;50
6356;0;Praia de Belas;Nonoai;209;49;96;25;49;160
6357;0;Praia de Belas;Parque Santa Fé;0;0;0;0;0;0
6358;0;Praia de Belas;Partenon;222;0;121;55;0;222
6359;0;Praia de Belas;Passo D'Areia;120;0;43;48;0;120
6360;0;Praia de Belas;Passo das Pedras;72;0;12;5;50;22
6361;0;Praia de Belas;Pedra Redonda;50;50;0;0;50;0
6362;0;Praia de Belas;Petrópolis;71;0;36;16;0;71
6363;0;Praia de Belas;Pitinga;0;0;0;0;0;0
6364;0;Praia de Belas;Ponta Grossa;50;0;28;9;0;50
6365;0;Praia de Belas;Praia de Belas;0;0;0;0;0;0
6366;0;Praia de Belas;Restinga;77;0;41;9;0;77
6367;0;Praia de Belas;Rio Branco;163;0;96;43;0;163
6368;0;Praia de Belas;Rubem Berta;105;0;31;16;49;56
6369;0;Praia de Belas;Santa Cecília;50;0;27;10;0;50
6370;0;Praia de Belas;Santa Maria Goretti;0;0;0;0;0;0
6371;0;Praia de Belas;Santa Rosa de Lima;53;0;28;14;0;53
6372;0;Praia de Belas;Santa Tereza;822;198;267;107;348;474
6373;0;Praia de Belas;Santana;355;0;181;79;39;316
6374;0;Praia de Belas;Santo Antônio;152;50;58;20;50;102
6375;0;Praia de Belas;Sarandi;340;0;166;77;49;291
6376;0;Praia de Belas;Serraria;0;0;0;0;0;0
6377;0;Praia de Belas;São Caetano;0;0;0;0;0;0
6378;0;Praia de Belas;São Geraldo;0;0;0;0;0;0
6379;0;Praia de Belas;São José;107;0;39;14;39;68
6380;0;Praia de Belas;São João;0;0;0;0;0;0
6381;0;Praia de Belas;São Sebastião;49;49;0;0;49;0
6382;0;Praia de Belas;Sétimo Céu;0;0;0;0;0;0
6383;0;Praia de Belas;Teresópolis;150;0;93;34;0;150
6384;0;Praia de Belas;Tristeza;116;0;64;39;0;116
6385;0;Praia de Belas;Três Figueiras;0;0;0;0;0;0
6386;0;Praia de Belas;Vila Assunção;0;0;0;0;0;0
6387;0;Praia de Belas;Vila Conceição;0;0;0;0;0;0
6388;0;Praia de Belas;Vila Ipiranga;103;0;34;16;50;53
6389;0;Praia de Belas;Vila Jardim;116;0;40;21;49;67
6390;0;Praia de Belas;Vila João Pessoa;0;0;0;0;0;0
6391;0;Praia de Belas;Vila Nova;126;49;50;11;49;77
6392;0;Restinga;Aberta dos Morros;2222;450;715;191;950;1272
6393;0;Restinga;Agronomia;400;50;183;44;100;300
6394;0;Restinga;Anchieta;150;50;31;9;100;50
6395;0;Restinga;Arquipélago;250;50;83;18;100;150
6396;0;Restinga;Auxiliadora;103;50;37;6;50;53
6397;0;Restinga;Azenha;269;50;64;20;149;120
6398;0;Restinga;Bela Vista;123;46;11;10;96;27
6399;0;Restinga;Belém Novo;269;99;68;20;149;120
6400;0;Restinga;Belém Velho;872;246;278;72;396;476
6401;0;Restinga;Boa Vista;0;0;0;0;0;0
6402;0;Restinga;Boa Vista do Sul;100;0;53;20;0;100
6403;0;Restinga;Bom Fim;50;0;25;7;0;50
6404;0;Restinga;Bom Jesus;139;0;55;22;50;89
6405;0;Restinga;Camaquã;2;0;2;0;0;2
6406;0;Restinga;Campo Novo;900;300;137;29;750;150
6407;0;Restinga;Cascata;250;50;54;17;150;100
6408;0;Restinga;Cavalhada;303;45;120;37;95;208
6409;0;Restinga;Cel. Aparício Borges;207;100;59;25;100;107
6410;0;Restinga;Centro Histórico;22;0;1;1;17;5
6411;0;Restinga;Chapéu do Sol;4898;300;2546;687;596;4302
6412;0;Restinga;Chácara das Pedras;52;0;29;9;0;52
6413;0;Restinga;Cidade Baixa;153;50;60;12;50;103
6414;0;Restinga;Costa e Silva;203;46;36;8;145;58
6415;0;Restinga;Cristal;156;0;32;7;99;57
6416;0;Restinga;Cristo Redentor;33;0;17;10;0;33
6417;0;Restinga;Espírito Santo;600;150;179;47;300;300
6418;0;Restinga;Extrema;300;0;150;38;50;250
6419;0;Restinga;Farrapos;9584;89;5486;1508;205;9379
6420;0;Restinga;Farroupilha;100;0;28;7;50;50
6421;0;Restinga;Floresta;50;50;0;0;50;0
6422;0;Restinga;Glória;550;150;226;54;150;400
6423;0;Restinga;Guarujá;650;150;197;53;300;350
6424;0;Restinga;Higienópolis;0;0;0;0;0;0
6425;0;Restinga;Humaitá;402;100;141;15;250;152
6426;0;Restinga;Hípica;1310;286;469;110;562;748
6427;0;Restinga;Independência;50;0;23;12;0;50
6428;0;Restinga;Ipanema;557;0;306;82;0;557
6429;0;Restinga;Jardim Botânico;233;46;96;36;46;187
6430;0;Restinga;Jardim Carvalho;259;96;115;20;146;113
6431;0;Restinga;Jardim Europa;0;0;0;0;0;0
6432;0;Restinga;Jardim Floresta;150;50;0;0;150;0
6433;0;Restinga;Jardim Isabel;50;0;26;7;0;50
6434;0;Restinga;Jardim Itú;225;49;100;33;49;176
6435;0;Restinga;Jardim Leopoldina;4;0;3;1;0;4
6436;0;Restinga;Jardim Lindóia;0;0;0;0;0;0
6437;0;Restinga;Jardim Sabará;224;0;98;26;49;175
6438;0;Restinga;Jardim São Pedro;0;0;0;0;0;0
6439;0;Restinga;Jardim do Salso;200;50;85;29;50;150
6440;0;Restinga;Lageado;900;400;208;58;600;300
6441;0;Restinga;Lami;200;50;86;21;50;150
6442;0;Restinga;Lomba do Pinheiro;490;142;165;44;192;298
6443;0;Restinga;Medianeira;100;0;61;11;0;100
6444;0;Restinga;Menino Deus;69;0;38;12;0;69
6445;0;Restinga;Moinhos de Vento;0;0;0;0;0;0
6446;0;Restinga;Mont'Serrat;149;50;31;10;99;50
6447;0;Restinga;Morro Santana;84;50;17;10;50;34
6448;0;Restinga;Mário Quintana;367;149;134;27;149;218
6449;0;Restinga;Navegantes;100;0;27;7;50;50
6450;0;Restinga;Nonoai;254;50;112;37;50;204
6451;0;Restinga;Parque Santa Fé;100;0;48;17;0;100
6452;0;Restinga;Partenon;614;97;219;57;245;369
6453;0;Restinga;Passo D'Areia;109;0;27;12;50;59
6454;0;Restinga;Passo das Pedras;57;0;33;11;0;57
6455;0;Restinga;Pedra Redonda;150;50;59;12;50;100
6456;0;Restinga;Petrópolis;269;187;18;9;237;32
6457;0;Restinga;Pitinga;1521;146;730;171;314;1207
6458;0;Restinga;Ponta Grossa;450;50;207;45;100;350
6459;0;Restinga;Praia de Belas;50;0;28;7;0;50
6460;0;Restinga;Restinga;16982;387;9433;2495;455;16527
6461;0;Restinga;Rio Branco;151;46;52;22;46;105
6462;0;Restinga;Rubem Berta;127;0;41;20;50;77
6463;0;Restinga;Santa Cecília;199;0;84;24;49;150
6464;0;Restinga;Santa Maria Goretti;50;0;26;10;0;50
6465;0;Restinga;Santa Rosa de Lima;263;50;118;42;50;213
6466;0;Restinga;Santa Tereza;89;50;26;5;50;39
6467;0;Restinga;Santana;232;0;93;17;100;132
6468;0;Restinga;Santo Antônio;164;50;64;16;50;114
6469;0;Restinga;Sarandi;282;0;151;44;0;282
6470;0;Restinga;Serraria;175;0;105;26;0;175
6471;0;Restinga;São Caetano;150;0;90;23;0;150
6472;0;Restinga;São Geraldo;50;0;0;0;50;0
6473;0;Restinga;São José;180;100;51;13;100;80
6474;0;Restinga;São João;199;0;90;23;49;150
6475;0;Restinga;São Sebastião;50;0;21;13;0;50
6476;0;Restinga;Sétimo Céu;450;100;108;26;250;200
6477;0;Restinga;Teresópolis;300;150;90;19;150;150
6478;0;Restinga;Tristeza;156;49;41;10;99;57
6479;0;Restinga;Três Figueiras;100;0;29;9;50;50
6480;0;Restinga;Vila Assunção;96;0;33;6;46;50
6481;0;Restinga;Vila Conceição;200;0;82;20;50;150
6482;0;Restinga;Vila Ipiranga;149;49;34;7;99;50
6483;0;Restinga;Vila Jardim;157;100;28;13;100;57
6484;0;Restinga;Vila João Pessoa;145;0;87;21;0;145
6485;0;Restinga;Vila Nova;920;150;341;62;500;420
6486;0;Rio Branco;Aberta dos Morros;50;0;24;15;0;50
6487;0;Rio Branco;Agronomia;0;0;0;0;0;0
6488;0;Rio Branco;Anchieta;50;0;32;11;0;50
6489;0;Rio Branco;Arquipélago;50;0;25;8;0;50
6490;0;Rio Branco;Auxiliadora;551;50;163;82;250;301
6491;0;Rio Branco;Azenha;396;100;117;38;246;150
6492;0;Rio Branco;Bela Vista;3860;1147;758;347;2556;1304
6493;0;Rio Branco;Belém Novo;0;0;0;0;0;0
6494;0;Rio Branco;Belém Velho;6;0;3;2;0;6
6495;0;Rio Branco;Boa Vista;248;48;60;22;148;100
6496;0;Rio Branco;Boa Vista do Sul;150;100;32;14;100;50
6497;0;Rio Branco;Bom Fim;2125;146;865;419;525;1600
6498;0;Rio Branco;Bom Jesus;156;0;64;11;48;108
6499;0;Rio Branco;Camaquã;296;94;110;15;194;102
6500;0;Rio Branco;Campo Novo;50;0;0;0;50;0
6501;0;Rio Branco;Cascata;0;0;0;0;0;0
6502;0;Rio Branco;Cavalhada;14;0;7;6;0;14
6503;0;Rio Branco;Cel. Aparício Borges;365;50;144;71;100;265
6504;0;Rio Branco;Centro Histórico;1852;149;888;375;246;1606
6505;0;Rio Branco;Chapéu do Sol;0;0;0;0;0;0
6506;0;Rio Branco;Chácara das Pedras;350;50;96;65;150;200
6507;0;Rio Branco;Cidade Baixa;332;100;78;33;180;152
6508;0;Rio Branco;Costa e Silva;58;0;31;19;0;58
6509;0;Rio Branco;Cristal;265;100;91;40;100;165
6510;0;Rio Branco;Cristo Redentor;111;50;37;17;50;61
6511;0;Rio Branco;Espírito Santo;50;0;27;13;0;50
6512;0;Rio Branco;Extrema;100;0;60;22;0;100
6513;0;Rio Branco;Farrapos;8591;2338;3476;1817;2413;2020
6514;0;Rio Branco;Farroupilha;500;250;81;35;350;150
6515;0;Rio Branco;Floresta;945;148;354;207;245;700
6516;0;Rio Branco;Glória;0;0;0;0;0;0
6517;0;Rio Branco;Guarujá;50;0;35;12;0;50
6518;0;Rio Branco;Higienópolis;51;50;1;0;50;1
6519;0;Rio Branco;Humaitá;200;0;130;38;0;200
6520;0;Rio Branco;Hípica;50;0;50;0;50;0
6521;0;Rio Branco;Independência;1095;50;446;277;245;850
6522;0;Rio Branco;Ipanema;57;0;29;18;0;57
6523;0;Rio Branco;Jardim Botânico;210;0;115;55;0;210
6524;0;Rio Branco;Jardim Carvalho;101;50;31;9;50;51
6525;0;Rio Branco;Jardim Europa;200;0;75;9;150;50
6526;0;Rio Branco;Jardim Floresta;100;0;24;16;50;50
6527;0;Rio Branco;Jardim Isabel;0;0;0;0;0;0
6528;0;Rio Branco;Jardim Itú;50;0;31;9;0;50
6529;0;Rio Branco;Jardim Leopoldina;104;0;28;18;50;54
6530;0;Rio Branco;Jardim Lindóia;148;0;26;14;98;50
6531;0;Rio Branco;Jardim Sabará;250;150;100;0;250;0
6532;0;Rio Branco;Jardim São Pedro;100;50;23;20;50;50
6533;0;Rio Branco;Jardim do Salso;250;0;124;51;50;200
6534;0;Rio Branco;Lageado;50;0;28;13;0;50
6535;0;Rio Branco;Lami;0;0;0;0;0;0
6536;0;Rio Branco;Lomba do Pinheiro;106;0;31;10;50;56
6537;0;Rio Branco;Medianeira;350;100;96;61;150;200
6538;0;Rio Branco;Menino Deus;838;141;288;106;472;366
6539;0;Rio Branco;Moinhos de Vento;2359;332;836;614;709;1650
6540;0;Rio Branco;Mont'Serrat;495;147;194;69;244;251
6541;0;Rio Branco;Morro Santana;263;50;110;54;50;213
6542;0;Rio Branco;Mário Quintana;130;48;58;11;48;82
6543;0;Rio Branco;Navegantes;130;50;24;23;80;50
6544;0;Rio Branco;Nonoai;150;48;52;33;48;102
6545;0;Rio Branco;Parque Santa Fé;0;0;0;0;0;0
6546;0;Rio Branco;Partenon;459;50;199;57;149;310
6547;0;Rio Branco;Passo D'Areia;415;50;108;113;100;315
6548;0;Rio Branco;Passo das Pedras;61;0;31;15;0;61
6549;0;Rio Branco;Pedra Redonda;50;0;26;15;0;50
6550;0;Rio Branco;Petrópolis;2416;0;1198;646;150;2266
6551;0;Rio Branco;Pitinga;0;0;0;0;0;0
6552;0;Rio Branco;Ponta Grossa;100;50;0;0;100;0
6553;0;Rio Branco;Praia de Belas;150;0;89;39;0;150
6554;0;Rio Branco;Restinga;164;50;52;22;50;114
6555;0;Rio Branco;Rio Branco;2601;98;1244;716;195;2406
6556;0;Rio Branco;Rubem Berta;2;0;1;1;0;2
6557;0;Rio Branco;Santa Cecília;2548;0;1329;727;98;2450
6558;0;Rio Branco;Santa Maria Goretti;50;0;23;16;0;50
6559;0;Rio Branco;Santa Rosa de Lima;101;0;1;0;100;1
6560;0;Rio Branco;Santa Tereza;412;0;210;87;48;364
6561;0;Rio Branco;Santana;505;149;171;76;197;308
6562;0;Rio Branco;Santo Antônio;431;0;162;55;230;201
6563;0;Rio Branco;Sarandi;281;0;145;84;0;281
6564;0;Rio Branco;Serraria;0;0;0;0;0;0
6565;0;Rio Branco;São Caetano;50;50;0;0;50;0
6566;0;Rio Branco;São Geraldo;300;50;153;72;100;200
6567;0;Rio Branco;São José;57;0;6;0;50;7
6568;0;Rio Branco;São João;497;50;180;112;147;350
6569;0;Rio Branco;São Sebastião;100;0;48;36;0;100
6570;0;Rio Branco;Sétimo Céu;50;0;0;0;50;0
6571;0;Rio Branco;Teresópolis;50;0;36;10;0;50
6572;0;Rio Branco;Tristeza;9;0;5;2;0;9
6573;0;Rio Branco;Três Figueiras;200;100;61;26;100;100
6574;0;Rio Branco;Vila Assunção;0;0;0;0;0;0
6575;0;Rio Branco;Vila Conceição;0;0;0;0;0;0
6576;0;Rio Branco;Vila Ipiranga;151;0;57;31;50;101
6577;0;Rio Branco;Vila Jardim;234;0;25;20;180;54
6578;0;Rio Branco;Vila João Pessoa;150;0;30;16;100;50
6579;0;Rio Branco;Vila Nova;15;0;6;4;0;15
6580;0;Rubem Berta;Aberta dos Morros;0;0;0;0;0;0
6581;0;Rubem Berta;Agronomia;50;0;0;0;50;0
6582;0;Rubem Berta;Anchieta;50;0;22;23;0;50
6583;0;Rubem Berta;Arquipélago;0;0;0;0;0;0
6584;0;Rubem Berta;Auxiliadora;156;0;70;69;0;156
6585;0;Rubem Berta;Azenha;200;0;82;51;50;150
6586;0;Rubem Berta;Bela Vista;105;0;55;31;0;105
6587;0;Rubem Berta;Belém Novo;100;0;55;31;0;100
6588;0;Rubem Berta;Belém Velho;155;0;90;28;0;155
6589;0;Rubem Berta;Boa Vista;53;0;22;23;0;53
6590;0;Rubem Berta;Boa Vista do Sul;0;0;0;0;0;0
6591;0;Rubem Berta;Bom Fim;100;0;46;39;0;100
6592;0;Rubem Berta;Bom Jesus;259;0;93;49;50;209
6593;0;Rubem Berta;Camaquã;55;0;29;21;0;55
6594;0;Rubem Berta;Campo Novo;50;50;0;0;50;0
6595;0;Rubem Berta;Cascata;100;0;47;19;0;100
6596;0;Rubem Berta;Cavalhada;319;100;117;63;100;219
6597;0;Rubem Berta;Cel. Aparício Borges;217;100;65;14;100;117
6598;0;Rubem Berta;Centro Histórico;158;100;34;15;100;58
6599;0;Rubem Berta;Chapéu do Sol;200;0;92;70;0;200
6600;0;Rubem Berta;Chácara das Pedras;50;0;26;12;0;50
6601;0;Rubem Berta;Cidade Baixa;55;0;26;21;0;55
6602;0;Rubem Berta;Costa e Silva;2559;750;618;422;1350;1209
6603;0;Rubem Berta;Cristal;226;100;51;16;150;76
6604;0;Rubem Berta;Cristo Redentor;62;0;8;2;50;12
6605;0;Rubem Berta;Espírito Santo;0;0;0;0;0;0
6606;0;Rubem Berta;Extrema;50;50;0;0;50;0
6607;0;Rubem Berta;Farrapos;0;0;0;0;0;0
6608;0;Rubem Berta;Farroupilha;200;0;93;73;0;200
6609;0;Rubem Berta;Floresta;150;50;59;24;50;100
6610;0;Rubem Berta;Glória;103;100;1;2;100;3
6611;0;Rubem Berta;Guarujá;0;0;0;0;0;0
6612;0;Rubem Berta;Higienópolis;54;0;26;22;0;54
6613;0;Rubem Berta;Humaitá;250;50;98;37;100;150
6614;0;Rubem Berta;Hípica;100;0;45;38;0;100
6615;0;Rubem Berta;Independência;200;50;42;36;100;100
6616;0;Rubem Berta;Ipanema;57;0;25;12;0;57
6617;0;Rubem Berta;Jardim Botânico;159;50;59;35;50;109
6618;0;Rubem Berta;Jardim Carvalho;205;0;135;59;50;155
6619;0;Rubem Berta;Jardim Europa;200;0;58;70;50;150
6620;0;Rubem Berta;Jardim Floresta;50;0;23;23;0;50
6621;0;Rubem Berta;Jardim Isabel;50;0;20;21;0;50
6622;0;Rubem Berta;Jardim Itú;603;200;237;124;250;353
6623;0;Rubem Berta;Jardim Leopoldina;3055;600;995;531;1300;1755
6624;0;Rubem Berta;Jardim Lindóia;200;50;28;19;150;50
6625;0;Rubem Berta;Jardim Sabará;550;150;157;85;250;300
6626;0;Rubem Berta;Jardim São Pedro;200;50;80;48;50;150
6627;0;Rubem Berta;Jardim do Salso;100;0;58;30;0;100
6628;0;Rubem Berta;Lageado;0;0;0;0;0;0
6629;0;Rubem Berta;Lami;150;50;20;26;100;50
6630;0;Rubem Berta;Lomba do Pinheiro;657;100;233;65;250;407
6631;0;Rubem Berta;Medianeira;100;50;29;18;50;50
6632;0;Rubem Berta;Menino Deus;69;50;12;1;50;19
6633;0;Rubem Berta;Moinhos de Vento;50;50;0;0;50;0
6634;0;Rubem Berta;Mont'Serrat;53;0;29;14;0;53
6635;0;Rubem Berta;Morro Santana;1513;350;549;353;500;1013
6636;0;Rubem Berta;Mário Quintana;5609;700;2511;1093;1100;4509
6637;0;Rubem Berta;Navegantes;100;100;0;0;100;0
6638;0;Rubem Berta;Nonoai;205;0;51;28;100;105
6639;0;Rubem Berta;Parque Santa Fé;2150;550;843;516;650;1500
6640;0;Rubem Berta;Partenon;563;100;101;33;400;163
6641;0;Rubem Berta;Passo D'Areia;315;50;122;99;50;265
6642;0;Rubem Berta;Passo das Pedras;2013;400;630;474;700;1313
6643;0;Rubem Berta;Pedra Redonda;50;50;0;0;50;0
6644;0;Rubem Berta;Petrópolis;119;100;7;7;100;19
6645;0;Rubem Berta;Pitinga;50;50;0;0;50;0
6646;0;Rubem Berta;Ponta Grossa;250;50;94;81;50;200
6647;0;Rubem Berta;Praia de Belas;100;0;26;16;50;50
6648;0;Rubem Berta;Restinga;175;0;70;32;50;125
6649;0;Rubem Berta;Rio Branco;7;0;5;2;0;7
6650;0;Rubem Berta;Rubem Berta;25205;2600;10181;7888;4600;20605
6651;0;Rubem Berta;Santa Cecília;100;50;30;16;50;50
6652;0;Rubem Berta;Santa Maria Goretti;200;0;92;70;0;200
6653;0;Rubem Berta;Santa Rosa de Lima;4905;1950;595;241;3900;1005
6654;0;Rubem Berta;Santa Tereza;518;200;142;47;350;168
6655;0;Rubem Berta;Santana;205;50;52;32;100;105
6656;0;Rubem Berta;Santo Antônio;103;0;48;36;0;103
6657;0;Rubem Berta;Sarandi;1210;200;498;248;300;910
6658;0;Rubem Berta;Serraria;100;100;0;0;100;0
6659;0;Rubem Berta;São Caetano;0;0;0;0;0;0
6660;0;Rubem Berta;São Geraldo;50;0;31;13;0;50
6661;0;Rubem Berta;São José;107;50;34;13;50;57
6662;0;Rubem Berta;São João;150;100;25;20;100;50
6663;0;Rubem Berta;São Sebastião;700;250;203;105;400;300
6664;0;Rubem Berta;Sétimo Céu;100;50;24;17;50;50
6665;0;Rubem Berta;Teresópolis;100;0;34;9;50;50
6666;0;Rubem Berta;Tristeza;110;50;31;17;50;60
6667;0;Rubem Berta;Três Figueiras;0;0;0;0;0;0
6668;0;Rubem Berta;Vila Assunção;150;0;75;52;0;150
6669;0;Rubem Berta;Vila Conceição;150;0;76;53;0;150
6670;0;Rubem Berta;Vila Ipiranga;303;0;134;127;0;303
6671;0;Rubem Berta;Vila Jardim;108;50;55;3;100;8
6672;0;Rubem Berta;Vila João Pessoa;250;50;62;20;150;100
6673;0;Rubem Berta;Vila Nova;262;50;111;63;50;212
6674;0;Santa Cecília;Aberta dos Morros;50;0;31;14;0;50
6675;0;Santa Cecília;Agronomia;0;0;0;0;0;0
6676;0;Santa Cecília;Anchieta;0;0;0;0;0;0
6677;0;Santa Cecília;Arquipélago;100;50;34;4;50;50
6678;0;Santa Cecília;Auxiliadora;151;0;50;30;50;101
6679;0;Santa Cecília;Azenha;650;200;191;92;300;350
6680;0;Santa Cecília;Bela Vista;1101;50;555;219;200;901
6681;0;Santa Cecília;Belém Novo;50;0;0;0;50;0
6682;0;Santa Cecília;Belém Velho;56;0;28;10;0;56
6683;0;Santa Cecília;Boa Vista;50;0;35;5;0;50
6684;0;Santa Cecília;Boa Vista do Sul;50;50;0;0;50;0
6685;0;Santa Cecília;Bom Fim;800;250;258;82;500;300
6686;0;Santa Cecília;Bom Jesus;57;0;35;6;0;57
6687;0;Santa Cecília;Camaquã;101;0;56;28;0;101
6688;0;Santa Cecília;Campo Novo;150;100;35;12;100;50
6689;0;Santa Cecília;Cascata;50;50;0;0;50;0
6690;0;Santa Cecília;Cavalhada;157;0;87;34;0;157
6691;0;Santa Cecília;Cel. Aparício Borges;108;50;32;19;50;58
6692;0;Santa Cecília;Centro Histórico;505;100;126;60;250;255
6693;0;Santa Cecília;Chapéu do Sol;100;50;22;14;50;50
6694;0;Santa Cecília;Chácara das Pedras;200;50;80;51;50;150
6695;0;Santa Cecília;Cidade Baixa;451;50;105;58;250;201
6696;0;Santa Cecília;Costa e Silva;154;50;50;39;50;104
6697;0;Santa Cecília;Cristal;307;0;178;57;0;307
6698;0;Santa Cecília;Cristo Redentor;6;0;4;2;0;6
6699;0;Santa Cecília;Espírito Santo;0;0;0;0;0;0
6700;0;Santa Cecília;Extrema;0;0;0;0;0;0
6701;0;Santa Cecília;Farrapos;3153;791;1432;692;713;1072
6702;0;Santa Cecília;Farroupilha;250;100;24;13;200;50
6703;0;Santa Cecília;Floresta;50;0;26;12;0;50
6704;0;Santa Cecília;Glória;400;0;202;107;0;400
6705;0;Santa Cecília;Guarujá;0;0;0;0;0;0
6706;0;Santa Cecília;Higienópolis;1;0;1;0;0;1
6707;0;Santa Cecília;Humaitá;50;0;0;0;50;0
6708;0;Santa Cecília;Hípica;50;0;34;7;0;50
6709;0;Santa Cecília;Independência;100;0;49;32;0;100
6710;0;Santa Cecília;Ipanema;106;0;30;11;50;56
6711;0;Santa Cecília;Jardim Botânico;206;0;107;48;0;206
6712;0;Santa Cecília;Jardim Carvalho;101;0;58;15;0;101
6713;0;Santa Cecília;Jardim Europa;0;0;0;0;0;0
6714;0;Santa Cecília;Jardim Floresta;50;0;27;15;0;50
6715;0;Santa Cecília;Jardim Isabel;50;0;28;11;0;50
6716;0;Santa Cecília;Jardim Itú;100;100;0;0;100;0
6717;0;Santa Cecília;Jardim Leopoldina;6;0;4;0;0;6
6718;0;Santa Cecília;Jardim Lindóia;50;0;0;0;50;0
6719;0;Santa Cecília;Jardim Sabará;150;0;57;21;50;100
6720;0;Santa Cecília;Jardim São Pedro;0;0;0;0;0;0
6721;0;Santa Cecília;Jardim do Salso;50;0;27;14;0;50
6722;0;Santa Cecília;Lageado;50;0;0;0;50;0
6723;0;Santa Cecília;Lami;50;0;33;13;0;50
6724;0;Santa Cecília;Lomba do Pinheiro;103;50;26;12;50;53
6725;0;Santa Cecília;Medianeira;450;50;190;91;100;350
6726;0;Santa Cecília;Menino Deus;557;150;185;46;400;157
6727;0;Santa Cecília;Moinhos de Vento;500;50;186;150;100;400
6728;0;Santa Cecília;Mont'Serrat;150;0;63;24;50;100
6729;0;Santa Cecília;Morro Santana;56;0;35;13;0;56
6730;0;Santa Cecília;Mário Quintana;80;0;42;9;0;80
6731;0;Santa Cecília;Navegantes;50;50;0;0;50;0
6732;0;Santa Cecília;Nonoai;151;0;92;32;0;151
6733;0;Santa Cecília;Parque Santa Fé;50;0;34;6;0;50
6734;0;Santa Cecília;Partenon;907;0;478;206;50;857
6735;0;Santa Cecília;Passo D'Areia;158;0;1;3;150;8
6736;0;Santa Cecília;Passo das Pedras;7;0;4;0;0;7
6737;0;Santa Cecília;Pedra Redonda;50;0;36;11;0;50
6738;0;Santa Cecília;Petrópolis;808;50;406;153;200;608
6739;0;Santa Cecília;Pitinga;50;0;30;16;0;50
6740;0;Santa Cecília;Ponta Grossa;100;0;52;24;0;100
6741;0;Santa Cecília;Praia de Belas;50;0;27;10;0;50
6742;0;Santa Cecília;Restinga;206;0;89;24;50;156
6743;0;Santa Cecília;Rio Branco;2554;0;1331;729;100;2454
6744;0;Santa Cecília;Rubem Berta;101;50;30;16;50;51
6745;0;Santa Cecília;Santa Cecília;2600;1100;410;112;2200;400
6746;0;Santa Cecília;Santa Maria Goretti;0;0;0;0;0;0
6747;0;Santa Cecília;Santa Rosa de Lima;101;0;63;17;0;101
6748;0;Santa Cecília;Santa Tereza;706;200;87;27;550;156
6749;0;Santa Cecília;Santana;806;200;210;78;450;356
6750;0;Santa Cecília;Santo Antônio;401;0;109;57;200;201
6751;0;Santa Cecília;Sarandi;280;0;119;69;50;230
6752;0;Santa Cecília;Serraria;0;0;0;0;0;0
6753;0;Santa Cecília;São Caetano;0;0;0;0;0;0
6754;0;Santa Cecília;São Geraldo;200;50;73;48;50;150
6755;0;Santa Cecília;São José;105;0;37;6;50;55
6756;0;Santa Cecília;São João;250;0;95;39;150;100
6757;0;Santa Cecília;São Sebastião;0;0;0;0;0;0
6758;0;Santa Cecília;Sétimo Céu;0;0;0;0;0;0
6759;0;Santa Cecília;Teresópolis;200;0;91;37;50;150
6760;0;Santa Cecília;Tristeza;56;0;3;2;50;6
6761;0;Santa Cecília;Três Figueiras;100;0;57;30;0;100
6762;0;Santa Cecília;Vila Assunção;0;0;0;0;0;0
6763;0;Santa Cecília;Vila Conceição;0;0;0;0;0;0
6764;0;Santa Cecília;Vila Ipiranga;151;0;81;36;0;151
6765;0;Santa Cecília;Vila Jardim;254;50;114;57;50;204
6766;0;Santa Cecília;Vila João Pessoa;150;50;53;17;50;100
6767;0;Santa Cecília;Vila Nova;178;0;99;42;0;178
6768;0;Santa Maria Goretti;Aberta dos Morros;50;0;33;3;0;50
6769;0;Santa Maria Goretti;Agronomia;0;0;0;0;0;0
6770;0;Santa Maria Goretti;Anchieta;679;300;92;7;532;147
6771;0;Santa Maria Goretti;Arquipélago;0;0;0;0;0;0
6772;0;Santa Maria Goretti;Auxiliadora;58;0;37;9;0;58
6773;0;Santa Maria Goretti;Azenha;49;0;21;10;0;49
6774;0;Santa Maria Goretti;Bela Vista;8;0;4;1;0;8
6775;0;Santa Maria Goretti;Belém Novo;100;50;33;8;50;50
6776;0;Santa Maria Goretti;Belém Velho;69;0;50;6;0;69
6777;0;Santa Maria Goretti;Boa Vista;391;100;85;22;250;141
6778;0;Santa Maria Goretti;Boa Vista do Sul;50;0;32;4;0;50
6779;0;Santa Maria Goretti;Bom Fim;160;0;29;19;100;60
6780;0;Santa Maria Goretti;Bom Jesus;90;0;51;19;0;90
6781;0;Santa Maria Goretti;Camaquã;156;100;6;0;150;6
6782;0;Santa Maria Goretti;Campo Novo;0;0;0;0;0;0
6783;0;Santa Maria Goretti;Cascata;0;0;0;0;0;0
6784;0;Santa Maria Goretti;Cavalhada;109;0;58;23;0;109
6785;0;Santa Maria Goretti;Cel. Aparício Borges;94;50;21;6;50;44
6786;0;Santa Maria Goretti;Centro Histórico;143;50;26;7;100;43
6787;0;Santa Maria Goretti;Chapéu do Sol;50;0;29;0;0;50
6788;0;Santa Maria Goretti;Chácara das Pedras;50;50;0;0;50;0
6789;0;Santa Maria Goretti;Cidade Baixa;10;0;4;2;0;10
6790;0;Santa Maria Goretti;Costa e Silva;96;0;72;10;0;96
6791;0;Santa Maria Goretti;Cristal;124;0;86;13;50;74
6792;0;Santa Maria Goretti;Cristo Redentor;696;50;337;119;150;546
6793;0;Santa Maria Goretti;Espírito Santo;0;0;0;0;0;0
6794;0;Santa Maria Goretti;Extrema;0;0;0;0;0;0
6795;0;Santa Maria Goretti;Farrapos;6345;350;3220;1365;673;5672
6796;0;Santa Maria Goretti;Farroupilha;100;0;60;3;0;100
6797;0;Santa Maria Goretti;Floresta;112;0;47;4;50;62
6798;0;Santa Maria Goretti;Glória;51;0;32;2;0;51
6799;0;Santa Maria Goretti;Guarujá;0;0;0;0;0;0
6800;0;Santa Maria Goretti;Higienópolis;1052;600;131;26;850;202
6801;0;Santa Maria Goretti;Humaitá;75;50;17;2;50;25
6802;0;Santa Maria Goretti;Hípica;0;0;0;0;0;0
6803;0;Santa Maria Goretti;Independência;19;0;8;7;0;19
6804;0;Santa Maria Goretti;Ipanema;14;0;9;5;0;14
6805;0;Santa Maria Goretti;Jardim Botânico;48;0;32;8;0;48
6806;0;Santa Maria Goretti;Jardim Carvalho;161;50;59;13;50;111
6807;0;Santa Maria Goretti;Jardim Europa;50;50;0;0;50;0
6808;0;Santa Maria Goretti;Jardim Floresta;126;50;45;11;50;76
6809;0;Santa Maria Goretti;Jardim Isabel;0;0;0;0;0;0
6810;0;Santa Maria Goretti;Jardim Itú;284;50;110;32;100;184
6811;0;Santa Maria Goretti;Jardim Leopoldina;24;0;18;2;0;24
6812;0;Santa Maria Goretti;Jardim Lindóia;144;0;98;38;0;144
6813;0;Santa Maria Goretti;Jardim Sabará;50;0;0;0;50;0
6814;0;Santa Maria Goretti;Jardim São Pedro;1050;0;559;167;150;900
6815;0;Santa Maria Goretti;Jardim do Salso;0;0;0;0;0;0
6816;0;Santa Maria Goretti;Lageado;0;0;0;0;0;0
6817;0;Santa Maria Goretti;Lami;0;0;0;0;0;0
6818;0;Santa Maria Goretti;Lomba do Pinheiro;63;50;9;1;50;13
6819;0;Santa Maria Goretti;Medianeira;0;0;0;0;0;0
6820;0;Santa Maria Goretti;Menino Deus;160;0;95;35;0;160
6821;0;Santa Maria Goretti;Moinhos de Vento;36;0;17;6;0;36
6822;0;Santa Maria Goretti;Mont'Serrat;28;0;17;7;0;28
6823;0;Santa Maria Goretti;Morro Santana;214;50;106;15;50;164
6824;0;Santa Maria Goretti;Mário Quintana;340;100;78;12;200;140
6825;0;Santa Maria Goretti;Navegantes;100;0;50;0;100;0
6826;0;Santa Maria Goretti;Nonoai;9;0;5;2;0;9
6827;0;Santa Maria Goretti;Parque Santa Fé;50;50;0;0;50;0
6828;0;Santa Maria Goretti;Partenon;78;0;13;9;50;28
6829;0;Santa Maria Goretti;Passo D'Areia;1451;450;244;170;950;501
6830;0;Santa Maria Goretti;Passo das Pedras;30;0;22;3;0;30
6831;0;Santa Maria Goretti;Pedra Redonda;0;0;0;0;0;0
6832;0;Santa Maria Goretti;Petrópolis;217;0;55;32;100;117
6833;0;Santa Maria Goretti;Pitinga;0;0;0;0;0;0
6834;0;Santa Maria Goretti;Ponta Grossa;0;0;0;0;0;0
6835;0;Santa Maria Goretti;Praia de Belas;0;0;0;0;0;0
6836;0;Santa Maria Goretti;Restinga;81;0;43;14;0;81
6837;0;Santa Maria Goretti;Rio Branco;42;0;25;12;0;42
6838;0;Santa Maria Goretti;Rubem Berta;119;0;51;48;0;119
6839;0;Santa Maria Goretti;Santa Cecília;0;0;0;0;0;0
6840;0;Santa Maria Goretti;Santa Maria Goretti;1844;600;483;18;1300;544
6841;0;Santa Maria Goretti;Santa Rosa de Lima;154;50;2;1;150;4
6842;0;Santa Maria Goretti;Santa Tereza;327;150;48;14;250;77
6843;0;Santa Maria Goretti;Santana;149;50;25;13;100;49
6844;0;Santa Maria Goretti;Santo Antônio;4;0;4;0;0;4
6845;0;Santa Maria Goretti;Sarandi;274;50;102;45;100;174
6846;0;Santa Maria Goretti;Serraria;0;0;0;0;0;0
6847;0;Santa Maria Goretti;São Caetano;50;0;29;4;0;50
6848;0;Santa Maria Goretti;São Geraldo;100;0;68;1;0;100
6849;0;Santa Maria Goretti;São José;38;0;25;6;0;38
6850;0;Santa Maria Goretti;São João;244;0;55;13;150;94
6851;0;Santa Maria Goretti;São Sebastião;50;0;37;3;0;50
6852;0;Santa Maria Goretti;Sétimo Céu;0;0;0;0;0;0
6853;0;Santa Maria Goretti;Teresópolis;0;0;0;0;0;0
6854;0;Santa Maria Goretti;Tristeza;87;0;19;14;50;37
6855;0;Santa Maria Goretti;Três Figueiras;0;0;0;0;0;0
6856;0;Santa Maria Goretti;Vila Assunção;0;0;0;0;0;0
6857;0;Santa Maria Goretti;Vila Conceição;0;0;0;0;0;0
6858;0;Santa Maria Goretti;Vila Ipiranga;280;150;51;7;200;80
6859;0;Santa Maria Goretti;Vila Jardim;164;50;43;6;100;64
6860;0;Santa Maria Goretti;Vila João Pessoa;0;0;0;0;0;0
6861;0;Santa Maria Goretti;Vila Nova;235;50;113;31;50;185
6862;0;Santa Rosa de Lima;Aberta dos Morros;0;0;0;0;0;0
6863;0;Santa Rosa de Lima;Agronomia;150;50;50;0;150;0
6864;0;Santa Rosa de Lima;Anchieta;200;50;53;18;100;100
6865;0;Santa Rosa de Lima;Arquipélago;50;0;0;0;50;0
6866;0;Santa Rosa de Lima;Auxiliadora;200;0;83;25;50;150
6867;0;Santa Rosa de Lima;Azenha;50;0;25;10;0;50
6868;0;Santa Rosa de Lima;Bela Vista;203;0;126;35;0;203
6869;0;Santa Rosa de Lima;Belém Novo;100;0;28;7;50;50
6870;0;Santa Rosa de Lima;Belém Velho;207;50;98;19;50;157
6871;0;Santa Rosa de Lima;Boa Vista;400;150;155;32;150;250
6872;0;Santa Rosa de Lima;Boa Vista do Sul;50;50;0;0;50;0
6873;0;Santa Rosa de Lima;Bom Fim;150;100;31;4;100;50
6874;0;Santa Rosa de Lima;Bom Jesus;207;50;34;9;150;57
6875;0;Santa Rosa de Lima;Camaquã;100;50;25;7;50;50
6876;0;Santa Rosa de Lima;Campo Novo;0;0;0;0;0;0
6877;0;Santa Rosa de Lima;Cascata;200;0;73;25;50;150
6878;0;Santa Rosa de Lima;Cavalhada;106;0;53;16;0;106
6879;0;Santa Rosa de Lima;Cel. Aparício Borges;107;0;71;14;0;107
6880;0;Santa Rosa de Lima;Centro Histórico;7;0;2;3;0;7
6881;0;Santa Rosa de Lima;Chapéu do Sol;50;0;35;5;0;50
6882;0;Santa Rosa de Lima;Chácara das Pedras;150;0;83;30;0;150
6883;0;Santa Rosa de Lima;Cidade Baixa;53;0;32;11;0;53
6884;0;Santa Rosa de Lima;Costa e Silva;1706;700;500;158;850;856
6885;0;Santa Rosa de Lima;Cristal;56;0;36;7;0;56
6886;0;Santa Rosa de Lima;Cristo Redentor;256;50;132;30;100;156
6887;0;Santa Rosa de Lima;Espírito Santo;50;0;0;0;50;0
6888;0;Santa Rosa de Lima;Extrema;150;0;30;7;100;50
6889;0;Santa Rosa de Lima;Farrapos;100;0;64;15;0;100
6890;0;Santa Rosa de Lima;Farroupilha;100;0;54;18;0;100
6891;0;Santa Rosa de Lima;Floresta;100;50;34;6;50;50
6892;0;Santa Rosa de Lima;Glória;51;0;34;6;0;51
6893;0;Santa Rosa de Lima;Guarujá;150;0;89;19;0;150
6894;0;Santa Rosa de Lima;Higienópolis;202;50;99;25;50;152
6895;0;Santa Rosa de Lima;Humaitá;150;50;58;17;50;100
6896;0;Santa Rosa de Lima;Hípica;50;0;0;0;50;0
6897;0;Santa Rosa de Lima;Independência;50;0;35;6;0;50
6898;0;Santa Rosa de Lima;Ipanema;7;0;3;3;0;7
6899;0;Santa Rosa de Lima;Jardim Botânico;307;0;159;58;50;257
6900;0;Santa Rosa de Lima;Jardim Carvalho;200;50;101;23;50;150
6901;0;Santa Rosa de Lima;Jardim Europa;250;100;51;19;150;100
6902;0;Santa Rosa de Lima;Jardim Floresta;350;100;125;26;150;200
6903;0;Santa Rosa de Lima;Jardim Isabel;100;50;30;5;50;50
6904;0;Santa Rosa de Lima;Jardim Itú;501;50;236;74;100;401
6905;0;Santa Rosa de Lima;Jardim Leopoldina;1607;300;590;148;800;807
6906;0;Santa Rosa de Lima;Jardim Lindóia;1100;250;418;112;400;700
6907;0;Santa Rosa de Lima;Jardim Sabará;450;100;131;14;300;150
6908;0;Santa Rosa de Lima;Jardim São Pedro;200;50;53;22;100;100
6909;0;Santa Rosa de Lima;Jardim do Salso;150;0;55;10;50;100
6910;0;Santa Rosa de Lima;Lageado;0;0;0;0;0;0
6911;0;Santa Rosa de Lima;Lami;50;0;0;0;50;0
6912;0;Santa Rosa de Lima;Lomba do Pinheiro;204;50;93;20;50;154
6913;0;Santa Rosa de Lima;Medianeira;100;0;62;20;0;100
6914;0;Santa Rosa de Lima;Menino Deus;156;0;38;4;100;56
6915;0;Santa Rosa de Lima;Moinhos de Vento;100;0;49;39;0;100
6916;0;Santa Rosa de Lima;Mont'Serrat;101;0;37;9;50;51
6917;0;Santa Rosa de Lima;Morro Santana;255;100;94;25;100;155
6918;0;Santa Rosa de Lima;Mário Quintana;505;50;222;54;150;355
6919;0;Santa Rosa de Lima;Navegantes;200;50;56;19;100;100
6920;0;Santa Rosa de Lima;Nonoai;52;0;30;11;0;52
6921;0;Santa Rosa de Lima;Parque Santa Fé;7700;200;4250;1185;500;7200
6922;0;Santa Rosa de Lima;Partenon;706;100;291;104;200;506
6923;0;Santa Rosa de Lima;Passo D'Areia;407;0;257;65;0;407
6924;0;Santa Rosa de Lima;Passo das Pedras;1956;250;900;226;500;1456
6925;0;Santa Rosa de Lima;Pedra Redonda;50;0;29;9;0;50
6926;0;Santa Rosa de Lima;Petrópolis;157;50;64;29;50;107
6927;0;Santa Rosa de Lima;Pitinga;100;0;61;19;0;100
6928;0;Santa Rosa de Lima;Ponta Grossa;100;50;0;0;100;0
6929;0;Santa Rosa de Lima;Praia de Belas;50;0;27;14;0;50
6930;0;Santa Rosa de Lima;Restinga;306;50;140;54;50;256
6931;0;Santa Rosa de Lima;Rio Branco;106;0;5;0;100;6
6932;0;Santa Rosa de Lima;Rubem Berta;4901;1950;592;241;3900;1001
6933;0;Santa Rosa de Lima;Santa Cecília;100;0;63;17;0;100
6934;0;Santa Rosa de Lima;Santa Maria Goretti;150;50;0;0;150;0
6935;0;Santa Rosa de Lima;Santa Rosa de Lima;5701;400;2567;728;1400;4301
6936;0;Santa Rosa de Lima;Santa Tereza;506;150;167;42;200;306
6937;0;Santa Rosa de Lima;Santana;107;0;34;5;50;57
6938;0;Santa Rosa de Lima;Santo Antônio;0;0;0;0;0;0
6939;0;Santa Rosa de Lima;Sarandi;8256;750;3570;1418;2200;6056
6940;0;Santa Rosa de Lima;Serraria;50;0;28;11;0;50
6941;0;Santa Rosa de Lima;São Caetano;50;0;30;9;0;50
6942;0;Santa Rosa de Lima;São Geraldo;100;0;53;20;0;100
6943;0;Santa Rosa de Lima;São José;206;0;56;25;100;106
6944;0;Santa Rosa de Lima;São João;100;50;28;9;50;50
6945;0;Santa Rosa de Lima;São Sebastião;250;0;113;34;50;200
6946;0;Santa Rosa de Lima;Sétimo Céu;50;0;28;9;0;50
6947;0;Santa Rosa de Lima;Teresópolis;50;0;0;0;50;0
6948;0;Santa Rosa de Lima;Tristeza;157;0;92;33;0;157
6949;0;Santa Rosa de Lima;Três Figueiras;150;0;56;13;50;100
6950;0;Santa Rosa de Lima;Vila Assunção;100;0;62;11;0;100
6951;0;Santa Rosa de Lima;Vila Conceição;100;0;64;15;0;100
6952;0;Santa Rosa de Lima;Vila Ipiranga;300;50;122;37;100;200
6953;0;Santa Rosa de Lima;Vila Jardim;208;50;63;24;100;108
6954;0;Santa Rosa de Lima;Vila João Pessoa;150;50;25;9;100;50
6955;0;Santa Rosa de Lima;Vila Nova;256;50;109;46;50;206
6956;0;Santa Tereza;Aberta dos Morros;100;0;48;20;0;100
6957;0;Santa Tereza;Agronomia;200;0;98;27;50;150
6958;0;Santa Tereza;Anchieta;50;50;0;0;50;0
6959;0;Santa Tereza;Arquipélago;328;0;137;41;100;228
6960;0;Santa Tereza;Auxiliadora;207;0;122;32;0;207
6961;0;Santa Tereza;Azenha;2035;300;801;266;700;1335
6962;0;Santa Tereza;Bela Vista;151;0;92;30;0;151
6963;0;Santa Tereza;Belém Novo;200;0;84;29;50;150
6964;0;Santa Tereza;Belém Velho;105;0;59;24;0;105
6965;0;Santa Tereza;Boa Vista;207;0;133;33;0;207
6966;0;Santa Tereza;Boa Vista do Sul;300;100;78;39;150;150
6967;0;Santa Tereza;Bom Fim;100;0;30;13;50;50
6968;0;Santa Tereza;Bom Jesus;236;100;55;17;150;86
6969;0;Santa Tereza;Camaquã;320;200;73;20;200;120
6970;0;Santa Tereza;Campo Novo;150;100;31;10;100;50
6971;0;Santa Tereza;Cascata;200;100;30;6;150;50
6972;0;Santa Tereza;Cavalhada;1431;100;719;250;150;1281
6973;0;Santa Tereza;Cel. Aparício Borges;2124;0;1197;347;0;2124
6974;0;Santa Tereza;Centro Histórico;473;50;160;58;250;223
6975;0;Santa Tereza;Chapéu do Sol;350;100;134;27;200;150
6976;0;Santa Tereza;Chácara das Pedras;50;0;24;18;0;50
6977;0;Santa Tereza;Cidade Baixa;228;50;63;37;100;128
6978;0;Santa Tereza;Costa e Silva;211;0;37;12;150;61
6979;0;Santa Tereza;Cristal;2823;500;1138;423;800;2023
6980;0;Santa Tereza;Cristo Redentor;66;0;33;12;0;66
6981;0;Santa Tereza;Espírito Santo;100;0;60;18;0;100
6982;0;Santa Tereza;Extrema;200;50;88;23;50;150
6983;0;Santa Tereza;Farrapos;7617;0;4358;1638;50;7567
6984;0;Santa Tereza;Farroupilha;50;0;22;14;0;50
6985;0;Santa Tereza;Floresta;300;100;106;43;100;200
6986;0;Santa Tereza;Glória;583;200;220;37;300;283
6987;0;Santa Tereza;Guarujá;100;50;0;0;100;0
6988;0;Santa Tereza;Higienópolis;125;50;45;14;50;75
6989;0;Santa Tereza;Humaitá;100;50;27;2;50;50
6990;0;Santa Tereza;Hípica;0;0;0;0;0;0
6991;0;Santa Tereza;Independência;195;50;83;30;50;145
6992;0;Santa Tereza;Ipanema;463;50;66;25;350;113
6993;0;Santa Tereza;Jardim Botânico;360;100;142;41;100;260
6994;0;Santa Tereza;Jardim Carvalho;63;0;32;15;0;63
6995;0;Santa Tereza;Jardim Europa;63;0;28;17;0;63
6996;0;Santa Tereza;Jardim Floresta;50;0;27;7;0;50
6997;0;Santa Tereza;Jardim Isabel;200;50;63;12;100;100
6998;0;Santa Tereza;Jardim Itú;281;100;52;15;200;81
6999;0;Santa Tereza;Jardim Leopoldina;160;50;64;18;50;110
7000;0;Santa Tereza;Jardim Lindóia;150;0;104;28;50;100
7001;0;Santa Tereza;Jardim Sabará;120;50;40;14;50;70
7002;0;Santa Tereza;Jardim São Pedro;50;0;29;9;0;50
7003;0;Santa Tereza;Jardim do Salso;100;0;33;10;50;50
7004;0;Santa Tereza;Lageado;250;100;87;29;100;150
7005;0;Santa Tereza;Lami;150;0;61;14;50;100
7006;0;Santa Tereza;Lomba do Pinheiro;212;50;99;23;50;162
7007;0;Santa Tereza;Medianeira;5203;2250;796;182;4200;1003
7008;0;Santa Tereza;Menino Deus;2154;200;913;318;700;1454
7009;0;Santa Tereza;Moinhos de Vento;177;0;71;38;50;127
7010;0;Santa Tereza;Mont'Serrat;157;50;67;21;50;107
7011;0;Santa Tereza;Morro Santana;328;100;78;23;200;128
7012;0;Santa Tereza;Mário Quintana;194;50;98;12;100;94
7013;0;Santa Tereza;Navegantes;50;0;26;14;0;50
7014;0;Santa Tereza;Nonoai;5358;500;2750;890;600;4758
7015;0;Santa Tereza;Parque Santa Fé;76;0;41;13;0;76
7016;0;Santa Tereza;Partenon;466;50;192;51;150;316
7017;0;Santa Tereza;Passo D'Areia;168;100;6;6;150;18
7018;0;Santa Tereza;Passo das Pedras;65;0;37;15;0;65
7019;0;Santa Tereza;Pedra Redonda;100;0;31;10;50;50
7020;0;Santa Tereza;Petrópolis;318;0;121;55;100;218
7021;0;Santa Tereza;Pitinga;150;0;62;19;50;100
7022;0;Santa Tereza;Ponta Grossa;220;0;130;34;0;220
7023;0;Santa Tereza;Praia de Belas;596;200;143;54;350;246
7024;0;Santa Tereza;Restinga;186;50;81;17;50;136
7025;0;Santa Tereza;Rio Branco;305;0;145;61;50;255
7026;0;Santa Tereza;Rubem Berta;450;200;105;24;350;100
7027;0;Santa Tereza;Santa Cecília;700;200;83;27;550;150
7028;0;Santa Tereza;Santa Maria Goretti;350;150;64;17;250;100
7029;0;Santa Tereza;Santa Rosa de Lima;460;150;140;39;200;260
7030;0;Santa Tereza;Santa Tereza;6343;500;3022;937;1200;5143
7031;0;Santa Tereza;Santana;1443;650;246;62;1100;343
7032;0;Santa Tereza;Santo Antônio;618;250;179;44;400;218
7033;0;Santa Tereza;Sarandi;311;0;163;79;0;311
7034;0;Santa Tereza;Serraria;50;0;29;7;0;50
7035;0;Santa Tereza;São Caetano;300;0;161;70;0;300
7036;0;Santa Tereza;São Geraldo;100;50;28;9;50;50
7037;0;Santa Tereza;São José;72;50;11;5;50;22
7038;0;Santa Tereza;São João;150;50;61;21;50;100
7039;0;Santa Tereza;São Sebastião;100;0;59;14;0;100
7040;0;Santa Tereza;Sétimo Céu;150;0;89;35;0;150
7041;0;Santa Tereza;Teresópolis;993;300;335;85;500;493
7042;0;Santa Tereza;Tristeza;734;100;193;67;400;334
7043;0;Santa Tereza;Três Figueiras;300;100;55;14;200;100
7044;0;Santa Tereza;Vila Assunção;250;50;54;17;150;100
7045;0;Santa Tereza;Vila Conceição;100;0;64;16;0;100
7046;0;Santa Tereza;Vila Ipiranga;106;0;27;15;50;56
7047;0;Santa Tereza;Vila Jardim;285;50;105;39;100;185
7048;0;Santa Tereza;Vila João Pessoa;350;100;114;39;150;200
7049;0;Santa Tereza;Vila Nova;324;50;174;42;100;224
7050;0;Santana;Aberta dos Morros;150;100;29;17;100;50
7051;0;Santana;Agronomia;0;0;0;0;0;0
7052;0;Santana;Anchieta;0;0;0;0;0;0
7053;0;Santana;Arquipélago;0;0;0;0;0;0
7054;0;Santana;Auxiliadora;389;50;104;60;200;189
7055;0;Santana;Azenha;642;50;280;120;200;442
7056;0;Santana;Bela Vista;424;150;59;34;300;124
7057;0;Santana;Belém Novo;0;0;0;0;0;0
7058;0;Santana;Belém Velho;39;0;21;9;0;39
7059;0;Santana;Boa Vista;200;0;77;52;50;150
7060;0;Santana;Boa Vista do Sul;150;50;24;11;100;50
7061;0;Santana;Bom Fim;1198;200;399;231;398;800
7062;0;Santana;Bom Jesus;166;50;37;13;100;66
7063;0;Santana;Camaquã;155;0;104;0;150;5
7064;0;Santana;Campo Novo;50;0;28;19;0;50
7065;0;Santana;Cascata;223;0;126;19;100;123
7066;0;Santana;Cavalhada;268;0;125;22;150;118
7067;0;Santana;Cel. Aparício Borges;121;50;36;27;50;71
7068;0;Santana;Centro Histórico;541;0;146;72;250;291
7069;0;Santana;Chapéu do Sol;150;0;80;35;0;150
7070;0;Santana;Chácara das Pedras;150;0;83;43;0;150
7071;0;Santana;Cidade Baixa;5696;150;2919;1543;350;5346
7072;0;Santana;Costa e Silva;112;0;38;19;50;62
7073;0;Santana;Cristal;292;50;85;31;150;142
7074;0;Santana;Cristo Redentor;114;50;29;14;50;64
7075;0;Santana;Espírito Santo;152;0;59;38;50;102
7076;0;Santana;Extrema;0;0;0;0;0;0
7077;0;Santana;Farrapos;4589;0;2569;1127;0;4589
7078;0;Santana;Farroupilha;5150;1100;824;442;3700;1450
7079;0;Santana;Floresta;511;100;164;54;300;211
7080;0;Santana;Glória;150;0;27;12;100;50
7081;0;Santana;Guarujá;50;0;30;10;0;50
7082;0;Santana;Higienópolis;57;50;4;1;50;7
7083;0;Santana;Humaitá;200;50;79;42;50;150
7084;0;Santana;Hípica;100;0;26;10;50;50
7085;0;Santana;Independência;450;100;26;12;400;50
7086;0;Santana;Ipanema;114;0;52;30;0;114
7087;0;Santana;Jardim Botânico;190;0;100;60;0;190
7088;0;Santana;Jardim Carvalho;102;0;57;28;0;102
7089;0;Santana;Jardim Europa;100;50;24;24;50;50
7090;0;Santana;Jardim Floresta;100;0;56;27;0;100
7091;0;Santana;Jardim Isabel;50;50;0;0;50;0
7092;0;Santana;Jardim Itú;150;50;75;15;100;50
7093;0;Santana;Jardim Leopoldina;14;0;9;1;0;14
7094;0;Santana;Jardim Lindóia;50;0;29;18;0;50
7095;0;Santana;Jardim Sabará;19;0;10;5;0;19
7096;0;Santana;Jardim São Pedro;25;0;12;10;0;25
7097;0;Santana;Jardim do Salso;311;100;59;32;200;111
7098;0;Santana;Lageado;250;50;62;29;150;100
7099;0;Santana;Lami;100;0;39;32;0;100
7100;0;Santana;Lomba do Pinheiro;115;0;6;3;100;15
7101;0;Santana;Medianeira;625;150;177;96;300;325
7102;0;Santana;Menino Deus;932;150;397;177;330;602
7103;0;Santana;Moinhos de Vento;326;50;104;37;150;176
7104;0;Santana;Mont'Serrat;662;200;85;49;500;162
7105;0;Santana;Morro Santana;143;0;25;6;100;43
7106;0;Santana;Mário Quintana;205;50;66;26;100;105
7107;0;Santana;Navegantes;200;100;27;14;150;50
7108;0;Santana;Nonoai;279;100;90;19;200;79
7109;0;Santana;Parque Santa Fé;150;0;49;27;50;100
7110;0;Santana;Partenon;1295;300;350;139;700;595
7111;0;Santana;Passo D'Areia;119;0;38;19;50;69
7112;0;Santana;Passo das Pedras;91;50;24;5;50;41
7113;0;Santana;Pedra Redonda;100;0;0;0;100;0
7114;0;Santana;Petrópolis;787;200;260;109;400;387
7115;0;Santana;Pitinga;25;0;11;2;0;25
7116;0;Santana;Ponta Grossa;100;0;26;17;50;50
7117;0;Santana;Praia de Belas;350;0;171;75;50;300
7118;0;Santana;Restinga;202;0;61;19;100;102
7119;0;Santana;Rio Branco;431;150;123;56;200;231
7120;0;Santana;Rubem Berta;178;50;39;23;100;78
7121;0;Santana;Santa Cecília;694;200;148;53;450;244
7122;0;Santana;Santa Maria Goretti;150;50;22;19;100;50
7123;0;Santana;Santa Rosa de Lima;76;0;18;2;50;26
7124;0;Santana;Santa Tereza;1391;650;208;71;1100;291
7125;0;Santana;Santana;2408;200;1017;517;800;1608
7126;0;Santana;Santo Antônio;675;100;281;109;250;425
7127;0;Santana;Sarandi;96;0;48;28;0;96
7128;0;Santana;Serraria;100;0;54;18;0;100
7129;0;Santana;São Caetano;0;0;0;0;0;0
7130;0;Santana;São Geraldo;450;100;92;36;300;150
7131;0;Santana;São José;212;50;7;2;200;12
7132;0;Santana;São João;175;100;45;21;100;75
7133;0;Santana;São Sebastião;150;50;24;15;100;50
7134;0;Santana;Sétimo Céu;50;0;0;0;50;0
7135;0;Santana;Teresópolis;179;50;99;19;100;79
7136;0;Santana;Tristeza;116;0;38;20;50;66
7137;0;Santana;Três Figueiras;319;150;65;30;200;119
7138;0;Santana;Vila Assunção;100;100;0;0;100;0
7139;0;Santana;Vila Conceição;0;0;0;0;0;0
7140;0;Santana;Vila Ipiranga;203;0;112;24;100;103
7141;0;Santana;Vila Jardim;63;0;37;23;0;63
7142;0;Santana;Vila João Pessoa;230;50;75;33;100;130
7143;0;Santana;Vila Nova;259;100;37;8;200;59
7144;0;Santo Antônio;Aberta dos Morros;119;0;67;26;0;119
7145;0;Santo Antônio;Agronomia;200;0;95;28;50;150
7146;0;Santo Antônio;Anchieta;0;0;0;0;0;0
7147;0;Santo Antônio;Arquipélago;69;0;9;5;50;19
7148;0;Santo Antônio;Auxiliadora;102;0;29;15;50;52
7149;0;Santo Antônio;Azenha;1480;400;438;147;850;630
7150;0;Santo Antônio;Bela Vista;213;0;69;28;100;113
7151;0;Santo Antônio;Belém Novo;0;0;0;0;0;0
7152;0;Santo Antônio;Belém Velho;107;0;38;16;50;57
7153;0;Santo Antônio;Boa Vista;0;0;0;0;0;0
7154;0;Santo Antônio;Boa Vista do Sul;0;0;0;0;0;0
7155;0;Santo Antônio;Bom Fim;229;50;19;8;200;29
7156;0;Santo Antônio;Bom Jesus;87;50;21;6;50;37
7157;0;Santo Antônio;Camaquã;100;0;0;0;100;0
7158;0;Santo Antônio;Campo Novo;61;0;34;16;0;61
7159;0;Santo Antônio;Cascata;193;50;23;6;150;43
7160;0;Santo Antônio;Cavalhada;274;50;97;46;100;174
7161;0;Santo Antônio;Cel. Aparício Borges;255;0;113;49;50;205
7162;0;Santo Antônio;Centro Histórico;222;100;34;22;150;72
7163;0;Santo Antônio;Chapéu do Sol;0;0;0;0;0;0
7164;0;Santo Antônio;Chácara das Pedras;50;0;23;11;0;50
7165;0;Santo Antônio;Cidade Baixa;502;200;30;14;450;52
7166;0;Santo Antônio;Costa e Silva;75;50;20;1;50;25
7167;0;Santo Antônio;Cristal;148;100;28;8;100;48
7168;0;Santo Antônio;Cristo Redentor;23;0;12;5;0;23
7169;0;Santo Antônio;Espírito Santo;0;0;0;0;0;0
7170;0;Santo Antônio;Extrema;0;0;0;0;0;0
7171;0;Santo Antônio;Farrapos;9948;2284;4519;1901;1755;5072
7172;0;Santo Antônio;Farroupilha;50;0;29;13;0;50
7173;0;Santo Antônio;Floresta;199;0;96;34;50;149
7174;0;Santo Antônio;Glória;326;50;74;29;200;126
7175;0;Santo Antônio;Guarujá;0;0;0;0;0;0
7176;0;Santo Antônio;Higienópolis;100;50;35;9;50;50
7177;0;Santo Antônio;Humaitá;150;50;60;22;50;100
7178;0;Santo Antônio;Hípica;262;0;144;64;0;262
7179;0;Santo Antônio;Independência;69;0;59;8;50;19
7180;0;Santo Antônio;Ipanema;76;0;44;15;0;76
7181;0;Santo Antônio;Jardim Botânico;242;100;80;30;100;142
7182;0;Santo Antônio;Jardim Carvalho;376;150;48;33;250;126
7183;0;Santo Antônio;Jardim Europa;100;50;23;16;50;50
7184;0;Santo Antônio;Jardim Floresta;50;50;0;0;50;0
7185;0;Santo Antônio;Jardim Isabel;0;0;0;0;0;0
7186;0;Santo Antônio;Jardim Itú;50;0;33;8;0;50
7187;0;Santo Antônio;Jardim Leopoldina;107;50;5;1;100;7
7188;0;Santo Antônio;Jardim Lindóia;50;0;30;14;0;50
7189;0;Santo Antônio;Jardim Sabará;11;0;9;2;0;11
7190;0;Santo Antônio;Jardim São Pedro;50;0;23;12;0;50
7191;0;Santo Antônio;Jardim do Salso;100;50;28;10;50;50
7192;0;Santo Antônio;Lageado;50;50;0;0;50;0
7193;0;Santo Antônio;Lami;0;0;0;0;0;0
7194;0;Santo Antônio;Lomba do Pinheiro;67;0;31;22;0;67
7195;0;Santo Antônio;Medianeira;1975;800;475;209;1150;825
7196;0;Santo Antônio;Menino Deus;494;100;95;56;300;194
7197;0;Santo Antônio;Moinhos de Vento;100;50;28;19;50;50
7198;0;Santo Antônio;Mont'Serrat;120;50;10;5;100;20
7199;0;Santo Antônio;Morro Santana;63;0;33;15;0;63
7200;0;Santo Antônio;Mário Quintana;105;0;66;14;0;105
7201;0;Santo Antônio;Navegantes;50;0;50;0;50;0
7202;0;Santo Antônio;Nonoai;527;100;266;86;150;377
7203;0;Santo Antônio;Parque Santa Fé;50;0;33;9;0;50
7204;0;Santo Antônio;Partenon;3932;300;1934;805;450;3482
7205;0;Santo Antônio;Passo D'Areia;64;0;5;4;50;14
7206;0;Santo Antônio;Passo das Pedras;14;0;8;1;0;14
7207;0;Santo Antônio;Pedra Redonda;0;0;0;0;0;0
7208;0;Santo Antônio;Petrópolis;412;0;237;107;0;412
7209;0;Santo Antônio;Pitinga;0;0;0;0;0;0
7210;0;Santo Antônio;Ponta Grossa;100;50;0;0;100;0
7211;0;Santo Antônio;Praia de Belas;119;50;42;11;50;69
7212;0;Santo Antônio;Restinga;157;50;59;17;50;107
7213;0;Santo Antônio;Rio Branco;398;0;133;39;250;148
7214;0;Santo Antônio;Rubem Berta;36;0;11;17;0;36
7215;0;Santo Antônio;Santa Cecília;361;0;87;43;200;161
7216;0;Santo Antônio;Santa Maria Goretti;0;0;0;0;0;0
7217;0;Santo Antônio;Santa Rosa de Lima;0;0;0;0;0;0
7218;0;Santo Antônio;Santa Tereza;568;250;155;33;400;168
7219;0;Santo Antônio;Santana;834;100;381;147;250;584
7220;0;Santo Antônio;Santo Antônio;1761;700;361;106;1300;461
7221;0;Santo Antônio;Sarandi;350;50;130;64;100;250
7222;0;Santo Antônio;Serraria;0;0;0;0;0;0
7223;0;Santo Antônio;São Caetano;100;0;26;10;50;50
7224;0;Santo Antônio;São Geraldo;0;0;0;0;0;0
7225;0;Santo Antônio;São José;206;50;59;20;100;106
7226;0;Santo Antônio;São João;175;0;13;4;150;25
7227;0;Santo Antônio;São Sebastião;75;0;43;16;0;75
7228;0;Santo Antônio;Sétimo Céu;0;0;0;0;0;0
7229;0;Santo Antônio;Teresópolis;250;50;83;39;100;150
7230;0;Santo Antônio;Tristeza;181;50;46;25;100;81
7231;0;Santo Antônio;Três Figueiras;111;0;29;17;50;61
7232;0;Santo Antônio;Vila Assunção;0;0;0;0;0;0
7233;0;Santo Antônio;Vila Conceição;0;0;0;0;0;0
7234;0;Santo Antônio;Vila Ipiranga;44;0;31;9;0;44
7235;0;Santo Antônio;Vila Jardim;4;0;3;1;0;4
7236;0;Santo Antônio;Vila João Pessoa;201;100;1;0;200;1
7237;0;Santo Antônio;Vila Nova;167;50;66;33;50;117
7238;0;Sarandi;Aberta dos Morros;200;0;55;25;100;100
7239;0;Sarandi;Agronomia;100;0;36;12;50;50
7240;0;Sarandi;Anchieta;1600;0;873;436;50;1550
7241;0;Sarandi;Arquipélago;250;0;110;47;50;200
7242;0;Sarandi;Auxiliadora;101;50;0;0;100;1
7243;0;Sarandi;Azenha;300;50;121;50;100;200
7244;0;Sarandi;Bela Vista;102;0;49;26;0;102
7245;0;Sarandi;Belém Novo;100;50;27;14;50;50
7246;0;Sarandi;Belém Velho;110;0;64;19;0;110
7247;0;Sarandi;Boa Vista;250;50;114;65;50;200
7248;0;Sarandi;Boa Vista do Sul;450;0;170;70;150;300
7249;0;Sarandi;Bom Fim;300;50;150;64;50;250
7250;0;Sarandi;Bom Jesus;411;0;169;75;100;311
7251;0;Sarandi;Camaquã;302;0;167;81;0;302
7252;0;Sarandi;Campo Novo;600;0;282;122;100;500
7253;0;Sarandi;Cascata;250;100;51;26;150;100
7254;0;Sarandi;Cavalhada;565;0;265;104;100;465
7255;0;Sarandi;Cel. Aparício Borges;65;0;39;16;0;65
7256;0;Sarandi;Centro Histórico;209;0;62;32;100;109
7257;0;Sarandi;Chapéu do Sol;100;0;59;25;0;100
7258;0;Sarandi;Chácara das Pedras;400;100;105;54;200;200
7259;0;Sarandi;Cidade Baixa;301;0;120;47;100;201
7260;0;Sarandi;Costa e Silva;1460;250;561;202;500;960
7261;0;Sarandi;Cristal;313;0;143;62;50;263
7262;0;Sarandi;Cristo Redentor;415;0;199;99;50;365
7263;0;Sarandi;Espírito Santo;100;0;55;26;0;100
7264;0;Sarandi;Extrema;150;50;49;34;50;100
7265;0;Sarandi;Farrapos;22797;4957;9834;4984;5319;9822
7266;0;Sarandi;Farroupilha;250;0;105;56;50;200
7267;0;Sarandi;Floresta;200;50;84;41;50;150
7268;0;Sarandi;Glória;550;50;219;106;150;400
7269;0;Sarandi;Guarujá;150;0;52;30;50;100
7270;0;Sarandi;Higienópolis;350;0;196;82;0;350
7271;0;Sarandi;Humaitá;500;0;200;95;150;350
7272;0;Sarandi;Hípica;100;50;35;6;50;50
7273;0;Sarandi;Independência;400;150;76;47;250;150
7274;0;Sarandi;Ipanema;158;0;86;49;0;158
7275;0;Sarandi;Jardim Botânico;210;0;114;59;0;210
7276;0;Sarandi;Jardim Carvalho;301;50;51;29;200;101
7277;0;Sarandi;Jardim Europa;950;50;450;228;100;850
7278;0;Sarandi;Jardim Floresta;700;50;206;88;400;300
7279;0;Sarandi;Jardim Isabel;100;50;26;14;50;50
7280;0;Sarandi;Jardim Itú;600;100;267;141;100;500
7281;0;Sarandi;Jardim Leopoldina;510;50;178;97;150;360
7282;0;Sarandi;Jardim Lindóia;1400;200;505;252;450;950
7283;0;Sarandi;Jardim Sabará;350;50;153;84;50;300
7284;0;Sarandi;Jardim São Pedro;550;150;216;83;150;400
7285;0;Sarandi;Jardim do Salso;100;0;55;28;0;100
7286;0;Sarandi;Lageado;50;0;0;0;50;0
7287;0;Sarandi;Lami;150;0;82;10;100;50
7288;0;Sarandi;Lomba do Pinheiro;308;50;61;20;200;108
7289;0;Sarandi;Medianeira;200;50;29;14;150;50
7290;0;Sarandi;Menino Deus;364;0;191;94;0;364
7291;0;Sarandi;Moinhos de Vento;50;0;29;14;0;50
7292;0;Sarandi;Mont'Serrat;150;100;0;0;150;0
7293;0;Sarandi;Morro Santana;214;0;108;38;100;114
7294;0;Sarandi;Mário Quintana;299;50;98;37;100;199
7295;0;Sarandi;Navegantes;50;50;0;0;50;0
7296;0;Sarandi;Nonoai;601;50;215;123;200;401
7297;0;Sarandi;Parque Santa Fé;1300;200;547;269;300;1000
7298;0;Sarandi;Partenon;411;50;152;72;150;261
7299;0;Sarandi;Passo D'Areia;565;0;218;137;100;465
7300;0;Sarandi;Passo das Pedras;562;100;113;49;350;212
7301;0;Sarandi;Pedra Redonda;50;0;29;13;0;50
7302;0;Sarandi;Petrópolis;365;100;9;4;350;15
7303;0;Sarandi;Pitinga;50;0;27;9;0;50
7304;0;Sarandi;Ponta Grossa;50;0;0;0;50;0
7305;0;Sarandi;Praia de Belas;250;0;115;52;50;200
7306;0;Sarandi;Restinga;315;0;173;53;0;315
7307;0;Sarandi;Rio Branco;259;0;128;84;0;259
7308;0;Sarandi;Rubem Berta;1152;200;466;235;300;852
7309;0;Sarandi;Santa Cecília;250;0;99;63;50;200
7310;0;Sarandi;Santa Maria Goretti;450;50;189;82;100;350
7311;0;Sarandi;Santa Rosa de Lima;8250;750;3567;1415;2200;6050
7312;0;Sarandi;Santa Tereza;465;0;247;115;0;465
7313;0;Sarandi;Santana;210;0;109;60;0;210
7314;0;Sarandi;Santo Antônio;350;50;137;59;100;250
7315;0;Sarandi;Sarandi;11149;3500;2714;1145;7200;3949
7316;0;Sarandi;Serraria;150;50;29;14;100;50
7317;0;Sarandi;São Caetano;200;50;66;45;50;150
7318;0;Sarandi;São Geraldo;350;0;126;43;200;150
7319;0;Sarandi;São José;208;0;57;26;100;108
7320;0;Sarandi;São João;250;50;50;0;250;0
7321;0;Sarandi;São Sebastião;900;50;417;190;150;750
7322;0;Sarandi;Sétimo Céu;250;200;0;0;250;0
7323;0;Sarandi;Teresópolis;200;50;53;33;100;100
7324;0;Sarandi;Tristeza;110;0;63;31;0;110
7325;0;Sarandi;Três Figueiras;300;100;111;59;100;200
7326;0;Sarandi;Vila Assunção;50;0;25;14;0;50
7327;0;Sarandi;Vila Conceição;50;0;33;10;0;50
7328;0;Sarandi;Vila Ipiranga;200;50;53;28;100;100
7329;0;Sarandi;Vila Jardim;559;100;175;89;250;309
7330;0;Sarandi;Vila João Pessoa;50;0;25;14;0;50
7331;0;Sarandi;Vila Nova;451;50;190;85;100;351
7332;0;Serraria;Aberta dos Morros;450;150;92;29;300;150
7333;0;Serraria;Agronomia;50;0;34;12;0;50
7334;0;Serraria;Anchieta;0;0;0;0;0;0
7335;0;Serraria;Arquipélago;100;50;23;8;50;50
7336;0;Serraria;Auxiliadora;2;0;0;0;0;2
7337;0;Serraria;Azenha;0;0;0;0;0;0
7338;0;Serraria;Bela Vista;3;0;2;0;0;3
7339;0;Serraria;Belém Novo;250;50;94;27;100;150
7340;0;Serraria;Belém Velho;104;0;71;15;0;104
7341;0;Serraria;Boa Vista;50;50;0;0;50;0
7342;0;Serraria;Boa Vista do Sul;50;50;0;0;50;0
7343;0;Serraria;Bom Fim;0;0;0;0;0;0
7344;0;Serraria;Bom Jesus;57;0;45;11;0;57
7345;0;Serraria;Camaquã;204;0;83;31;50;154
7346;0;Serraria;Campo Novo;400;100;117;44;200;200
7347;0;Serraria;Cascata;0;0;0;0;0;0
7348;0;Serraria;Cavalhada;615;150;270;85;150;465
7349;0;Serraria;Cel. Aparício Borges;117;0;65;20;0;117
7350;0;Serraria;Centro Histórico;4;0;1;3;0;4
7351;0;Serraria;Chapéu do Sol;150;0;64;19;50;100
7352;0;Serraria;Chácara das Pedras;0;0;0;0;0;0
7353;0;Serraria;Cidade Baixa;3;0;2;0;0;3
7354;0;Serraria;Costa e Silva;157;0;57;16;50;107
7355;0;Serraria;Cristal;218;0;134;42;0;218
7356;0;Serraria;Cristo Redentor;58;0;33;9;0;58
7357;0;Serraria;Espírito Santo;1250;300;391;139;600;650
7358;0;Serraria;Extrema;0;0;0;0;0;0
7359;0;Serraria;Farrapos;100;0;71;14;0;100
7360;0;Serraria;Farroupilha;0;0;0;0;0;0
7361;0;Serraria;Floresta;50;0;0;0;50;0
7362;0;Serraria;Glória;252;0;55;22;150;102
7363;0;Serraria;Guarujá;1350;550;301;90;850;500
7364;0;Serraria;Higienópolis;51;0;32;15;0;51
7365;0;Serraria;Humaitá;0;0;0;0;0;0
7366;0;Serraria;Hípica;500;0;223;63;150;350
7367;0;Serraria;Independência;100;50;34;6;50;50
7368;0;Serraria;Ipanema;703;100;278;97;200;503
7369;0;Serraria;Jardim Botânico;57;0;32;16;0;57
7370;0;Serraria;Jardim Carvalho;152;50;34;5;100;52
7371;0;Serraria;Jardim Europa;0;0;0;0;0;0
7372;0;Serraria;Jardim Floresta;0;0;0;0;0;0
7373;0;Serraria;Jardim Isabel;0;0;0;0;0;0
7374;0;Serraria;Jardim Itú;151;50;74;18;50;101
7375;0;Serraria;Jardim Leopoldina;54;0;33;6;0;54
7376;0;Serraria;Jardim Lindóia;0;0;0;0;0;0
7377;0;Serraria;Jardim Sabará;0;0;0;0;0;0
7378;0;Serraria;Jardim São Pedro;0;0;0;0;0;0
7379;0;Serraria;Jardim do Salso;0;0;0;0;0;0
7380;0;Serraria;Lageado;50;0;31;13;0;50
7381;0;Serraria;Lami;0;0;0;0;0;0
7382;0;Serraria;Lomba do Pinheiro;53;0;32;10;0;53
7383;0;Serraria;Medianeira;150;0;93;31;0;150
7384;0;Serraria;Menino Deus;118;0;42;14;50;68
7385;0;Serraria;Moinhos de Vento;50;50;0;0;50;0
7386;0;Serraria;Mont'Serrat;0;0;0;0;0;0
7387;0;Serraria;Morro Santana;8;0;6;1;0;8
7388;0;Serraria;Mário Quintana;67;0;38;10;0;67
7389;0;Serraria;Navegantes;100;0;50;17;0;100
7390;0;Serraria;Nonoai;53;50;1;2;50;3
7391;0;Serraria;Parque Santa Fé;0;0;0;0;0;0
7392;0;Serraria;Partenon;358;50;103;39;150;208
7393;0;Serraria;Passo D'Areia;64;0;16;29;0;64
7394;0;Serraria;Passo das Pedras;58;0;37;9;0;58
7395;0;Serraria;Pedra Redonda;100;0;58;21;0;100
7396;0;Serraria;Petrópolis;167;100;42;22;100;67
7397;0;Serraria;Pitinga;0;0;0;0;0;0
7398;0;Serraria;Ponta Grossa;1100;200;438;100;400;700
7399;0;Serraria;Praia de Belas;0;0;0;0;0;0
7400;0;Serraria;Restinga;214;0;132;29;0;214
7401;0;Serraria;Rio Branco;3;0;1;2;0;3
7402;0;Serraria;Rubem Berta;103;100;2;0;100;3
7403;0;Serraria;Santa Cecília;0;0;0;0;0;0
7404;0;Serraria;Santa Maria Goretti;0;0;0;0;0;0
7405;0;Serraria;Santa Rosa de Lima;51;0;29;11;0;51
7406;0;Serraria;Santa Tereza;66;0;39;11;0;66
7407;0;Serraria;Santana;106;0;59;18;0;106
7408;0;Serraria;Santo Antônio;0;0;0;0;0;0
7409;0;Serraria;Sarandi;164;50;38;18;100;64
7410;0;Serraria;Serraria;3094;1000;590;170;2194;900
7411;0;Serraria;São Caetano;0;0;0;0;0;0
7412;0;Serraria;São Geraldo;50;0;20;15;0;50
7413;0;Serraria;São José;55;0;32;8;0;55
7414;0;Serraria;São João;50;0;29;16;0;50
7415;0;Serraria;São Sebastião;50;0;0;0;50;0
7416;0;Serraria;Sétimo Céu;100;0;55;25;0;100
7417;0;Serraria;Teresópolis;100;0;58;22;0;100
7418;0;Serraria;Tristeza;157;0;53;22;50;107
7419;0;Serraria;Três Figueiras;50;0;33;14;0;50
7420;0;Serraria;Vila Assunção;100;50;27;18;50;50
7421;0;Serraria;Vila Conceição;100;50;19;19;50;50
7422;0;Serraria;Vila Ipiranga;50;50;0;0;50;0
7423;0;Serraria;Vila Jardim;5;0;1;2;0;5
7424;0;Serraria;Vila João Pessoa;100;0;28;6;50;50
7425;0;Serraria;Vila Nova;264;0;138;63;0;264
7426;0;São Caetano;Aberta dos Morros;0;0;0;0;0;0
7427;0;São Caetano;Agronomia;50;0;33;9;0;50
7428;0;São Caetano;Anchieta;50;0;0;0;50;0
7429;0;São Caetano;Arquipélago;0;0;0;0;0;0
7430;0;São Caetano;Auxiliadora;0;0;0;0;0;0
7431;0;São Caetano;Azenha;28;0;14;7;0;28
7432;0;São Caetano;Bela Vista;50;50;0;0;50;0
7433;0;São Caetano;Belém Novo;170;50;9;7;150;20
7434;0;São Caetano;Belém Velho;0;0;0;0;0;0
7435;0;São Caetano;Boa Vista;0;0;0;0;0;0
7436;0;São Caetano;Boa Vista do Sul;87;0;56;17;0;87
7437;0;São Caetano;Bom Fim;0;0;0;0;0;0
7438;0;São Caetano;Bom Jesus;151;100;51;0;150;1
7439;0;São Caetano;Camaquã;101;0;30;11;50;51
7440;0;São Caetano;Campo Novo;0;0;0;0;0;0
7441;0;São Caetano;Cascata;0;0;0;0;0;0
7442;0;São Caetano;Cavalhada;2;0;1;1;0;2
7443;0;São Caetano;Cel. Aparício Borges;52;0;0;1;50;2
7444;0;São Caetano;Centro Histórico;148;0;78;41;0;148
7445;0;São Caetano;Chapéu do Sol;100;50;0;0;100;0
7446;0;São Caetano;Chácara das Pedras;0;0;0;0;0;0
7447;0;São Caetano;Cidade Baixa;50;0;26;11;0;50
7448;0;São Caetano;Costa e Silva;0;0;0;0;0;0
7449;0;São Caetano;Cristal;235;150;46;21;150;85
7450;0;São Caetano;Cristo Redentor;28;0;18;7;0;28
7451;0;São Caetano;Espírito Santo;0;0;0;0;0;0
7452;0;São Caetano;Extrema;70;0;48;14;0;70
7453;0;São Caetano;Farrapos;2773;215;1428;515;146;2448
7454;0;São Caetano;Farroupilha;0;0;0;0;0;0
7455;0;São Caetano;Floresta;50;50;0;0;50;0
7456;0;São Caetano;Glória;0;0;0;0;0;0
7457;0;São Caetano;Guarujá;0;0;0;0;0;0
7458;0;São Caetano;Higienópolis;0;0;0;0;0;0
7459;0;São Caetano;Humaitá;70;0;46;17;0;70
7460;0;São Caetano;Hípica;0;0;0;0;0;0
7461;0;São Caetano;Independência;50;0;0;0;50;0
7462;0;São Caetano;Ipanema;0;0;0;0;0;0
7463;0;São Caetano;Jardim Botânico;0;0;0;0;0;0
7464;0;São Caetano;Jardim Carvalho;70;50;12;7;50;20
7465;0;São Caetano;Jardim Europa;0;0;0;0;0;0
7466;0;São Caetano;Jardim Floresta;0;0;0;0;0;0
7467;0;São Caetano;Jardim Isabel;0;0;0;0;0;0
7468;0;São Caetano;Jardim Itú;100;100;0;0;100;0
7469;0;São Caetano;Jardim Leopoldina;0;0;0;0;0;0
7470;0;São Caetano;Jardim Lindóia;0;0;0;0;0;0
7471;0;São Caetano;Jardim Sabará;26;0;10;7;0;26
7472;0;São Caetano;Jardim São Pedro;50;0;36;11;0;50
7473;0;São Caetano;Jardim do Salso;50;0;37;7;0;50
7474;0;São Caetano;Lageado;1260;450;191;47;950;310
7475;0;São Caetano;Lami;425;150;139;35;200;225
7476;0;São Caetano;Lomba do Pinheiro;26;0;13;6;0;26
7477;0;São Caetano;Medianeira;51;0;18;15;0;51
7478;0;São Caetano;Menino Deus;2;0;2;0;0;2
7479;0;São Caetano;Moinhos de Vento;50;0;0;0;50;0
7480;0;São Caetano;Mont'Serrat;26;0;14;6;0;26
7481;0;São Caetano;Morro Santana;5;0;1;3;0;5
7482;0;São Caetano;Mário Quintana;40;0;25;5;0;40
7483;0;São Caetano;Navegantes;0;0;0;0;0;0
7484;0;São Caetano;Nonoai;151;0;90;35;0;151
7485;0;São Caetano;Parque Santa Fé;0;0;0;0;0;0
7486;0;São Caetano;Partenon;333;50;42;24;250;83
7487;0;São Caetano;Passo D'Areia;2;0;0;0;0;2
7488;0;São Caetano;Passo das Pedras;2;0;0;1;0;2
7489;0;São Caetano;Pedra Redonda;0;0;0;0;0;0
7490;0;São Caetano;Petrópolis;2;0;1;1;0;2
7491;0;São Caetano;Pitinga;50;0;0;0;50;0
7492;0;São Caetano;Ponta Grossa;20;0;10;5;0;20
7493;0;São Caetano;Praia de Belas;0;0;0;0;0;0
7494;0;São Caetano;Restinga;55;0;34;6;0;55
7495;0;São Caetano;Rio Branco;50;50;0;0;50;0
7496;0;São Caetano;Rubem Berta;0;0;0;0;0;0
7497;0;São Caetano;Santa Cecília;0;0;0;0;0;0
7498;0;São Caetano;Santa Maria Goretti;26;0;16;1;0;26
7499;0;São Caetano;Santa Rosa de Lima;26;0;17;6;0;26
7500;0;São Caetano;Santa Tereza;66;0;39;17;0;66
7501;0;São Caetano;Santana;0;0;0;0;0;0
7502;0;São Caetano;Santo Antônio;76;0;11;8;50;26
7503;0;São Caetano;Sarandi;148;50;47;27;50;98
7504;0;São Caetano;Serraria;0;0;0;0;0;0
7505;0;São Caetano;São Caetano;276;100;45;19;200;76
7506;0;São Caetano;São Geraldo;28;0;12;7;0;28
7507;0;São Caetano;São José;212;150;38;10;150;62
7508;0;São Caetano;São João;62;50;6;5;50;12
7509;0;São Caetano;São Sebastião;0;0;0;0;0;0
7510;0;São Caetano;Sétimo Céu;0;0;0;0;0;0
7511;0;São Caetano;Teresópolis;100;100;0;0;100;0
7512;0;São Caetano;Tristeza;1;0;1;0;0;1
7513;0;São Caetano;Três Figueiras;0;0;0;0;0;0
7514;0;São Caetano;Vila Assunção;0;0;0;0;0;0
7515;0;São Caetano;Vila Conceição;50;0;38;10;0;50
7516;0;São Caetano;Vila Ipiranga;50;0;0;0;50;0
7517;0;São Caetano;Vila Jardim;0;0;0;0;0;0
7518;0;São Caetano;Vila João Pessoa;20;0;11;2;0;20
7519;0;São Caetano;Vila Nova;70;0;13;3;50;20
7520;0;São Geraldo;Aberta dos Morros;50;50;0;0;50;0
7521;0;São Geraldo;Agronomia;100;50;28;14;50;50
7522;0;São Geraldo;Anchieta;100;0;31;8;50;50
7523;0;São Geraldo;Arquipélago;0;0;0;0;0;0
7524;0;São Geraldo;Auxiliadora;470;50;171;70;250;220
7525;0;São Geraldo;Azenha;0;0;0;0;0;0
7526;0;São Geraldo;Bela Vista;326;0;160;69;50;276
7527;0;São Geraldo;Belém Novo;100;0;47;26;0;100
7528;0;São Geraldo;Belém Velho;89;0;58;13;0;89
7529;0;São Geraldo;Boa Vista;59;0;34;13;0;59
7530;0;São Geraldo;Boa Vista do Sul;50;0;27;13;0;50
7531;0;São Geraldo;Bom Fim;350;0;175;86;0;350
7532;0;São Geraldo;Bom Jesus;275;50;98;33;100;175
7533;0;São Geraldo;Camaquã;72;0;14;5;50;22
7534;0;São Geraldo;Campo Novo;150;0;56;29;50;100
7535;0;São Geraldo;Cascata;100;50;0;0;100;0
7536;0;São Geraldo;Cavalhada;231;0;121;30;50;181
7537;0;São Geraldo;Cel. Aparício Borges;116;0;71;19;0;116
7538;0;São Geraldo;Centro Histórico;488;0;46;22;400;88
7539;0;São Geraldo;Chapéu do Sol;0;0;0;0;0;0
7540;0;São Geraldo;Chácara das Pedras;100;0;52;22;0;100
7541;0;São Geraldo;Cidade Baixa;280;0;118;51;50;230
7542;0;São Geraldo;Costa e Silva;159;50;78;18;50;109
7543;0;São Geraldo;Cristal;261;50;113;42;50;211
7544;0;São Geraldo;Cristo Redentor;193;0;77;46;50;143
7545;0;São Geraldo;Espírito Santo;150;0;76;47;0;150
7546;0;São Geraldo;Extrema;150;0;58;23;50;100
7547;0;São Geraldo;Farrapos;250;50;74;33;100;150
7548;0;São Geraldo;Farroupilha;100;0;57;33;0;100
7549;0;São Geraldo;Floresta;3701;1200;719;346;2401;1300
7550;0;São Geraldo;Glória;259;0;161;73;0;259
7551;0;São Geraldo;Guarujá;50;0;35;12;0;50
7552;0;São Geraldo;Higienópolis;69;0;60;5;50;19
7553;0;São Geraldo;Humaitá;150;0;47;37;50;100
7554;0;São Geraldo;Hípica;105;50;37;7;50;55
7555;0;São Geraldo;Independência;300;50;128;78;50;250
7556;0;São Geraldo;Ipanema;42;0;26;13;0;42
7557;0;São Geraldo;Jardim Botânico;54;0;31;8;0;54
7558;0;São Geraldo;Jardim Carvalho;119;50;42;13;50;69
7559;0;São Geraldo;Jardim Europa;100;0;22;10;50;50
7560;0;São Geraldo;Jardim Floresta;100;0;57;23;0;100
7561;0;São Geraldo;Jardim Isabel;0;0;0;0;0;0
7562;0;São Geraldo;Jardim Itú;6;0;4;1;0;6
7563;0;São Geraldo;Jardim Leopoldina;86;0;52;17;0;86
7564;0;São Geraldo;Jardim Lindóia;50;0;31;16;0;50
7565;0;São Geraldo;Jardim Sabará;50;0;16;20;0;50
7566;0;São Geraldo;Jardim São Pedro;50;50;0;0;50;0
7567;0;São Geraldo;Jardim do Salso;100;50;29;8;50;50
7568;0;São Geraldo;Lageado;50;0;31;10;0;50
7569;0;São Geraldo;Lami;0;0;0;0;0;0
7570;0;São Geraldo;Lomba do Pinheiro;237;0;138;30;0;237
7571;0;São Geraldo;Medianeira;50;50;0;0;50;0
7572;0;São Geraldo;Menino Deus;339;50;120;69;100;239
7573;0;São Geraldo;Moinhos de Vento;450;100;175;49;300;150
7574;0;São Geraldo;Mont'Serrat;210;0;53;29;100;110
7575;0;São Geraldo;Morro Santana;95;0;60;16;0;95
7576;0;São Geraldo;Mário Quintana;340;50;198;32;50;290
7577;0;São Geraldo;Navegantes;1350;150;604;244;350;1000
7578;0;São Geraldo;Nonoai;31;0;16;5;0;31
7579;0;São Geraldo;Parque Santa Fé;100;0;63;28;0;100
7580;0;São Geraldo;Partenon;179;50;79;22;50;129
7581;0;São Geraldo;Passo D'Areia;308;0;87;98;50;258
7582;0;São Geraldo;Passo das Pedras;78;0;45;16;0;78
7583;0;São Geraldo;Pedra Redonda;50;0;36;12;0;50
7584;0;São Geraldo;Petrópolis;228;0;96;45;50;178
7585;0;São Geraldo;Pitinga;50;0;26;8;0;50
7586;0;São Geraldo;Ponta Grossa;0;0;0;0;0;0
7587;0;São Geraldo;Praia de Belas;0;0;0;0;0;0
7588;0;São Geraldo;Restinga;262;0;104;43;50;212
7589;0;São Geraldo;Rio Branco;341;50;176;84;100;241
7590;0;São Geraldo;Rubem Berta;68;0;42;19;0;68
7591;0;São Geraldo;Santa Cecília;200;50;73;48;50;150
7592;0;São Geraldo;Santa Maria Goretti;100;0;68;1;0;100
7593;0;São Geraldo;Santa Rosa de Lima;111;0;59;22;0;111
7594;0;São Geraldo;Santa Tereza;216;50;91;25;50;166
7595;0;São Geraldo;Santana;501;100;124;48;300;201
7596;0;São Geraldo;Santo Antônio;16;0;11;4;0;16
7597;0;São Geraldo;Sarandi;627;0;272;122;200;427
7598;0;São Geraldo;Serraria;50;0;20;15;0;50
7599;0;São Geraldo;São Caetano;100;0;45;28;0;100
7600;0;São Geraldo;São Geraldo;7200;1300;2490;1104;3100;4100
7601;0;São Geraldo;São José;42;0;28;4;0;42
7602;0;São Geraldo;São João;600;50;243;129;150;450
7603;0;São Geraldo;São Sebastião;150;50;26;14;100;50
7604;0;São Geraldo;Sétimo Céu;0;0;0;0;0;0
7605;0;São Geraldo;Teresópolis;0;0;0;0;0;0
7606;0;São Geraldo;Tristeza;71;0;44;19;0;71
7607;0;São Geraldo;Três Figueiras;0;0;0;0;0;0
7608;0;São Geraldo;Vila Assunção;50;0;40;8;0;50
7609;0;São Geraldo;Vila Conceição;50;0;27;15;0;50
7610;0;São Geraldo;Vila Ipiranga;68;50;8;4;50;18
7611;0;São Geraldo;Vila Jardim;135;50;18;7;100;35
7612;0;São Geraldo;Vila João Pessoa;104;50;36;14;50;54
7613;0;São Geraldo;Vila Nova;280;0;123;47;50;230
7614;0;São José;Aberta dos Morros;50;0;35;5;0;50
7615;0;São José;Agronomia;2997;747;997;279;1297;1700
7616;0;São José;Anchieta;0;0;0;0;0;0
7617;0;São José;Arquipélago;250;0;126;34;50;200
7618;0;São José;Auxiliadora;2;0;0;2;0;2
7619;0;São José;Azenha;101;0;57;18;0;101
7620;0;São José;Bela Vista;149;50;1;0;147;2
7621;0;São José;Belém Novo;50;50;0;0;50;0
7622;0;São José;Belém Velho;810;200;253;74;400;410
7623;0;São José;Boa Vista;202;0;121;48;0;202
7624;0;São José;Boa Vista do Sul;50;0;22;6;0;50
7625;0;São José;Bom Fim;50;0;30;14;0;50
7626;0;São José;Bom Jesus;908;295;336;83;345;563
7627;0;São José;Camaquã;2;0;2;0;0;2
7628;0;São José;Campo Novo;150;50;32;11;100;50
7629;0;São José;Cascata;7023;445;3572;955;1073;5950
7630;0;São José;Cavalhada;70;0;36;17;0;70
7631;0;São José;Cel. Aparício Borges;1574;631;246;38;1304;270
7632;0;São José;Centro Histórico;106;0;41;6;47;59
7633;0;São José;Chapéu do Sol;0;0;0;0;0;0
7634;0;São José;Chácara das Pedras;150;0;95;29;0;150
7635;0;São José;Cidade Baixa;53;0;27;17;0;53
7636;0;São José;Costa e Silva;111;0;45;2;50;61
7637;0;São José;Cristal;113;47;12;2;95;18
7638;0;São José;Cristo Redentor;64;0;29;14;0;64
7639;0;São José;Espírito Santo;0;0;0;0;0;0
7640;0;São José;Extrema;100;50;25;13;50;50
7641;0;São José;Farrapos;602;97;160;22;452;150
7642;0;São José;Farroupilha;0;0;0;0;0;0
7643;0;São José;Floresta;50;0;24;21;0;50
7644;0;São José;Glória;820;238;288;87;368;452
7645;0;São José;Guarujá;50;50;0;0;50;0
7646;0;São José;Higienópolis;53;50;1;2;50;3
7647;0;São José;Humaitá;200;0;121;23;0;200
7648;0;São José;Hípica;201;0;132;30;0;201
7649;0;São José;Independência;150;0;92;30;0;150
7650;0;São José;Ipanema;204;47;98;34;47;157
7651;0;São José;Jardim Botânico;460;50;243;72;50;410
7652;0;São José;Jardim Carvalho;761;100;290;76;358;403
7653;0;São José;Jardim Europa;150;50;31;8;100;50
7654;0;São José;Jardim Floresta;50;0;34;8;0;50
7655;0;São José;Jardim Isabel;50;0;32;13;0;50
7656;0;São José;Jardim Itú;145;145;0;0;145;0
7657;0;São José;Jardim Leopoldina;157;0;39;8;100;57
7658;0;São José;Jardim Lindóia;0;0;0;0;0;0
7659;0;São José;Jardim Sabará;250;0;127;25;50;200
7660;0;São José;Jardim São Pedro;0;0;0;0;0;0
7661;0;São José;Jardim do Salso;350;0;197;57;0;350
7662;0;São José;Lageado;0;0;0;0;0;0
7663;0;São José;Lami;100;50;26;10;50;50
7664;0;São José;Lomba do Pinheiro;1501;296;608;153;496;1005
7665;0;São José;Medianeira;50;0;28;6;0;50
7666;0;São José;Menino Deus;214;0;38;19;147;67
7667;0;São José;Moinhos de Vento;50;0;32;6;0;50
7668;0;São José;Mont'Serrat;199;0;79;27;47;152
7669;0;São José;Morro Santana;198;50;71;19;82;116
7670;0;São José;Mário Quintana;230;99;43;13;149;81
7671;0;São José;Navegantes;0;0;0;0;0;0
7672;0;São José;Nonoai;298;98;94;31;145;153
7673;0;São José;Parque Santa Fé;100;0;82;7;50;50
7674;0;São José;Partenon;1063;100;594;178;100;963
7675;0;São José;Passo D'Areia;166;0;87;33;0;166
7676;0;São José;Passo das Pedras;157;0;35;11;95;62
7677;0;São José;Pedra Redonda;50;50;0;0;50;0
7678;0;São José;Petrópolis;368;0;184;75;50;318
7679;0;São José;Pitinga;100;0;66;22;0;100
7680;0;São José;Ponta Grossa;50;50;0;0;50;0
7681;0;São José;Praia de Belas;100;0;30;11;50;50
7682;0;São José;Restinga;265;97;110;27;97;168
7683;0;São José;Rio Branco;57;0;4;2;50;7
7684;0;São José;Rubem Berta;102;50;32;11;50;52
7685;0;São José;Santa Cecília;100;0;35;4;50;50
7686;0;São José;Santa Maria Goretti;50;0;37;6;0;50
7687;0;São José;Santa Rosa de Lima;200;0;56;25;97;103
7688;0;São José;Santa Tereza;120;50;39;14;50;70
7689;0;São José;Santana;211;50;6;3;200;11
7690;0;São José;Santo Antônio;249;50;89;26;97;152
7691;0;São José;Sarandi;211;0;65;36;82;129
7692;0;São José;Serraria;50;0;29;7;0;50
7693;0;São José;São Caetano;250;150;62;14;150;100
7694;0;São José;São Geraldo;0;0;0;0;0;0
7695;0;São José;São José;10148;1180;5111;1514;1639;8509
7696;0;São José;São João;100;0;54;35;0;100
7697;0;São José;São Sebastião;100;0;35;9;50;50
7698;0;São José;Sétimo Céu;50;0;32;6;0;50
7699;0;São José;Teresópolis;532;100;159;45;282;250
7700;0;São José;Tristeza;162;0;69;26;50;112
7701;0;São José;Três Figueiras;100;0;63;14;0;100
7702;0;São José;Vila Assunção;100;0;58;16;0;100
7703;0;São José;Vila Conceição;50;0;28;6;0;50
7704;0;São José;Vila Ipiranga;3;0;0;2;0;3
7705;0;São José;Vila Jardim;305;150;59;24;197;108
7706;0;São José;Vila João Pessoa;2033;738;377;87;1533;500
7707;0;São José;Vila Nova;380;0;227;75;50;330
7708;0;São João;Aberta dos Morros;0;0;0;0;0;0
7709;0;São João;Agronomia;0;0;0;0;0;0
7710;0;São João;Anchieta;150;0;76;29;0;150
7711;0;São João;Arquipélago;150;100;28;9;100;50
7712;0;São João;Auxiliadora;718;100;351;174;100;618
7713;0;São João;Azenha;350;150;85;40;200;150
7714;0;São João;Bela Vista;225;100;50;17;150;75
7715;0;São João;Belém Novo;0;0;0;0;0;0
7716;0;São João;Belém Velho;77;0;25;1;50;27
7717;0;São João;Boa Vista;557;0;266;151;50;507
7718;0;São João;Boa Vista do Sul;50;0;31;13;0;50
7719;0;São João;Bom Fim;200;0;129;37;50;150
7720;0;São João;Bom Jesus;288;50;43;13;200;88
7721;0;São João;Camaquã;73;0;40;17;0;73
7722;0;São João;Campo Novo;0;0;0;0;0;0
7723;0;São João;Cascata;0;0;0;0;0;0
7724;0;São João;Cavalhada;171;0;106;36;0;171
7725;0;São João;Cel. Aparício Borges;108;0;63;22;0;108
7726;0;São João;Centro Histórico;427;100;72;40;300;127
7727;0;São João;Chapéu do Sol;50;0;29;12;0;50
7728;0;São João;Chácara das Pedras;0;0;0;0;0;0
7729;0;São João;Cidade Baixa;374;0;140;66;100;274
7730;0;São João;Costa e Silva;137;0;94;18;0;137
7731;0;São João;Cristal;180;0;110;29;0;180
7732;0;São João;Cristo Redentor;496;0;253;86;100;396
7733;0;São João;Espírito Santo;0;0;0;0;0;0
7734;0;São João;Extrema;0;0;0;0;0;0
7735;0;São João;Farrapos;400;250;91;40;250;150
7736;0;São João;Farroupilha;50;0;21;13;0;50
7737;0;São João;Floresta;2517;200;1240;611;267;2250
7738;0;São João;Glória;357;100;147;67;100;257
7739;0;São João;Guarujá;0;0;0;0;0;0
7740;0;São João;Higienópolis;709;100;268;95;250;459
7741;0;São João;Humaitá;503;100;127;42;303;200
7742;0;São João;Hípica;200;50;73;44;50;150
7743;0;São João;Independência;450;0;181;62;200;250
7744;0;São João;Ipanema;177;0;102;49;0;177
7745;0;São João;Jardim Botânico;232;50;89;22;150;82
7746;0;São João;Jardim Carvalho;112;0;36;11;50;62
7747;0;São João;Jardim Europa;100;0;47;32;0;100
7748;0;São João;Jardim Floresta;50;0;25;15;0;50
7749;0;São João;Jardim Isabel;0;0;0;0;0;0
7750;0;São João;Jardim Itú;156;50;29;15;100;56
7751;0;São João;Jardim Leopoldina;73;0;47;18;0;73
7752;0;São João;Jardim Lindóia;150;0;27;13;100;50
7753;0;São João;Jardim Sabará;250;50;77;43;100;150
7754;0;São João;Jardim São Pedro;150;0;30;13;100;50
7755;0;São João;Jardim do Salso;100;0;28;9;50;50
7756;0;São João;Lageado;0;0;0;0;0;0
7757;0;São João;Lami;100;0;49;33;0;100
7758;0;São João;Lomba do Pinheiro;78;0;66;5;50;28
7759;0;São João;Medianeira;150;50;56;18;50;100
7760;0;São João;Menino Deus;269;0;126;68;50;219
7761;0;São João;Moinhos de Vento;850;200;242;175;350;500
7762;0;São João;Mont'Serrat;559;150;184;111;200;359
7763;0;São João;Morro Santana;196;50;82;31;50;146
7764;0;São João;Mário Quintana;136;0;85;17;0;136
7765;0;São João;Navegantes;250;0;138;39;100;150
7766;0;São João;Nonoai;124;0;79;13;0;124
7767;0;São João;Parque Santa Fé;50;0;27;16;0;50
7768;0;São João;Partenon;542;50;213;103;150;392
7769;0;São João;Passo D'Areia;606;150;180;102;250;356
7770;0;São João;Passo das Pedras;97;0;47;17;0;97
7771;0;São João;Pedra Redonda;0;0;0;0;0;0
7772;0;São João;Petrópolis;414;0;204;86;50;364
7773;0;São João;Pitinga;50;0;31;15;0;50
7774;0;São João;Ponta Grossa;50;0;19;19;0;50
7775;0;São João;Praia de Belas;0;0;0;0;0;0
7776;0;São João;Restinga;284;0;137;33;50;234
7777;0;São João;Rio Branco;528;50;198;117;150;378
7778;0;São João;Rubem Berta;171;100;36;25;100;71
7779;0;São João;Santa Cecília;250;0;95;39;150;100
7780;0;São João;Santa Maria Goretti;350;0;115;44;150;200
7781;0;São João;Santa Rosa de Lima;108;50;33;11;50;58
7782;0;São João;Santa Tereza;210;50;97;32;50;160
7783;0;São João;Santana;232;100;68;42;100;132
7784;0;São João;Santo Antônio;210;0;33;8;150;60
7785;0;São João;Sarandi;393;50;142;32;250;143
7786;0;São João;Serraria;50;0;29;16;0;50
7787;0;São João;São Caetano;100;50;29;14;50;50
7788;0;São João;São Geraldo;600;50;243;129;150;450
7789;0;São João;São José;130;0;72;38;0;130
7790;0;São João;São João;4100;100;2066;938;400;3700
7791;0;São João;São Sebastião;50;0;0;0;50;0
7792;0;São João;Sétimo Céu;50;0;28;20;0;50
7793;0;São João;Teresópolis;50;0;29;15;0;50
7794;0;São João;Tristeza;138;0;74;39;0;138
7795;0;São João;Três Figueiras;450;100;144;74;200;250
7796;0;São João;Vila Assunção;50;0;23;17;0;50
7797;0;São João;Vila Conceição;0;0;0;0;0;0
7798;0;São João;Vila Ipiranga;158;0;88;34;0;158
7799;0;São João;Vila Jardim;177;0;69;40;50;127
7800;0;São João;Vila João Pessoa;100;50;32;8;50;50
7801;0;São João;Vila Nova;190;50;78;33;50;140
7802;0;São Sebastião;Aberta dos Morros;50;0;37;8;0;50
7803;0;São Sebastião;Agronomia;0;0;0;0;0;0
7804;0;São Sebastião;Anchieta;50;50;0;0;50;0
7805;0;São Sebastião;Arquipélago;150;50;55;17;50;100
7806;0;São Sebastião;Auxiliadora;56;0;2;1;50;6
7807;0;São Sebastião;Azenha;0;0;0;0;0;0
7808;0;São Sebastião;Bela Vista;56;0;4;2;50;6
7809;0;São Sebastião;Belém Novo;50;0;35;7;0;50
7810;0;São Sebastião;Belém Velho;62;0;35;12;0;62
7811;0;São Sebastião;Boa Vista;252;100;53;25;150;102
7812;0;São Sebastião;Boa Vista do Sul;0;0;0;0;0;0
7813;0;São Sebastião;Bom Fim;50;0;10;18;0;50
7814;0;São Sebastião;Bom Jesus;66;50;9;3;50;16
7815;0;São Sebastião;Camaquã;55;0;33;12;0;55
7816;0;São Sebastião;Campo Novo;0;0;0;0;0;0
7817;0;São Sebastião;Cascata;0;0;0;0;0;0
7818;0;São Sebastião;Cavalhada;123;0;40;10;50;73
7819;0;São Sebastião;Cel. Aparício Borges;70;50;13;4;50;20
7820;0;São Sebastião;Centro Histórico;213;50;87;36;50;163
7821;0;São Sebastião;Chapéu do Sol;0;0;0;0;0;0
7822;0;São Sebastião;Chácara das Pedras;200;0;94;28;50;150
7823;0;São Sebastião;Cidade Baixa;106;0;62;22;0;106
7824;0;São Sebastião;Costa e Silva;665;150;243;43;300;365
7825;0;São Sebastião;Cristal;75;0;42;14;0;75
7826;0;São Sebastião;Cristo Redentor;716;200;264;97;250;466
7827;0;São Sebastião;Espírito Santo;0;0;0;0;0;0
7828;0;São Sebastião;Extrema;50;50;0;0;50;0
7829;0;São Sebastião;Farrapos;300;50;125;27;100;200
7830;0;São Sebastião;Farroupilha;0;0;0;0;0;0
7831;0;São Sebastião;Floresta;0;0;0;0;0;0
7832;0;São Sebastião;Glória;50;0;35;11;0;50
7833;0;São Sebastião;Guarujá;150;50;49;25;50;100
7834;0;São Sebastião;Higienópolis;204;50;63;21;100;104
7835;0;São Sebastião;Humaitá;150;0;36;8;100;50
7836;0;São Sebastião;Hípica;0;0;0;0;0;0
7837;0;São Sebastião;Independência;150;50;54;24;50;100
7838;0;São Sebastião;Ipanema;62;0;38;12;0;62
7839;0;São Sebastião;Jardim Botânico;63;50;10;2;50;13
7840;0;São Sebastião;Jardim Carvalho;56;50;4;1;50;6
7841;0;São Sebastião;Jardim Europa;100;50;0;0;100;0
7842;0;São Sebastião;Jardim Floresta;464;150;138;69;214;250
7843;0;São Sebastião;Jardim Isabel;0;0;0;0;0;0
7844;0;São Sebastião;Jardim Itú;502;0;229;82;100;402
7845;0;São Sebastião;Jardim Leopoldina;413;0;105;40;250;163
7846;0;São Sebastião;Jardim Lindóia;1300;250;560;207;450;850
7847;0;São Sebastião;Jardim Sabará;100;50;32;13;50;50
7848;0;São Sebastião;Jardim São Pedro;150;50;24;8;100;50
7849;0;São Sebastião;Jardim do Salso;50;0;21;12;0;50
7850;0;São Sebastião;Lageado;100;0;64;23;0;100
7851;0;São Sebastião;Lami;0;0;0;0;0;0
7852;0;São Sebastião;Lomba do Pinheiro;209;50;86;29;50;159
7853;0;São Sebastião;Medianeira;50;50;0;0;50;0
7854;0;São Sebastião;Menino Deus;124;0;75;37;0;124
7855;0;São Sebastião;Moinhos de Vento;100;0;56;20;0;100
7856;0;São Sebastião;Mont'Serrat;50;0;0;0;50;0
7857;0;São Sebastião;Morro Santana;167;0;99;30;0;167
7858;0;São Sebastião;Mário Quintana;367;100;121;26;150;217
7859;0;São Sebastião;Navegantes;0;0;0;0;0;0
7860;0;São Sebastião;Nonoai;56;0;30;13;0;56
7861;0;São Sebastião;Parque Santa Fé;250;50;94;24;100;150
7862;0;São Sebastião;Partenon;267;50;122;50;50;217
7863;0;São Sebastião;Passo D'Areia;317;50;93;68;100;217
7864;0;São Sebastião;Passo das Pedras;816;150;287;96;300;516
7865;0;São Sebastião;Pedra Redonda;0;0;0;0;0;0
7866;0;São Sebastião;Petrópolis;371;0;184;89;50;321
7867;0;São Sebastião;Pitinga;0;0;0;0;0;0
7868;0;São Sebastião;Ponta Grossa;50;0;39;7;0;50
7869;0;São Sebastião;Praia de Belas;50;50;0;0;50;0
7870;0;São Sebastião;Restinga;76;0;38;18;0;76
7871;0;São Sebastião;Rio Branco;113;0;52;39;0;113
7872;0;São Sebastião;Rubem Berta;704;250;203;108;400;304
7873;0;São Sebastião;Santa Cecília;0;0;0;0;0;0
7874;0;São Sebastião;Santa Maria Goretti;50;0;37;3;0;50
7875;0;São Sebastião;Santa Rosa de Lima;252;0;113;35;50;202
7876;0;São Sebastião;Santa Tereza;122;0;71;19;0;122
7877;0;São Sebastião;Santana;162;50;32;18;100;62
7878;0;São Sebastião;Santo Antônio;103;0;58;24;0;103
7879;0;São Sebastião;Sarandi;964;50;451;206;150;814
7880;0;São Sebastião;Serraria;50;0;0;0;50;0
7881;0;São Sebastião;São Caetano;0;0;0;0;0;0
7882;0;São Sebastião;São Geraldo;150;50;26;14;100;50
7883;0;São Sebastião;São José;111;0;42;11;50;61
7884;0;São Sebastião;São João;50;0;0;0;50;0
7885;0;São Sebastião;São Sebastião;5154;1300;1840;566;2154;3000
7886;0;São Sebastião;Sétimo Céu;50;0;25;15;0;50
7887;0;São Sebastião;Teresópolis;200;100;57;23;100;100
7888;0;São Sebastião;Tristeza;14;0;9;5;0;14
7889;0;São Sebastião;Três Figueiras;100;0;21;12;50;50
7890;0;São Sebastião;Vila Assunção;0;0;0;0;0;0
7891;0;São Sebastião;Vila Conceição;0;0;0;0;0;0
7892;0;São Sebastião;Vila Ipiranga;754;50;395;132;50;704
7893;0;São Sebastião;Vila Jardim;313;100;104;40;150;163
7894;0;São Sebastião;Vila João Pessoa;50;0;30;8;0;50
7895;0;São Sebastião;Vila Nova;247;0;155;37;50;197
7896;0;Sétimo Céu;Aberta dos Morros;0;0;0;0;0;0
7897;0;Sétimo Céu;Agronomia;50;0;26;7;0;50
7898;0;Sétimo Céu;Anchieta;0;0;0;0;0;0
7899;0;Sétimo Céu;Arquipélago;100;0;57;12;0;100
7900;0;Sétimo Céu;Auxiliadora;52;0;27;9;0;52
7901;0;Sétimo Céu;Azenha;0;0;0;0;0;0
7902;0;Sétimo Céu;Bela Vista;3;0;1;2;0;3
7903;0;Sétimo Céu;Belém Novo;100;0;24;10;50;50
7904;0;Sétimo Céu;Belém Velho;102;0;37;8;50;52
7905;0;Sétimo Céu;Boa Vista;2;0;2;0;0;2
7906;0;Sétimo Céu;Boa Vista do Sul;0;0;0;0;0;0
7907;0;Sétimo Céu;Bom Fim;0;0;0;0;0;0
7908;0;Sétimo Céu;Bom Jesus;158;0;88;29;0;158
7909;0;Sétimo Céu;Camaquã;1853;100;872;292;450;1403
7910;0;Sétimo Céu;Campo Novo;100;50;0;0;100;0
7911;0;Sétimo Céu;Cascata;0;0;0;0;0;0
7912;0;Sétimo Céu;Cavalhada;5222;500;2394;881;1050;4172
7913;0;Sétimo Céu;Cel. Aparício Borges;65;0;35;8;0;65
7914;0;Sétimo Céu;Centro Histórico;52;50;2;0;50;2
7915;0;Sétimo Céu;Chapéu do Sol;0;0;0;0;0;0
7916;0;Sétimo Céu;Chácara das Pedras;0;0;0;0;0;0
7917;0;Sétimo Céu;Cidade Baixa;152;0;42;28;50;102
7918;0;Sétimo Céu;Costa e Silva;6;0;6;0;0;6
7919;0;Sétimo Céu;Cristal;578;100;238;51;250;328
7920;0;Sétimo Céu;Cristo Redentor;10;0;7;3;0;10
7921;0;Sétimo Céu;Espírito Santo;50;0;29;11;0;50
7922;0;Sétimo Céu;Extrema;0;0;0;0;0;0
7923;0;Sétimo Céu;Farrapos;0;0;0;0;0;0
7924;0;Sétimo Céu;Farroupilha;0;0;0;0;0;0
7925;0;Sétimo Céu;Floresta;50;0;32;12;0;50
7926;0;Sétimo Céu;Glória;2;0;2;0;0;2
7927;0;Sétimo Céu;Guarujá;0;0;0;0;0;0
7928;0;Sétimo Céu;Higienópolis;102;50;0;1;100;2
7929;0;Sétimo Céu;Humaitá;50;0;33;2;0;50
7930;0;Sétimo Céu;Hípica;0;0;0;0;0;0
7931;0;Sétimo Céu;Independência;0;0;0;0;0;0
7932;0;Sétimo Céu;Ipanema;1202;0;578;213;250;952
7933;0;Sétimo Céu;Jardim Botânico;55;0;35;12;0;55
7934;0;Sétimo Céu;Jardim Carvalho;2;0;2;0;0;2
7935;0;Sétimo Céu;Jardim Europa;0;0;0;0;0;0
7936;0;Sétimo Céu;Jardim Floresta;0;0;0;0;0;0
7937;0;Sétimo Céu;Jardim Isabel;400;0;237;69;50;350
7938;0;Sétimo Céu;Jardim Itú;2;0;1;1;0;2
7939;0;Sétimo Céu;Jardim Leopoldina;52;50;0;1;50;2
7940;0;Sétimo Céu;Jardim Lindóia;0;0;0;0;0;0
7941;0;Sétimo Céu;Jardim Sabará;50;0;0;0;50;0
7942;0;Sétimo Céu;Jardim São Pedro;0;0;0;0;0;0
7943;0;Sétimo Céu;Jardim do Salso;0;0;0;0;0;0
7944;0;Sétimo Céu;Lageado;0;0;0;0;0;0
7945;0;Sétimo Céu;Lami;0;0;0;0;0;0
7946;0;Sétimo Céu;Lomba do Pinheiro;53;0;35;5;0;53
7947;0;Sétimo Céu;Medianeira;0;0;0;0;0;0
7948;0;Sétimo Céu;Menino Deus;67;0;35;14;0;67
7949;0;Sétimo Céu;Moinhos de Vento;50;50;0;0;50;0
7950;0;Sétimo Céu;Mont'Serrat;3;0;2;0;0;3
7951;0;Sétimo Céu;Morro Santana;13;0;8;3;0;13
7952;0;Sétimo Céu;Mário Quintana;41;0;28;6;0;41
7953;0;Sétimo Céu;Navegantes;0;0;0;0;0;0
7954;0;Sétimo Céu;Nonoai;588;100;213;64;236;352
7955;0;Sétimo Céu;Parque Santa Fé;50;0;29;9;0;50
7956;0;Sétimo Céu;Partenon;58;0;23;13;0;58
7957;0;Sétimo Céu;Passo D'Areia;13;0;6;4;0;13
7958;0;Sétimo Céu;Passo das Pedras;8;0;3;3;0;8
7959;0;Sétimo Céu;Pedra Redonda;150;0;32;3;100;50
7960;0;Sétimo Céu;Petrópolis;66;0;32;15;0;66
7961;0;Sétimo Céu;Pitinga;0;0;0;0;0;0
7962;0;Sétimo Céu;Ponta Grossa;100;0;66;13;0;100
7963;0;Sétimo Céu;Praia de Belas;0;0;0;0;0;0
7964;0;Sétimo Céu;Restinga;479;100;122;31;250;229
7965;0;Sétimo Céu;Rio Branco;52;0;0;1;50;2
7966;0;Sétimo Céu;Rubem Berta;102;50;26;17;50;52
7967;0;Sétimo Céu;Santa Cecília;0;0;0;0;0;0
7968;0;Sétimo Céu;Santa Maria Goretti;0;0;0;0;0;0
7969;0;Sétimo Céu;Santa Rosa de Lima;52;0;29;9;0;52
7970;0;Sétimo Céu;Santa Tereza;167;0;97;36;0;167
7971;0;Sétimo Céu;Santana;54;0;2;0;50;4
7972;0;Sétimo Céu;Santo Antônio;2;0;0;2;0;2
7973;0;Sétimo Céu;Sarandi;290;200;18;12;250;40
7974;0;Sétimo Céu;Serraria;100;0;55;25;0;100
7975;0;Sétimo Céu;São Caetano;0;0;0;0;0;0
7976;0;Sétimo Céu;São Geraldo;0;0;0;0;0;0
7977;0;Sétimo Céu;São José;52;0;33;7;0;52
7978;0;Sétimo Céu;São João;50;0;28;20;0;50
7979;0;Sétimo Céu;São Sebastião;50;0;25;15;0;50
7980;0;Sétimo Céu;Sétimo Céu;700;300;116;18;500;200
7981;0;Sétimo Céu;Teresópolis;50;0;28;17;0;50
7982;0;Sétimo Céu;Tristeza;3807;1750;517;191;3100;707
7983;0;Sétimo Céu;Três Figueiras;0;0;0;0;0;0
7984;0;Sétimo Céu;Vila Assunção;100;50;22;7;50;50
7985;0;Sétimo Céu;Vila Conceição;250;100;56;28;150;100
7986;0;Sétimo Céu;Vila Ipiranga;2;0;1;0;0;2
7987;0;Sétimo Céu;Vila Jardim;52;0;25;10;0;52
7988;0;Sétimo Céu;Vila João Pessoa;0;0;0;0;0;0
7989;0;Sétimo Céu;Vila Nova;289;0;138;61;50;239
7990;0;Teresópolis;Aberta dos Morros;150;0;63;24;50;100
7991;0;Teresópolis;Agronomia;50;50;0;0;50;0
7992;0;Teresópolis;Anchieta;50;0;30;12;0;50
7993;0;Teresópolis;Arquipélago;0;0;0;0;0;0
7994;0;Teresópolis;Auxiliadora;6;0;2;2;0;6
7995;0;Teresópolis;Azenha;50;0;22;14;0;50
7996;0;Teresópolis;Bela Vista;157;0;5;2;150;7
7997;0;Teresópolis;Belém Novo;0;0;0;0;0;0
7998;0;Teresópolis;Belém Velho;608;150;153;26;450;158
7999;0;Teresópolis;Boa Vista;54;0;4;0;50;4
8000;0;Teresópolis;Boa Vista do Sul;100;0;51;28;0;100
8001;0;Teresópolis;Bom Fim;0;0;0;0;0;0
8002;0;Teresópolis;Bom Jesus;60;0;30;12;0;60
8003;0;Teresópolis;Camaquã;507;100;181;70;200;307
8004;0;Teresópolis;Campo Novo;350;150;132;33;150;200
8005;0;Teresópolis;Cascata;250;150;0;0;250;0
8006;0;Teresópolis;Cavalhada;912;150;383;142;250;662
8007;0;Teresópolis;Cel. Aparício Borges;313;50;122;48;100;213
8008;0;Teresópolis;Centro Histórico;57;50;5;1;50;7
8009;0;Teresópolis;Chapéu do Sol;50;0;0;0;50;0
8010;0;Teresópolis;Chácara das Pedras;0;0;0;0;0;0
8011;0;Teresópolis;Cidade Baixa;107;50;30;14;50;57
8012;0;Teresópolis;Costa e Silva;107;50;41;7;50;57
8013;0;Teresópolis;Cristal;964;50;360;97;350;614
8014;0;Teresópolis;Cristo Redentor;164;50;64;27;50;114
8015;0;Teresópolis;Espírito Santo;100;0;25;21;50;50
8016;0;Teresópolis;Extrema;100;0;67;20;0;100
8017;0;Teresópolis;Farrapos;200;0;82;30;50;150
8018;0;Teresópolis;Farroupilha;50;0;27;11;0;50
8019;0;Teresópolis;Floresta;250;0;84;38;100;150
8020;0;Teresópolis;Glória;2002;950;457;155;1350;652
8021;0;Teresópolis;Guarujá;0;0;0;0;0;0
8022;0;Teresópolis;Higienópolis;55;0;3;1;50;5
8023;0;Teresópolis;Humaitá;100;0;30;9;50;50
8024;0;Teresópolis;Hípica;150;50;62;17;50;100
8025;0;Teresópolis;Independência;150;50;57;30;50;100
8026;0;Teresópolis;Ipanema;508;300;55;30;400;108
8027;0;Teresópolis;Jardim Botânico;110;50;42;10;50;60
8028;0;Teresópolis;Jardim Carvalho;105;50;3;1;100;5
8029;0;Teresópolis;Jardim Europa;300;0;163;47;50;250
8030;0;Teresópolis;Jardim Floresta;50;0;32;10;0;50
8031;0;Teresópolis;Jardim Isabel;0;0;0;0;0;0
8032;0;Teresópolis;Jardim Itú;152;50;64;27;50;102
8033;0;Teresópolis;Jardim Leopoldina;58;0;31;13;0;58
8034;0;Teresópolis;Jardim Lindóia;0;0;0;0;0;0
8035;0;Teresópolis;Jardim Sabará;50;0;30;13;0;50
8036;0;Teresópolis;Jardim São Pedro;0;0;0;0;0;0
8037;0;Teresópolis;Jardim do Salso;150;0;108;30;50;100
8038;0;Teresópolis;Lageado;100;0;35;12;50;50
8039;0;Teresópolis;Lami;150;0;57;25;50;100
8040;0;Teresópolis;Lomba do Pinheiro;109;100;4;1;100;9
8041;0;Teresópolis;Medianeira;650;200;278;108;200;450
8042;0;Teresópolis;Menino Deus;364;0;193;82;50;314
8043;0;Teresópolis;Moinhos de Vento;50;0;30;13;0;50
8044;0;Teresópolis;Mont'Serrat;104;0;63;24;0;104
8045;0;Teresópolis;Morro Santana;214;0;135;41;0;214
8046;0;Teresópolis;Mário Quintana;87;0;20;4;50;37
8047;0;Teresópolis;Navegantes;0;0;0;0;0;0
8048;0;Teresópolis;Nonoai;7957;800;3912;1457;1400;6557
8049;0;Teresópolis;Parque Santa Fé;100;0;30;16;50;50
8050;0;Teresópolis;Partenon;812;200;197;90;450;362
8051;0;Teresópolis;Passo D'Areia;13;0;6;7;0;13
8052;0;Teresópolis;Passo das Pedras;11;0;9;1;0;11
8053;0;Teresópolis;Pedra Redonda;150;50;54;34;50;100
8054;0;Teresópolis;Petrópolis;163;50;8;3;150;13
8055;0;Teresópolis;Pitinga;150;50;34;7;100;50
8056;0;Teresópolis;Ponta Grossa;0;0;0;0;0;0
8057;0;Teresópolis;Praia de Belas;150;0;93;34;0;150
8058;0;Teresópolis;Restinga;313;150;95;21;150;163
8059;0;Teresópolis;Rio Branco;56;0;37;14;0;56
8060;0;Teresópolis;Rubem Berta;106;0;37;10;50;56
8061;0;Teresópolis;Santa Cecília;200;0;91;37;50;150
8062;0;Teresópolis;Santa Maria Goretti;0;0;0;0;0;0
8063;0;Teresópolis;Santa Rosa de Lima;55;0;2;0;50;5
8064;0;Teresópolis;Santa Tereza;1165;300;434;137;500;665
8065;0;Teresópolis;Santana;309;50;173;57;100;209
8066;0;Teresópolis;Santo Antônio;255;50;84;41;100;155
8067;0;Teresópolis;Sarandi;234;50;71;41;100;134
8068;0;Teresópolis;Serraria;100;0;58;22;0;100
8069;0;Teresópolis;São Caetano;100;100;0;0;100;0
8070;0;Teresópolis;São Geraldo;0;0;0;0;0;0
8071;0;Teresópolis;São José;559;100;164;49;300;259
8072;0;Teresópolis;São João;50;0;29;15;0;50
8073;0;Teresópolis;São Sebastião;200;100;57;23;100;100
8074;0;Teresópolis;Sétimo Céu;50;0;28;17;0;50
8075;0;Teresópolis;Teresópolis;1200;400;376;110;600;600
8076;0;Teresópolis;Tristeza;359;0;192;93;50;309
8077;0;Teresópolis;Três Figueiras;0;0;0;0;0;0
8078;0;Teresópolis;Vila Assunção;100;0;59;19;0;100
8079;0;Teresópolis;Vila Conceição;50;0;28;12;0;50
8080;0;Teresópolis;Vila Ipiranga;155;100;33;9;100;55
8081;0;Teresópolis;Vila Jardim;107;0;54;22;0;107
8082;0;Teresópolis;Vila João Pessoa;350;0;90;36;200;150
8083;0;Teresópolis;Vila Nova;1887;150;826;275;450;1437
8084;0;Tristeza;Aberta dos Morros;150;50;25;11;100;50
8085;0;Tristeza;Agronomia;0;0;0;0;0;0
8086;0;Tristeza;Anchieta;0;0;0;0;0;0
8087;0;Tristeza;Arquipélago;0;0;0;0;0;0
8088;0;Tristeza;Auxiliadora;53;0;24;13;0;53
8089;0;Tristeza;Azenha;350;0;172;72;50;300
8090;0;Tristeza;Bela Vista;153;50;26;15;100;53
8091;0;Tristeza;Belém Novo;100;50;0;0;100;0
8092;0;Tristeza;Belém Velho;105;100;1;2;100;5
8093;0;Tristeza;Boa Vista;53;0;25;17;0;53
8094;0;Tristeza;Boa Vista do Sul;0;0;0;0;0;0
8095;0;Tristeza;Bom Fim;0;0;0;0;0;0
8096;0;Tristeza;Bom Jesus;5;0;5;0;0;5
8097;0;Tristeza;Camaquã;1253;500;367;202;550;703
8098;0;Tristeza;Campo Novo;300;50;114;53;100;200
8099;0;Tristeza;Cascata;0;0;0;0;0;0
8100;0;Tristeza;Cavalhada;908;200;230;108;500;408
8101;0;Tristeza;Cel. Aparício Borges;57;50;2;2;50;7
8102;0;Tristeza;Centro Histórico;55;0;23;13;0;55
8103;0;Tristeza;Chapéu do Sol;100;0;54;22;0;100
8104;0;Tristeza;Chácara das Pedras;0;0;0;0;0;0
8105;0;Tristeza;Cidade Baixa;103;0;66;23;0;103
8106;0;Tristeza;Costa e Silva;55;0;37;8;0;55
8107;0;Tristeza;Cristal;1459;300;552;230;500;959
8108;0;Tristeza;Cristo Redentor;57;0;35;13;0;57
8109;0;Tristeza;Espírito Santo;50;0;30;10;0;50
8110;0;Tristeza;Extrema;0;0;0;0;0;0
8111;0;Tristeza;Farrapos;9339;3167;3696;1975;2142;3238
8112;0;Tristeza;Farroupilha;0;0;0;0;0;0
8113;0;Tristeza;Floresta;50;0;0;0;50;0
8114;0;Tristeza;Glória;203;50;93;46;50;153
8115;0;Tristeza;Guarujá;150;0;81;49;0;150
8116;0;Tristeza;Higienópolis;53;0;32;9;0;53
8117;0;Tristeza;Humaitá;0;0;0;0;0;0
8118;0;Tristeza;Hípica;153;0;82;47;0;153
8119;0;Tristeza;Independência;0;0;0;0;0;0
8120;0;Tristeza;Ipanema;656;100;268;113;200;456
8121;0;Tristeza;Jardim Botânico;4;0;2;0;0;4
8122;0;Tristeza;Jardim Carvalho;53;0;32;9;0;53
8123;0;Tristeza;Jardim Europa;50;50;0;0;50;0
8124;0;Tristeza;Jardim Floresta;50;0;26;13;0;50
8125;0;Tristeza;Jardim Isabel;800;150;331;135;300;500
8126;0;Tristeza;Jardim Itú;50;0;0;0;50;0
8127;0;Tristeza;Jardim Leopoldina;5;0;3;1;0;5
8128;0;Tristeza;Jardim Lindóia;150;50;56;30;50;100
8129;0;Tristeza;Jardim Sabará;0;0;0;0;0;0
8130;0;Tristeza;Jardim São Pedro;100;0;72;24;0;100
8131;0;Tristeza;Jardim do Salso;0;0;0;0;0;0
8132;0;Tristeza;Lageado;50;0;33;16;0;50
8133;0;Tristeza;Lami;50;0;0;0;50;0
8134;0;Tristeza;Lomba do Pinheiro;3;0;1;1;0;3
8135;0;Tristeza;Medianeira;150;0;87;45;0;150
8136;0;Tristeza;Menino Deus;206;0;63;28;100;106
8137;0;Tristeza;Moinhos de Vento;100;0;57;30;0;100
8138;0;Tristeza;Mont'Serrat;103;0;54;33;0;103
8139;0;Tristeza;Morro Santana;59;0;7;2;50;9
8140;0;Tristeza;Mário Quintana;232;0;115;39;50;182
8141;0;Tristeza;Navegantes;0;0;0;0;0;0
8142;0;Tristeza;Nonoai;754;300;188;78;450;304
8143;0;Tristeza;Parque Santa Fé;0;0;0;0;0;0
8144;0;Tristeza;Partenon;159;50;65;31;50;109
8145;0;Tristeza;Passo D'Areia;6;0;2;3;0;6
8146;0;Tristeza;Passo das Pedras;7;0;6;0;0;7
8147;0;Tristeza;Pedra Redonda;691;250;244;115;341;350
8148;0;Tristeza;Petrópolis;156;0;95;40;0;156
8149;0;Tristeza;Pitinga;100;50;0;0;100;0
8150;0;Tristeza;Ponta Grossa;0;0;0;0;0;0
8151;0;Tristeza;Praia de Belas;100;0;57;32;0;100
8152;0;Tristeza;Restinga;157;50;42;8;100;57
8153;0;Tristeza;Rio Branco;6;0;1;1;0;6
8154;0;Tristeza;Rubem Berta;103;50;26;16;50;53
8155;0;Tristeza;Santa Cecília;50;0;0;0;50;0
8156;0;Tristeza;Santa Maria Goretti;100;0;31;18;50;50
8157;0;Tristeza;Santa Rosa de Lima;153;0;88;30;0;153
8158;0;Tristeza;Santa Tereza;857;100;250;108;400;457
8159;0;Tristeza;Santana;105;0;32;18;50;55
8160;0;Tristeza;Santo Antônio;255;50;92;45;100;155
8161;0;Tristeza;Sarandi;132;0;72;40;0;132
8162;0;Tristeza;Serraria;150;0;49;20;50;100
8163;0;Tristeza;São Caetano;0;0;0;0;0;0
8164;0;Tristeza;São Geraldo;0;0;0;0;0;0
8165;0;Tristeza;São José;157;0;66;22;50;107
8166;0;Tristeza;São João;100;0;56;25;0;100
8167;0;Tristeza;São Sebastião;0;0;0;0;0;0
8168;0;Tristeza;Sétimo Céu;3800;1750;514;187;3100;700
8169;0;Tristeza;Teresópolis;350;0;185;92;50;300
8170;0;Tristeza;Tristeza;905;100;416;208;200;705
8171;0;Tristeza;Três Figueiras;0;0;0;0;0;0
8172;0;Tristeza;Vila Assunção;1300;150;564;247;400;900
8173;0;Tristeza;Vila Conceição;750;150;293;139;250;500
8174;0;Tristeza;Vila Ipiranga;4;0;0;1;0;4
8175;0;Tristeza;Vila Jardim;5;0;3;2;0;5
8176;0;Tristeza;Vila João Pessoa;0;0;0;0;0;0
8177;0;Tristeza;Vila Nova;1581;50;872;448;50;1531
8178;0;Três Figueiras;Aberta dos Morros;76;50;12;7;50;26
8179;0;Três Figueiras;Agronomia;0;0;0;0;0;0
8180;0;Três Figueiras;Anchieta;0;0;0;0;0;0
8181;0;Três Figueiras;Arquipélago;50;50;0;0;50;0
8182;0;Três Figueiras;Auxiliadora;205;50;73;42;50;155
8183;0;Três Figueiras;Azenha;100;0;25;14;50;50
8184;0;Três Figueiras;Bela Vista;158;50;57;29;50;108
8185;0;Três Figueiras;Belém Novo;50;0;24;8;0;50
8186;0;Três Figueiras;Belém Velho;15;0;11;3;0;15
8187;0;Três Figueiras;Boa Vista;671;250;173;41;450;221
8188;0;Três Figueiras;Boa Vista do Sul;50;0;21;13;0;50
8189;0;Três Figueiras;Bom Fim;200;50;75;13;150;50
8190;0;Três Figueiras;Bom Jesus;309;0;183;34;100;209
8191;0;Três Figueiras;Camaquã;82;50;22;6;50;32
8192;0;Três Figueiras;Campo Novo;100;0;26;10;50;50
8193;0;Três Figueiras;Cascata;62;50;8;2;50;12
8194;0;Três Figueiras;Cavalhada;65;50;7;3;50;15
8195;0;Três Figueiras;Cel. Aparício Borges;84;0;49;13;0;84
8196;0;Três Figueiras;Centro Histórico;235;50;68;35;100;135
8197;0;Três Figueiras;Chapéu do Sol;50;0;23;12;0;50
8198;0;Três Figueiras;Chácara das Pedras;512;150;142;48;350;162
8199;0;Três Figueiras;Cidade Baixa;134;0;15;4;100;34
8200;0;Três Figueiras;Costa e Silva;209;50;63;21;100;109
8201;0;Três Figueiras;Cristal;72;50;15;3;50;22
8202;0;Três Figueiras;Cristo Redentor;264;50;81;40;100;164
8203;0;Três Figueiras;Espírito Santo;0;0;0;0;0;0
8204;0;Três Figueiras;Extrema;0;0;0;0;0;0
8205;0;Três Figueiras;Farrapos;10423;885;5501;2437;548;8910
8206;0;Três Figueiras;Farroupilha;76;0;35;19;0;76
8207;0;Três Figueiras;Floresta;76;50;7;9;50;26
8208;0;Três Figueiras;Glória;166;100;28;17;100;66
8209;0;Três Figueiras;Guarujá;100;0;58;27;0;100
8210;0;Três Figueiras;Higienópolis;265;50;94;33;100;165
8211;0;Três Figueiras;Humaitá;151;0;97;33;0;151
8212;0;Três Figueiras;Hípica;50;50;0;0;50;0
8213;0;Três Figueiras;Independência;70;0;40;18;0;70
8214;0;Três Figueiras;Ipanema;61;50;7;2;50;11
8215;0;Três Figueiras;Jardim Botânico;101;0;31;13;50;51
8216;0;Três Figueiras;Jardim Carvalho;58;0;34;8;0;58
8217;0;Três Figueiras;Jardim Europa;300;100;85;38;150;150
8218;0;Três Figueiras;Jardim Floresta;76;0;38;21;0;76
8219;0;Três Figueiras;Jardim Isabel;0;0;0;0;0;0
8220;0;Três Figueiras;Jardim Itú;50;0;0;0;50;0
8221;0;Três Figueiras;Jardim Leopoldina;161;50;9;1;150;11
8222;0;Três Figueiras;Jardim Lindóia;0;0;0;0;0;0
8223;0;Três Figueiras;Jardim Sabará;54;0;13;5;28;26
8224;0;Três Figueiras;Jardim São Pedro;0;0;0;0;0;0
8225;0;Três Figueiras;Jardim do Salso;150;0;51;24;50;100
8226;0;Três Figueiras;Lageado;0;0;0;0;0;0
8227;0;Três Figueiras;Lami;0;0;0;0;0;0
8228;0;Três Figueiras;Lomba do Pinheiro;63;50;9;1;50;13
8229;0;Três Figueiras;Medianeira;0;0;0;0;0;0
8230;0;Três Figueiras;Menino Deus;210;150;45;7;150;60
8231;0;Três Figueiras;Moinhos de Vento;101;0;53;35;0;101
8232;0;Três Figueiras;Mont'Serrat;690;250;243;102;250;440
8233;0;Três Figueiras;Morro Santana;42;0;24;9;0;42
8234;0;Três Figueiras;Mário Quintana;311;50;116;17;200;111
8235;0;Três Figueiras;Navegantes;0;0;0;0;0;0
8236;0;Três Figueiras;Nonoai;8;0;7;0;0;8
8237;0;Três Figueiras;Parque Santa Fé;0;0;0;0;0;0
8238;0;Três Figueiras;Partenon;91;0;23;6;50;41
8239;0;Três Figueiras;Passo D'Areia;388;100;123;66;150;238
8240;0;Três Figueiras;Passo das Pedras;91;0;52;10;0;91
8241;0;Três Figueiras;Pedra Redonda;0;0;0;0;0;0
8242;0;Três Figueiras;Petrópolis;6929;1250;1962;930;3600;3329
8243;0;Três Figueiras;Pitinga;0;0;0;0;0;0
8244;0;Três Figueiras;Ponta Grossa;50;0;26;13;0;50
8245;0;Três Figueiras;Praia de Belas;0;0;0;0;0;0
8246;0;Três Figueiras;Restinga;124;0;41;10;50;74
8247;0;Três Figueiras;Rio Branco;142;100;26;8;100;42
8248;0;Três Figueiras;Rubem Berta;7;0;4;1;0;7
8249;0;Três Figueiras;Santa Cecília;76;0;42;23;0;76
8250;0;Três Figueiras;Santa Maria Goretti;0;0;0;0;0;0
8251;0;Três Figueiras;Santa Rosa de Lima;92;0;26;3;50;42
8252;0;Três Figueiras;Santa Tereza;244;100;22;7;200;44
8253;0;Três Figueiras;Santana;307;150;55;24;200;107
8254;0;Três Figueiras;Santo Antônio;123;0;37;19;50;73
8255;0;Três Figueiras;Sarandi;230;100;68;41;100;130
8256;0;Três Figueiras;Serraria;50;0;33;14;0;50
8257;0;Três Figueiras;São Caetano;0;0;0;0;0;0
8258;0;Três Figueiras;São Geraldo;0;0;0;0;0;0
8259;0;Três Figueiras;São José;51;0;31;12;0;51
8260;0;Três Figueiras;São João;325;100;80;31;200;125
8261;0;Três Figueiras;São Sebastião;100;0;21;12;50;50
8262;0;Três Figueiras;Sétimo Céu;0;0;0;0;0;0
8263;0;Três Figueiras;Teresópolis;0;0;0;0;0;0
8264;0;Três Figueiras;Tristeza;14;0;7;7;0;14
8265;0;Três Figueiras;Três Figueiras;251;100;70;34;100;151
8266;0;Três Figueiras;Vila Assunção;78;50;14;6;50;28
8267;0;Três Figueiras;Vila Conceição;0;0;0;0;0;0
8268;0;Três Figueiras;Vila Ipiranga;240;50;82;33;100;140
8269;0;Três Figueiras;Vila Jardim;382;150;106;36;200;182
8270;0;Três Figueiras;Vila João Pessoa;176;100;46;21;100;76
8271;0;Três Figueiras;Vila Nova;21;0;7;11;0;21
8272;0;Vila Assunção;Aberta dos Morros;0;0;0;0;0;0
8273;0;Vila Assunção;Agronomia;0;0;0;0;0;0
8274;0;Vila Assunção;Anchieta;0;0;0;0;0;0
8275;0;Vila Assunção;Arquipélago;50;0;0;0;50;0
8276;0;Vila Assunção;Auxiliadora;0;0;0;0;0;0
8277;0;Vila Assunção;Azenha;50;0;24;10;0;50
8278;0;Vila Assunção;Bela Vista;0;0;0;0;0;0
8279;0;Vila Assunção;Belém Novo;50;0;0;0;50;0
8280;0;Vila Assunção;Belém Velho;56;0;6;0;50;6
8281;0;Vila Assunção;Boa Vista;0;0;0;0;0;0
8282;0;Vila Assunção;Boa Vista do Sul;50;0;31;7;0;50
8283;0;Vila Assunção;Bom Fim;100;0;0;0;100;0
8284;0;Vila Assunção;Bom Jesus;107;50;37;10;50;57
8285;0;Vila Assunção;Camaquã;450;150;143;17;300;150
8286;0;Vila Assunção;Campo Novo;0;0;0;0;0;0
8287;0;Vila Assunção;Cascata;150;100;33;3;100;50
8288;0;Vila Assunção;Cavalhada;259;0;148;28;100;159
8289;0;Vila Assunção;Cel. Aparício Borges;60;50;4;4;50;10
8290;0;Vila Assunção;Centro Histórico;255;0;53;33;150;105
8291;0;Vila Assunção;Chapéu do Sol;0;0;0;0;0;0
8292;0;Vila Assunção;Chácara das Pedras;50;0;26;14;0;50
8293;0;Vila Assunção;Cidade Baixa;101;0;51;20;0;101
8294;0;Vila Assunção;Costa e Silva;106;50;3;0;100;6
8295;0;Vila Assunção;Cristal;1366;400;338;107;950;416
8296;0;Vila Assunção;Cristo Redentor;110;50;35;24;50;60
8297;0;Vila Assunção;Espírito Santo;100;0;32;14;50;50
8298;0;Vila Assunção;Extrema;0;0;0;0;0;0
8299;0;Vila Assunção;Farrapos;0;0;0;0;0;0
8300;0;Vila Assunção;Farroupilha;100;50;0;0;100;0
8301;0;Vila Assunção;Floresta;0;0;0;0;0;0
8302;0;Vila Assunção;Glória;50;0;0;0;50;0
8303;0;Vila Assunção;Guarujá;50;0;0;0;50;0
8304;0;Vila Assunção;Higienópolis;101;0;62;26;0;101
8305;0;Vila Assunção;Humaitá;0;0;0;0;0;0
8306;0;Vila Assunção;Hípica;100;0;74;13;0;100
8307;0;Vila Assunção;Independência;100;50;50;0;100;0
8308;0;Vila Assunção;Ipanema;105;0;66;17;0;105
8309;0;Vila Assunção;Jardim Botânico;56;0;40;10;0;56
8310;0;Vila Assunção;Jardim Carvalho;51;0;30;12;0;51
8311;0;Vila Assunção;Jardim Europa;0;0;0;0;0;0
8312;0;Vila Assunção;Jardim Floresta;50;0;0;0;50;0
8313;0;Vila Assunção;Jardim Isabel;0;0;0;0;0;0
8314;0;Vila Assunção;Jardim Itú;0;0;0;0;0;0
8315;0;Vila Assunção;Jardim Leopoldina;53;0;28;16;0;53
8316;0;Vila Assunção;Jardim Lindóia;0;0;0;0;0;0
8317;0;Vila Assunção;Jardim Sabará;50;0;20;16;0;50
8318;0;Vila Assunção;Jardim São Pedro;0;0;0;0;0;0
8319;0;Vila Assunção;Jardim do Salso;0;0;0;0;0;0
8320;0;Vila Assunção;Lageado;0;0;0;0;0;0
8321;0;Vila Assunção;Lami;0;0;0;0;0;0
8322;0;Vila Assunção;Lomba do Pinheiro;51;0;29;14;0;51
8323;0;Vila Assunção;Medianeira;100;0;37;10;50;50
8324;0;Vila Assunção;Menino Deus;260;50;103;58;50;210
8325;0;Vila Assunção;Moinhos de Vento;50;0;29;19;0;50
8326;0;Vila Assunção;Mont'Serrat;51;0;29;16;0;51
8327;0;Vila Assunção;Morro Santana;110;0;66;20;0;110
8328;0;Vila Assunção;Mário Quintana;129;0;78;18;0;129
8329;0;Vila Assunção;Navegantes;0;0;0;0;0;0
8330;0;Vila Assunção;Nonoai;301;0;174;35;100;201
8331;0;Vila Assunção;Parque Santa Fé;0;0;0;0;0;0
8332;0;Vila Assunção;Partenon;160;50;37;15;100;60
8333;0;Vila Assunção;Passo D'Areia;10;0;6;1;0;10
8334;0;Vila Assunção;Passo das Pedras;9;0;5;1;0;9
8335;0;Vila Assunção;Pedra Redonda;0;0;0;0;0;0
8336;0;Vila Assunção;Petrópolis;110;50;7;3;100;10
8337;0;Vila Assunção;Pitinga;0;0;0;0;0;0
8338;0;Vila Assunção;Ponta Grossa;100;0;58;17;0;100
8339;0;Vila Assunção;Praia de Belas;0;0;0;0;0;0
8340;0;Vila Assunção;Restinga;117;0;42;9;50;67
8341;0;Vila Assunção;Rio Branco;5;0;3;2;0;5
8342;0;Vila Assunção;Rubem Berta;152;0;76;52;0;152
8343;0;Vila Assunção;Santa Cecília;0;0;0;0;0;0
8344;0;Vila Assunção;Santa Maria Goretti;0;0;0;0;0;0
8345;0;Vila Assunção;Santa Rosa de Lima;101;0;63;11;0;101
8346;0;Vila Assunção;Santa Tereza;260;50;58;19;150;110
8347;0;Vila Assunção;Santana;106;100;5;0;100;6
8348;0;Vila Assunção;Santo Antônio;0;0;0;0;0;0
8349;0;Vila Assunção;Sarandi;79;0;37;26;0;79
8350;0;Vila Assunção;Serraria;100;50;27;18;50;50
8351;0;Vila Assunção;São Caetano;0;0;0;0;0;0
8352;0;Vila Assunção;São Geraldo;50;0;40;8;0;50
8353;0;Vila Assunção;São José;106;0;61;18;0;106
8354;0;Vila Assunção;São João;50;0;23;17;0;50
8355;0;Vila Assunção;São Sebastião;0;0;0;0;0;0
8356;0;Vila Assunção;Sétimo Céu;100;50;22;7;50;50
8357;0;Vila Assunção;Teresópolis;100;0;59;19;0;100
8358;0;Vila Assunção;Tristeza;1307;150;568;249;400;907
8359;0;Vila Assunção;Três Figueiras;150;50;62;22;50;100
8360;0;Vila Assunção;Vila Assunção;2900;1100;554;232;2000;900
8361;0;Vila Assunção;Vila Conceição;150;0;91;40;0;150
8362;0;Vila Assunção;Vila Ipiranga;51;0;31;8;0;51
8363;0;Vila Assunção;Vila Jardim;55;0;31;13;0;55
8364;0;Vila Assunção;Vila João Pessoa;0;0;0;0;0;0
8365;0;Vila Assunção;Vila Nova;476;50;252;111;50;426
8366;0;Vila Conceição;Aberta dos Morros;50;0;25;8;0;50
8367;0;Vila Conceição;Agronomia;0;0;0;0;0;0
8368;0;Vila Conceição;Anchieta;0;0;0;0;0;0
8369;0;Vila Conceição;Arquipélago;0;0;0;0;0;0
8370;0;Vila Conceição;Auxiliadora;0;0;0;0;0;0
8371;0;Vila Conceição;Azenha;70;0;25;14;20;50
8372;0;Vila Conceição;Bela Vista;52;0;33;14;0;52
8373;0;Vila Conceição;Belém Novo;100;0;51;24;0;100
8374;0;Vila Conceição;Belém Velho;3;0;3;0;0;3
8375;0;Vila Conceição;Boa Vista;0;0;0;0;0;0
8376;0;Vila Conceição;Boa Vista do Sul;50;0;28;9;0;50
8377;0;Vila Conceição;Bom Fim;50;0;21;22;0;50
8378;0;Vila Conceição;Bom Jesus;7;0;5;0;0;7
8379;0;Vila Conceição;Camaquã;595;95;260;85;145;450
8380;0;Vila Conceição;Campo Novo;0;0;0;0;0;0
8381;0;Vila Conceição;Cascata;0;0;0;0;0;0
8382;0;Vila Conceição;Cavalhada;457;96;201;79;96;361
8383;0;Vila Conceição;Cel. Aparício Borges;12;0;9;1;0;12
8384;0;Vila Conceição;Centro Histórico;149;46;54;31;46;103
8385;0;Vila Conceição;Chapéu do Sol;0;0;0;0;0;0
8386;0;Vila Conceição;Chácara das Pedras;50;0;24;12;0;50
8387;0;Vila Conceição;Cidade Baixa;51;0;25;12;0;51
8388;0;Vila Conceição;Costa e Silva;5;0;4;1;0;5
8389;0;Vila Conceição;Cristal;266;96;95;40;96;170
8390;0;Vila Conceição;Cristo Redentor;9;0;4;2;0;9
8391;0;Vila Conceição;Espírito Santo;191;141;30;5;141;50
8392;0;Vila Conceição;Extrema;0;0;0;0;0;0
8393;0;Vila Conceição;Farrapos;922;279;293;181;342;261
8394;0;Vila Conceição;Farroupilha;0;0;0;0;0;0
8395;0;Vila Conceição;Floresta;0;0;0;0;0;0
8396;0;Vila Conceição;Glória;0;0;0;0;0;0
8397;0;Vila Conceição;Guarujá;199;0;89;37;49;150
8398;0;Vila Conceição;Higienópolis;50;0;24;10;0;50
8399;0;Vila Conceição;Humaitá;0;0;0;0;0;0
8400;0;Vila Conceição;Hípica;50;0;33;11;0;50
8401;0;Vila Conceição;Independência;0;0;0;0;0;0
8402;0;Vila Conceição;Ipanema;1010;145;516;195;156;854
8403;0;Vila Conceição;Jardim Botânico;6;0;1;3;0;6
8404;0;Vila Conceição;Jardim Carvalho;0;0;0;0;0;0
8405;0;Vila Conceição;Jardim Europa;0;0;0;0;0;0
8406;0;Vila Conceição;Jardim Floresta;0;0;0;0;0;0
8407;0;Vila Conceição;Jardim Isabel;96;46;30;10;46;50
8408;0;Vila Conceição;Jardim Itú;200;0;137;43;0;200
8409;0;Vila Conceição;Jardim Leopoldina;2;0;1;0;0;2
8410;0;Vila Conceição;Jardim Lindóia;0;0;0;0;0;0
8411;0;Vila Conceição;Jardim Sabará;0;0;0;0;0;0
8412;0;Vila Conceição;Jardim São Pedro;50;0;28;11;0;50
8413;0;Vila Conceição;Jardim do Salso;0;0;0;0;0;0
8414;0;Vila Conceição;Lageado;0;0;0;0;0;0
8415;0;Vila Conceição;Lami;0;0;0;0;0;0
8416;0;Vila Conceição;Lomba do Pinheiro;2;0;2;0;0;2
8417;0;Vila Conceição;Medianeira;0;0;0;0;0;0
8418;0;Vila Conceição;Menino Deus;111;0;38;21;49;62
8419;0;Vila Conceição;Moinhos de Vento;0;0;0;0;0;0
8420;0;Vila Conceição;Mont'Serrat;50;0;23;10;0;50
8421;0;Vila Conceição;Morro Santana;9;0;4;1;0;9
8422;0;Vila Conceição;Mário Quintana;136;46;39;6;66;70
8423;0;Vila Conceição;Navegantes;50;0;27;10;0;50
8424;0;Vila Conceição;Nonoai;150;49;55;21;49;101
8425;0;Vila Conceição;Parque Santa Fé;50;0;27;16;0;50
8426;0;Vila Conceição;Partenon;157;0;96;31;0;157
8427;0;Vila Conceição;Passo D'Areia;179;46;50;40;67;112
8428;0;Vila Conceição;Passo das Pedras;57;0;31;17;0;57
8429;0;Vila Conceição;Pedra Redonda;296;46;173;39;96;200
8430;0;Vila Conceição;Petrópolis;154;0;38;20;92;62
8431;0;Vila Conceição;Pitinga;0;0;0;0;0;0
8432;0;Vila Conceição;Ponta Grossa;49;0;0;0;49;0
8433;0;Vila Conceição;Praia de Belas;0;0;0;0;0;0
8434;0;Vila Conceição;Restinga;216;0;94;22;49;167
8435;0;Vila Conceição;Rio Branco;3;0;2;1;0;3
8436;0;Vila Conceição;Rubem Berta;150;0;76;53;0;150
8437;0;Vila Conceição;Santa Cecília;0;0;0;0;0;0
8438;0;Vila Conceição;Santa Maria Goretti;0;0;0;0;0;0
8439;0;Vila Conceição;Santa Rosa de Lima;100;0;64;15;0;100
8440;0;Vila Conceição;Santa Tereza;111;0;72;18;0;111
8441;0;Vila Conceição;Santana;5;0;4;1;0;5
8442;0;Vila Conceição;Santo Antônio;0;0;0;0;0;0
8443;0;Vila Conceição;Sarandi;66;0;40;17;0;66
8444;0;Vila Conceição;Serraria;100;50;19;19;50;50
8445;0;Vila Conceição;São Caetano;50;0;38;10;0;50
8446;0;Vila Conceição;São Geraldo;50;0;27;15;0;50
8447;0;Vila Conceição;São José;54;0;30;7;0;54
8448;0;Vila Conceição;São João;0;0;0;0;0;0
8449;0;Vila Conceição;São Sebastião;0;0;0;0;0;0
8450;0;Vila Conceição;Sétimo Céu;246;96;56;28;146;100
8451;0;Vila Conceição;Teresópolis;50;0;28;12;0;50
8452;0;Vila Conceição;Tristeza;744;140;297;141;237;507
8453;0;Vila Conceição;Três Figueiras;0;0;0;0;0;0
8454;0;Vila Conceição;Vila Assunção;150;0;91;40;0;150
8455;0;Vila Conceição;Vila Conceição;495;100;106;64;295;200
8456;0;Vila Conceição;Vila Ipiranga;96;46;26;12;46;50
8457;0;Vila Conceição;Vila Jardim;53;0;34;17;0;53
8458;0;Vila Conceição;Vila João Pessoa;96;46;27;12;46;50
8459;0;Vila Conceição;Vila Nova;117;0;66;25;0;117
8460;0;Vila Ipiranga;Aberta dos Morros;100;0;32;7;50;50
8461;0;Vila Ipiranga;Agronomia;0;0;0;0;0;0
8462;0;Vila Ipiranga;Anchieta;50;0;23;13;0;50
8463;0;Vila Ipiranga;Arquipélago;50;0;31;7;0;50
8464;0;Vila Ipiranga;Auxiliadora;100;50;0;0;100;0
8465;0;Vila Ipiranga;Azenha;200;50;50;0;200;0
8466;0;Vila Ipiranga;Bela Vista;250;100;0;0;250;0
8467;0;Vila Ipiranga;Belém Novo;50;0;32;10;0;50
8468;0;Vila Ipiranga;Belém Velho;258;100;68;19;150;108
8469;0;Vila Ipiranga;Boa Vista;643;150;194;62;342;301
8470;0;Vila Ipiranga;Boa Vista do Sul;150;0;80;40;0;150
8471;0;Vila Ipiranga;Bom Fim;100;50;26;13;50;50
8472;0;Vila Ipiranga;Bom Jesus;1011;350;327;124;450;561
8473;0;Vila Ipiranga;Camaquã;50;50;0;0;50;0
8474;0;Vila Ipiranga;Campo Novo;150;50;0;0;150;0
8475;0;Vila Ipiranga;Cascata;50;50;0;0;50;0
8476;0;Vila Ipiranga;Cavalhada;225;0;143;53;0;225
8477;0;Vila Ipiranga;Cel. Aparício Borges;69;50;10;2;50;19
8478;0;Vila Ipiranga;Centro Histórico;307;50;99;51;100;207
8479;0;Vila Ipiranga;Chapéu do Sol;0;0;0;0;0;0
8480;0;Vila Ipiranga;Chácara das Pedras;450;100;23;17;400;50
8481;0;Vila Ipiranga;Cidade Baixa;51;0;28;13;0;51
8482;0;Vila Ipiranga;Costa e Silva;411;150;158;26;150;261
8483;0;Vila Ipiranga;Cristal;77;50;15;5;50;27
8484;0;Vila Ipiranga;Cristo Redentor;3268;850;959;400;1600;1668
8485;0;Vila Ipiranga;Espírito Santo;0;0;0;0;0;0
8486;0;Vila Ipiranga;Extrema;50;0;31;14;0;50
8487;0;Vila Ipiranga;Farrapos;50;0;31;11;0;50
8488;0;Vila Ipiranga;Farroupilha;100;50;25;9;50;50
8489;0;Vila Ipiranga;Floresta;50;0;30;13;0;50
8490;0;Vila Ipiranga;Glória;101;50;32;14;50;51
8491;0;Vila Ipiranga;Guarujá;0;0;0;0;0;0
8492;0;Vila Ipiranga;Higienópolis;250;100;58;32;150;100
8493;0;Vila Ipiranga;Humaitá;150;50;75;9;50;100
8494;0;Vila Ipiranga;Hípica;50;0;29;11;0;50
8495;0;Vila Ipiranga;Independência;150;50;46;35;50;100
8496;0;Vila Ipiranga;Ipanema;6;0;5;1;0;6
8497;0;Vila Ipiranga;Jardim Botânico;258;50;60;35;150;108
8498;0;Vila Ipiranga;Jardim Carvalho;202;150;32;15;150;52
8499;0;Vila Ipiranga;Jardim Europa;3250;500;1547;608;700;2550
8500;0;Vila Ipiranga;Jardim Floresta;400;50;226;38;200;200
8501;0;Vila Ipiranga;Jardim Isabel;50;0;27;13;0;50
8502;0;Vila Ipiranga;Jardim Itú;1402;350;597;246;400;1002
8503;0;Vila Ipiranga;Jardim Leopoldina;106;0;67;21;0;106
8504;0;Vila Ipiranga;Jardim Lindóia;250;0;87;38;100;150
8505;0;Vila Ipiranga;Jardim Sabará;850;300;307;99;400;450
8506;0;Vila Ipiranga;Jardim São Pedro;150;100;31;6;100;50
8507;0;Vila Ipiranga;Jardim do Salso;0;0;0;0;0;0
8508;0;Vila Ipiranga;Lageado;0;0;0;0;0;0
8509;0;Vila Ipiranga;Lami;100;0;58;24;0;100
8510;0;Vila Ipiranga;Lomba do Pinheiro;306;0;135;42;50;256
8511;0;Vila Ipiranga;Medianeira;250;50;124;41;50;200
8512;0;Vila Ipiranga;Menino Deus;219;0;127;59;0;219
8513;0;Vila Ipiranga;Moinhos de Vento;100;50;25;23;50;50
8514;0;Vila Ipiranga;Mont'Serrat;250;50;94;44;100;150
8515;0;Vila Ipiranga;Morro Santana;219;50;94;31;50;169
8516;0;Vila Ipiranga;Mário Quintana;127;0;78;14;0;127
8517;0;Vila Ipiranga;Navegantes;0;0;0;0;0;0
8518;0;Vila Ipiranga;Nonoai;451;150;128;39;250;201
8519;0;Vila Ipiranga;Parque Santa Fé;0;0;0;0;0;0
8520;0;Vila Ipiranga;Partenon;164;50;66;15;50;114
8521;0;Vila Ipiranga;Passo D'Areia;616;400;73;67;450;166
8522;0;Vila Ipiranga;Passo das Pedras;516;300;79;43;350;166
8523;0;Vila Ipiranga;Pedra Redonda;0;0;0;0;0;0
8524;0;Vila Ipiranga;Petrópolis;368;100;122;60;150;218
8525;0;Vila Ipiranga;Pitinga;100;0;59;25;0;100
8526;0;Vila Ipiranga;Ponta Grossa;0;0;0;0;0;0
8527;0;Vila Ipiranga;Praia de Belas;100;0;31;16;50;50
8528;0;Vila Ipiranga;Restinga;178;50;51;11;100;78
8529;0;Vila Ipiranga;Rio Branco;157;0;60;33;50;107
8530;0;Vila Ipiranga;Rubem Berta;301;0;134;126;0;301
8531;0;Vila Ipiranga;Santa Cecília;150;0;80;36;0;150
8532;0;Vila Ipiranga;Santa Maria Goretti;350;150;87;31;200;150
8533;0;Vila Ipiranga;Santa Rosa de Lima;301;50;123;37;100;201
8534;0;Vila Ipiranga;Santa Tereza;171;0;65;33;50;121
8535;0;Vila Ipiranga;Santana;209;0;114;27;100;109
8536;0;Vila Ipiranga;Santo Antônio;100;0;65;18;0;100
8537;0;Vila Ipiranga;Sarandi;228;50;68;36;100;128
8538;0;Vila Ipiranga;Serraria;50;50;0;0;50;0
8539;0;Vila Ipiranga;São Caetano;50;0;0;0;50;0
8540;0;Vila Ipiranga;São Geraldo;50;50;0;0;50;0
8541;0;Vila Ipiranga;São José;10;0;5;3;0;10
8542;0;Vila Ipiranga;São João;150;0;84;32;0;150
8543;0;Vila Ipiranga;São Sebastião;750;50;392;131;50;700
8544;0;Vila Ipiranga;Sétimo Céu;0;0;0;0;0;0
8545;0;Vila Ipiranga;Teresópolis;150;100;33;9;100;50
8546;0;Vila Ipiranga;Tristeza;11;0;7;1;0;11
8547;0;Vila Ipiranga;Três Figueiras;450;50;206;80;100;350
8548;0;Vila Ipiranga;Vila Assunção;50;0;31;7;0;50
8549;0;Vila Ipiranga;Vila Conceição;100;50;26;12;50;50
8550;0;Vila Ipiranga;Vila Ipiranga;8901;1700;3477;1470;2900;6001
8551;0;Vila Ipiranga;Vila Jardim;2258;250;1014;453;450;1808
8552;0;Vila Ipiranga;Vila João Pessoa;101;0;61;24;0;101
8553;0;Vila Ipiranga;Vila Nova;226;100;82;21;100;126
8554;0;Vila Jardim;Aberta dos Morros;50;0;33;10;0;50
8555;0;Vila Jardim;Agronomia;148;50;22;19;98;50
8556;0;Vila Jardim;Anchieta;50;0;29;14;0;50
8557;0;Vila Jardim;Arquipélago;100;50;0;0;100;0
8558;0;Vila Jardim;Auxiliadora;228;0;107;45;50;178
8559;0;Vila Jardim;Azenha;76;0;44;22;0;76
8560;0;Vila Jardim;Bela Vista;1;0;1;0;0;1
8561;0;Vila Jardim;Belém Novo;0;0;0;0;0;0
8562;0;Vila Jardim;Belém Velho;54;0;3;1;50;4
8563;0;Vila Jardim;Boa Vista;227;150;41;20;150;77
8564;0;Vila Jardim;Boa Vista do Sul;0;0;0;0;0;0
8565;0;Vila Jardim;Bom Fim;163;0;42;15;87;76
8566;0;Vila Jardim;Bom Jesus;1676;790;346;162;1064;612
8567;0;Vila Jardim;Camaquã;101;0;25;10;50;51
8568;0;Vila Jardim;Campo Novo;50;0;0;0;50;0
8569;0;Vila Jardim;Cascata;50;50;0;0;50;0
8570;0;Vila Jardim;Cavalhada;66;0;31;22;0;66
8571;0;Vila Jardim;Cel. Aparício Borges;75;0;22;6;37;38
8572;0;Vila Jardim;Centro Histórico;156;50;55;26;50;106
8573;0;Vila Jardim;Chapéu do Sol;0;0;0;0;0;0
8574;0;Vila Jardim;Chácara das Pedras;1484;727;325;143;992;492
8575;0;Vila Jardim;Cidade Baixa;102;0;25;20;50;52
8576;0;Vila Jardim;Costa e Silva;127;0;15;5;100;27
8577;0;Vila Jardim;Cristal;115;0;34;14;50;65
8578;0;Vila Jardim;Cristo Redentor;433;147;142;60;197;236
8579;0;Vila Jardim;Espírito Santo;0;0;0;0;0;0
8580;0;Vila Jardim;Extrema;0;0;0;0;0;0
8581;0;Vila Jardim;Farrapos;12941;1957;6238;2843;1835;7978
8582;0;Vila Jardim;Farroupilha;0;0;0;0;0;0
8583;0;Vila Jardim;Floresta;68;0;11;6;48;20
8584;0;Vila Jardim;Glória;75;0;14;7;48;27
8585;0;Vila Jardim;Guarujá;150;50;26;14;100;50
8586;0;Vila Jardim;Higienópolis;128;0;63;32;0;128
8587;0;Vila Jardim;Humaitá;50;0;29;19;0;50
8588;0;Vila Jardim;Hípica;63;0;32;26;0;63
8589;0;Vila Jardim;Independência;50;0;0;0;50;0
8590;0;Vila Jardim;Ipanema;54;0;2;1;50;4
8591;0;Vila Jardim;Jardim Botânico;5;0;3;0;0;5
8592;0;Vila Jardim;Jardim Carvalho;377;0;225;51;137;240
8593;0;Vila Jardim;Jardim Europa;648;149;218;112;248;400
8594;0;Vila Jardim;Jardim Floresta;88;0;26;16;37;51
8595;0;Vila Jardim;Jardim Isabel;0;0;0;0;0;0
8596;0;Vila Jardim;Jardim Itú;1140;100;550;253;150;990
8597;0;Vila Jardim;Jardim Leopoldina;5;0;2;3;0;5
8598;0;Vila Jardim;Jardim Lindóia;224;50;95;53;50;174
8599;0;Vila Jardim;Jardim Sabará;2764;800;469;181;2074;690
8600;0;Vila Jardim;Jardim São Pedro;100;0;53;27;0;100
8601;0;Vila Jardim;Jardim do Salso;208;0;74;16;100;108
8602;0;Vila Jardim;Lageado;0;0;0;0;0;0
8603;0;Vila Jardim;Lami;50;0;21;14;0;50
8604;0;Vila Jardim;Lomba do Pinheiro;108;50;36;10;50;58
8605;0;Vila Jardim;Medianeira;0;0;0;0;0;0
8606;0;Vila Jardim;Menino Deus;104;0;12;2;87;17
8607;0;Vila Jardim;Moinhos de Vento;196;50;69;45;50;146
8608;0;Vila Jardim;Mont'Serrat;197;50;55;18;100;97
8609;0;Vila Jardim;Morro Santana;176;0;80;20;50;126
8610;0;Vila Jardim;Mário Quintana;211;48;62;21;98;113
8611;0;Vila Jardim;Navegantes;0;0;0;0;0;0
8612;0;Vila Jardim;Nonoai;98;0;24;16;50;48
8613;0;Vila Jardim;Parque Santa Fé;48;48;0;0;48;0
8614;0;Vila Jardim;Partenon;172;50;26;3;137;35
8615;0;Vila Jardim;Passo D'Areia;219;0;86;78;0;219
8616;0;Vila Jardim;Passo das Pedras;428;194;153;40;244;184
8617;0;Vila Jardim;Pedra Redonda;50;0;32;16;0;50
8618;0;Vila Jardim;Petrópolis;455;195;84;46;294;161
8619;0;Vila Jardim;Pitinga;50;0;31;17;0;50
8620;0;Vila Jardim;Ponta Grossa;70;0;37;19;0;70
8621;0;Vila Jardim;Praia de Belas;100;0;31;16;50;50
8622;0;Vila Jardim;Restinga;189;98;54;22;98;91
8623;0;Vila Jardim;Rio Branco;203;0;9;5;185;18
8624;0;Vila Jardim;Rubem Berta;99;49;49;1;98;1
8625;0;Vila Jardim;Santa Cecília;248;48;111;57;48;200
8626;0;Vila Jardim;Santa Maria Goretti;120;50;13;0;100;20
8627;0;Vila Jardim;Santa Rosa de Lima;137;50;20;9;98;39
8628;0;Vila Jardim;Santa Tereza;231;48;83;18;98;133
8629;0;Vila Jardim;Santana;55;0;31;19;0;55
8630;0;Vila Jardim;Santo Antônio;1;0;1;0;0;1
8631;0;Vila Jardim;Sarandi;413;100;107;50;222;191
8632;0;Vila Jardim;Serraria;0;0;0;0;0;0
8633;0;Vila Jardim;São Caetano;0;0;0;0;0;0
8634;0;Vila Jardim;São Geraldo;98;50;0;0;98;0
8635;0;Vila Jardim;São José;276;146;41;20;196;80
8636;0;Vila Jardim;São João;103;0;30;14;50;53
8637;0;Vila Jardim;São Sebastião;276;100;80;31;150;126
8638;0;Vila Jardim;Sétimo Céu;50;0;24;10;0;50
8639;0;Vila Jardim;Teresópolis;53;0;27;11;0;53
8640;0;Vila Jardim;Tristeza;7;0;3;3;0;7
8641;0;Vila Jardim;Três Figueiras;306;150;65;17;198;108
8642;0;Vila Jardim;Vila Assunção;26;0;12;8;0;26
8643;0;Vila Jardim;Vila Conceição;50;0;33;16;0;50
8644;0;Vila Jardim;Vila Ipiranga;1531;250;599;266;437;1094
8645;0;Vila Jardim;Vila Jardim;5145;298;2384;1184;659;4486
8646;0;Vila Jardim;Vila João Pessoa;87;0;26;10;37;50
8647;0;Vila Jardim;Vila Nova;81;50;21;4;50;31
8648;0;Vila João Pessoa;Aberta dos Morros;50;0;0;0;50;0
8649;0;Vila João Pessoa;Agronomia;450;100;114;52;250;200
8650;0;Vila João Pessoa;Anchieta;100;0;65;20;0;100
8651;0;Vila João Pessoa;Arquipélago;150;0;39;10;100;50
8652;0;Vila João Pessoa;Auxiliadora;130;50;39;16;50;80
8653;0;Vila João Pessoa;Azenha;182;100;53;18;100;82
8654;0;Vila João Pessoa;Bela Vista;54;50;3;1;50;4
8655;0;Vila João Pessoa;Belém Novo;103;0;29;12;50;53
8656;0;Vila João Pessoa;Belém Velho;161;0;98;35;0;161
8657;0;Vila João Pessoa;Boa Vista;114;0;45;11;50;64
8658;0;Vila João Pessoa;Boa Vista do Sul;50;0;27;10;0;50
8659;0;Vila João Pessoa;Bom Fim;150;0;55;25;50;100
8660;0;Vila João Pessoa;Bom Jesus;458;100;117;52;250;208
8661;0;Vila João Pessoa;Camaquã;91;0;26;7;50;41
8662;0;Vila João Pessoa;Campo Novo;0;0;0;0;0;0
8663;0;Vila João Pessoa;Cascata;840;200;292;91;350;490
8664;0;Vila João Pessoa;Cavalhada;109;0;66;26;0;109
8665;0;Vila João Pessoa;Cel. Aparício Borges;3032;700;971;269;1582;1450
8666;0;Vila João Pessoa;Centro Histórico;211;0;87;36;50;161
8667;0;Vila João Pessoa;Chapéu do Sol;0;0;0;0;0;0
8668;0;Vila João Pessoa;Chácara das Pedras;53;0;30;12;0;53
8669;0;Vila João Pessoa;Cidade Baixa;166;100;45;11;100;66
8670;0;Vila João Pessoa;Costa e Silva;165;100;12;2;150;15
8671;0;Vila João Pessoa;Cristal;14;0;9;3;0;14
8672;0;Vila João Pessoa;Cristo Redentor;64;50;12;2;50;14
8673;0;Vila João Pessoa;Espírito Santo;0;0;0;0;0;0
8674;0;Vila João Pessoa;Extrema;100;0;55;18;0;100
8675;0;Vila João Pessoa;Farrapos;7000;0;4144;1312;0;7000
8676;0;Vila João Pessoa;Farroupilha;50;50;0;0;50;0
8677;0;Vila João Pessoa;Floresta;87;0;57;16;0;87
8678;0;Vila João Pessoa;Glória;806;150;314;121;250;556
8679;0;Vila João Pessoa;Guarujá;0;0;0;0;0;0
8680;0;Vila João Pessoa;Higienópolis;28;0;13;6;0;28
8681;0;Vila João Pessoa;Humaitá;0;0;0;0;0;0
8682;0;Vila João Pessoa;Hípica;105;50;36;16;50;55
8683;0;Vila João Pessoa;Independência;50;0;0;0;50;0
8684;0;Vila João Pessoa;Ipanema;63;0;9;3;50;13
8685;0;Vila João Pessoa;Jardim Botânico;809;250;277;100;350;459
8686;0;Vila João Pessoa;Jardim Carvalho;890;50;427;152;150;740
8687;0;Vila João Pessoa;Jardim Europa;100;0;69;16;0;100
8688;0;Vila João Pessoa;Jardim Floresta;0;0;0;0;0;0
8689;0;Vila João Pessoa;Jardim Isabel;126;0;53;7;50;76
8690;0;Vila João Pessoa;Jardim Itú;153;50;62;24;50;103
8691;0;Vila João Pessoa;Jardim Leopoldina;7;0;4;0;0;7
8692;0;Vila João Pessoa;Jardim Lindóia;76;0;44;14;0;76
8693;0;Vila João Pessoa;Jardim Sabará;201;50;67;14;100;101
8694;0;Vila João Pessoa;Jardim São Pedro;50;50;0;0;50;0
8695;0;Vila João Pessoa;Jardim do Salso;959;250;400;111;400;559
8696;0;Vila João Pessoa;Lageado;50;0;24;11;0;50
8697;0;Vila João Pessoa;Lami;0;0;0;0;0;0
8698;0;Vila João Pessoa;Lomba do Pinheiro;586;100;235;79;200;386
8699;0;Vila João Pessoa;Medianeira;476;200;138;58;250;226
8700;0;Vila João Pessoa;Menino Deus;141;0;53;22;50;91
8701;0;Vila João Pessoa;Moinhos de Vento;100;100;0;0;100;0
8702;0;Vila João Pessoa;Mont'Serrat;252;100;69;19;150;102
8703;0;Vila João Pessoa;Morro Santana;14;0;6;3;0;14
8704;0;Vila João Pessoa;Mário Quintana;144;0;66;16;50;94
8705;0;Vila João Pessoa;Navegantes;12;0;5;3;0;12
8706;0;Vila João Pessoa;Nonoai;155;0;56;16;50;105
8707;0;Vila João Pessoa;Parque Santa Fé;53;0;33;12;0;53
8708;0;Vila João Pessoa;Partenon;1581;200;549;198;700;881
8709;0;Vila João Pessoa;Passo D'Areia;241;50;97;52;50;191
8710;0;Vila João Pessoa;Passo das Pedras;63;0;40;9;0;63
8711;0;Vila João Pessoa;Pedra Redonda;100;0;58;15;0;100
8712;0;Vila João Pessoa;Petrópolis;192;50;55;19;100;92
8713;0;Vila João Pessoa;Pitinga;0;0;0;0;0;0
8714;0;Vila João Pessoa;Ponta Grossa;100;0;65;26;0;100
8715;0;Vila João Pessoa;Praia de Belas;0;0;0;0;0;0
8716;0;Vila João Pessoa;Restinga;137;0;83;26;0;137
8717;0;Vila João Pessoa;Rio Branco;114;0;8;3;100;14
8718;0;Vila João Pessoa;Rubem Berta;253;50;62;22;150;103
8719;0;Vila João Pessoa;Santa Cecília;150;50;53;17;50;100
8720;0;Vila João Pessoa;Santa Maria Goretti;0;0;0;0;0;0
8721;0;Vila João Pessoa;Santa Rosa de Lima;128;50;11;5;100;28
8722;0;Vila João Pessoa;Santa Tereza;271;100;63;29;150;121
8723;0;Vila João Pessoa;Santana;290;50;117;41;100;190
8724;0;Vila João Pessoa;Santo Antônio;252;100;34;9;200;52
8725;0;Vila João Pessoa;Sarandi;16;0;6;9;0;16
8726;0;Vila João Pessoa;Serraria;76;0;15;3;50;26
8727;0;Vila João Pessoa;São Caetano;50;0;23;9;0;50
8728;0;Vila João Pessoa;São Geraldo;100;50;34;12;50;50
8729;0;Vila João Pessoa;São José;1896;750;243;37;1663;233
8730;0;Vila João Pessoa;São João;100;50;32;8;50;50
8731;0;Vila João Pessoa;São Sebastião;50;0;30;8;0;50
8732;0;Vila João Pessoa;Sétimo Céu;0;0;0;0;0;0
8733;0;Vila João Pessoa;Teresópolis;350;0;90;36;200;150
8734;0;Vila João Pessoa;Tristeza;15;0;12;1;0;15
8735;0;Vila João Pessoa;Três Figueiras;153;100;31;12;100;53
8736;0;Vila João Pessoa;Vila Assunção;0;0;0;0;0;0
8737;0;Vila João Pessoa;Vila Conceição;100;50;27;12;50;50
8738;0;Vila João Pessoa;Vila Ipiranga;101;0;61;24;0;101
8739;0;Vila João Pessoa;Vila Jardim;62;0;8;4;50;12
8740;0;Vila João Pessoa;Vila João Pessoa;3701;1100;777;246;2500;1201
8741;0;Vila João Pessoa;Vila Nova;213;0;33;10;150;63
8742;0;Vila Nova;Aberta dos Morros;670;50;240;81;250;420
8743;0;Vila Nova;Agronomia;200;0;107;37;0;200
8744;0;Vila Nova;Anchieta;304;0;128;60;50;254
8745;0;Vila Nova;Arquipélago;100;100;0;0;100;0
8746;0;Vila Nova;Auxiliadora;73;0;34;20;0;73
8747;0;Vila Nova;Azenha;250;0;77;34;100;150
8748;0;Vila Nova;Bela Vista;172;100;35;19;100;72
8749;0;Vila Nova;Belém Novo;100;50;0;0;100;0
8750;0;Vila Nova;Belém Velho;4964;686;2018;716;1291;3673
8751;0;Vila Nova;Boa Vista;50;0;32;11;0;50
8752;0;Vila Nova;Boa Vista do Sul;0;0;0;0;0;0
8753;0;Vila Nova;Bom Fim;50;0;26;8;0;50
8754;0;Vila Nova;Bom Jesus;252;50;69;37;100;152
8755;0;Vila Nova;Camaquã;143;0;72;26;0;143
8756;0;Vila Nova;Campo Novo;2032;247;677;235;832;1200
8757;0;Vila Nova;Cascata;1024;200;207;75;724;300
8758;0;Vila Nova;Cavalhada;872;50;432;154;198;674
8759;0;Vila Nova;Cel. Aparício Borges;714;100;309;115;237;477
8760;0;Vila Nova;Centro Histórico;234;50;94;29;137;97
8761;0;Vila Nova;Chapéu do Sol;50;0;30;6;0;50
8762;0;Vila Nova;Chácara das Pedras;0;0;0;0;0;0
8763;0;Vila Nova;Cidade Baixa;52;0;1;1;50;2
8764;0;Vila Nova;Costa e Silva;315;50;109;51;100;215
8765;0;Vila Nova;Cristal;441;98;167;51;148;293
8766;0;Vila Nova;Cristo Redentor;131;50;19;4;100;31
8767;0;Vila Nova;Espírito Santo;772;200;106;32;600;172
8768;0;Vila Nova;Extrema;250;100;102;22;150;100
8769;0;Vila Nova;Farrapos;24255;7821;9707;3545;4576;12716
8770;0;Vila Nova;Farroupilha;0;0;0;0;0;0
8771;0;Vila Nova;Floresta;50;50;0;0;50;0
8772;0;Vila Nova;Glória;535;98;141;47;285;250
8773;0;Vila Nova;Guarujá;150;50;56;18;50;100
8774;0;Vila Nova;Higienópolis;50;0;25;16;0;50
8775;0;Vila Nova;Humaitá;63;0;31;14;0;63
8776;0;Vila Nova;Hípica;520;50;227;67;148;372
8777;0;Vila Nova;Independência;50;0;31;10;0;50
8778;0;Vila Nova;Ipanema;772;50;326;128;200;572
8779;0;Vila Nova;Jardim Botânico;102;0;60;21;0;102
8780;0;Vila Nova;Jardim Carvalho;324;100;97;35;148;176
8781;0;Vila Nova;Jardim Europa;150;0;72;28;0;150
8782;0;Vila Nova;Jardim Floresta;50;0;0;0;50;0
8783;0;Vila Nova;Jardim Isabel;280;100;79;18;150;130
8784;0;Vila Nova;Jardim Itú;50;0;0;0;50;0
8785;0;Vila Nova;Jardim Leopoldina;101;0;22;15;50;51
8786;0;Vila Nova;Jardim Lindóia;100;0;57;23;0;100
8787;0;Vila Nova;Jardim Sabará;100;50;0;0;100;0
8788;0;Vila Nova;Jardim São Pedro;54;0;31;14;0;54
8789;0;Vila Nova;Jardim do Salso;226;50;59;28;100;126
8790;0;Vila Nova;Lageado;98;48;26;8;48;50
8791;0;Vila Nova;Lami;200;0;112;34;0;200
8792;0;Vila Nova;Lomba do Pinheiro;297;99;108;16;195;102
8793;0;Vila Nova;Medianeira;150;50;36;12;100;50
8794;0;Vila Nova;Menino Deus;158;50;32;13;96;62
8795;0;Vila Nova;Moinhos de Vento;150;0;65;29;0;150
8796;0;Vila Nova;Mont'Serrat;87;0;0;0;87;0
8797;0;Vila Nova;Morro Santana;55;0;23;10;0;55
8798;0;Vila Nova;Mário Quintana;445;49;169;60;148;297
8799;0;Vila Nova;Navegantes;100;0;30;8;50;50
8800;0;Vila Nova;Nonoai;859;148;392;124;198;661
8801;0;Vila Nova;Parque Santa Fé;150;50;28;11;100;50
8802;0;Vila Nova;Partenon;181;0;51;14;96;85
8803;0;Vila Nova;Passo D'Areia;106;100;2;2;100;6
8804;0;Vila Nova;Passo das Pedras;92;50;37;2;87;5
8805;0;Vila Nova;Pedra Redonda;150;0;57;17;50;100
8806;0;Vila Nova;Petrópolis;325;49;129;55;98;227
8807;0;Vila Nova;Pitinga;0;0;0;0;0;0
8808;0;Vila Nova;Ponta Grossa;91;0;47;25;0;91
8809;0;Vila Nova;Praia de Belas;100;50;32;9;50;50
8810;0;Vila Nova;Restinga;649;144;196;27;454;195
8811;0;Vila Nova;Rio Branco;1;0;1;0;0;1
8812;0;Vila Nova;Rubem Berta;132;50;49;26;50;82
8813;0;Vila Nova;Santa Cecília;126;0;72;26;0;126
8814;0;Vila Nova;Santa Maria Goretti;350;50;161;64;50;300
8815;0;Vila Nova;Santa Rosa de Lima;250;50;106;45;50;200
8816;0;Vila Nova;Santa Tereza;223;48;111;26;98;125
8817;0;Vila Nova;Santana;252;100;29;8;200;52
8818;0;Vila Nova;Santo Antônio;104;50;19;20;50;54
8819;0;Vila Nova;Sarandi;360;48;145;63;98;262
8820;0;Vila Nova;Serraria;183;0;94;45;0;183
8821;0;Vila Nova;São Caetano;50;0;0;0;50;0
8822;0;Vila Nova;São Geraldo;50;0;0;0;50;0
8823;0;Vila Nova;São José;291;0;174;58;50;241
8824;0;Vila Nova;São João;50;50;0;0;50;0
8825;0;Vila Nova;São Sebastião;200;0;132;27;50;150
8826;0;Vila Nova;Sétimo Céu;213;0;90;42;50;163
8827;0;Vila Nova;Teresópolis;1688;150;710;224;450;1238
8828;0;Vila Nova;Tristeza;525;48;266;134;48;477
8829;0;Vila Nova;Três Figueiras;0;0;0;0;0;0
8830;0;Vila Nova;Vila Assunção;342;50;170;74;50;292
8831;0;Vila Nova;Vila Conceição;100;0;60;21;0;100
8832;0;Vila Nova;Vila Ipiranga;144;98;32;8;98;46
8833;0;Vila Nova;Vila Jardim;102;50;28;12;50;52
8834;0;Vila Nova;Vila João Pessoa;128;0;2;1;124;4
8835;0;Vila Nova;Vila Nova;6389;2753;598;140;5776;613
